Player,Pos,Age,Tm,G,GS,MP,FG,FGA,FG%,3P,3PA,3P%,2P,2PA,2P%,eFG%,FT,FTA,FT%,ORB,DRB,TRB,AST,STL,BLK,TOV,PF,PTS,Season
Quincy Acy,PF,22,TOR,29,0,342,42,75,.560,1,2,.500,41,73,.562,.567,31,38,.816,30,47,77,11,13,15,17,53,116,12
Jeff Adrien,PF,26,CHA,52,5,713,72,168,.429,0,2,0,72,166,.434,.429,65,100,.650,68,128,196,36,18,27,32,80,209,12
Arron Afflalo,SF,27,ORL,64,64,2307,397,905,.439,72,240,.300,325,665,.489,.478,191,223,.857,29,210,239,206,40,11,138,137,1057,12
Josh Akognon,PG,26,DAL,3,0,9,2,4,.500,1,2,.500,1,2,.500,.625,0,0,0,0,1,1,1,0,0,0,3,5,12
Cole Aldrich,C,24,TOT,45,0,388,44,80,.550,0,0,0,44,80,.550,.550,12,20,.600,30,90,120,9,5,23,23,60,100,12
LaMarcus Aldridge,PF,27,POR,74,74,2790,638,1318,.484,2,14,.143,636,1304,.488,.485,282,348,.810,175,495,670,192,62,91,143,187,1560,12
Lavoy Allen,C,23,PHI,79,37,1669,206,454,.454,0,1,0,206,453,.455,.454,43,60,.717,159,236,395,73,24,55,55,180,455,12
Ray Allen,SG,37,MIA,79,0,2035,292,651,.449,139,332,.419,153,319,.480,.555,140,158,.886,40,177,217,135,67,15,103,129,863,12
Tony Allen,SG,31,MEM,79,79,2109,284,638,.445,3,24,.125,281,614,.458,.447,134,187,.717,121,242,363,98,119,44,94,211,705,12
Al-Farouq Aminu,SF,22,NOH,76,71,2066,225,474,.475,4,19,.211,221,455,.486,.479,101,137,.737,139,446,585,103,92,51,116,153,555,12
Lou Amundson,PF,30,TOT,39,0,372,32,81,.395,0,0,0,32,81,.395,.395,12,36,.333,48,58,106,11,16,12,19,53,76,12
Chris Andersen,C,34,MIA,42,0,624,71,123,.577,2,3,.667,69,120,.575,.585,63,93,.677,57,115,172,17,16,44,24,89,207,12
Alan Anderson,SF,30,TOR,65,2,1495,236,616,.383,95,285,.333,141,331,.426,.460,126,147,.857,34,114,148,103,48,7,80,131,693,12
James Anderson,SG-SF,23,TOT,39,2,401,52,126,.413,21,60,.350,31,66,.470,.496,24,28,.857,18,54,72,42,15,5,25,25,149,12
Ryan Anderson,PF,24,NOH,81,22,2503,472,1115,.423,213,557,.382,259,558,.464,.519,152,180,.844,191,328,519,97,42,31,97,179,1309,12
Carmelo Anthony,PF,28,NYK,67,67,2482,669,1489,.449,157,414,.379,512,1075,.476,.502,425,512,.830,134,326,460,171,52,32,175,205,1920,12
Joel Anthony,C,30,MIA,62,3,566,35,68,.515,0,0,0,35,68,.515,.515,17,28,.607,45,70,115,13,13,42,22,49,87,12
Trevor Ariza,SF,27,WAS,56,15,1471,188,451,.417,76,209,.364,112,242,.463,.501,78,95,.821,44,222,266,113,72,20,84,72,530,12
Darrell Arthur,PF,24,MEM,59,3,970,162,359,.451,5,18,.278,157,341,.460,.458,33,46,.717,68,101,169,33,24,33,43,126,362,12
Ömer Aşık,C,26,HOU,82,82,2464,332,614,.541,0,1,0,332,613,.542,.541,168,299,.562,275,681,956,75,46,87,173,223,832,12
D.J. Augustin,PG,25,IND,76,5,1226,103,294,.350,67,190,.353,36,104,.346,.464,83,99,.838,20,71,91,170,34,3,68,64,356,12
Gustavo Ayón,C,27,TOT,55,3,734,92,167,.551,0,0,0,92,167,.551,.551,20,50,.400,60,139,199,71,22,17,47,107,204,12
Jeff Ayres,PF,25,IND,37,0,369,61,126,.484,2,4,.500,59,122,.484,.492,21,23,.913,29,75,104,15,6,12,23,44,145,12
Luke Babbitt,PF,23,POR,62,0,730,86,234,.368,62,178,.348,24,56,.429,.500,10,13,.769,15,122,137,29,14,5,22,82,244,12
Leandro Barbosa,PG,30,BOS,41,2,513,83,193,.430,18,47,.383,65,146,.445,.477,31,41,.756,8,38,46,58,17,6,21,51,215,12
J.J. Barea,PG,28,MIN,74,2,1713,316,758,.417,97,280,.346,219,478,.458,.481,105,134,.784,34,173,207,294,32,0,145,131,834,12
Andrea Bargnani,PF,27,TOR,35,25,1003,170,426,.399,38,123,.309,132,303,.436,.444,65,77,.844,26,102,128,38,21,23,54,64,443,12
Harrison Barnes,SF,20,GSW,81,81,2058,276,628,.439,52,145,.359,224,483,.464,.481,144,190,.758,53,280,333,98,52,14,101,140,748,12
Matt Barnes,SF,32,LAC,80,4,2058,312,675,.462,111,325,.342,201,350,.574,.544,87,117,.744,111,255,366,123,82,63,90,233,822,12
Earl Barron,C,31,TOT,12,2,159,18,51,.353,0,0,0,18,51,.353,.353,3,7,.429,22,39,61,5,5,6,11,24,39,12
Will Barton,SG,22,POR,73,5,894,118,309,.382,9,65,.138,109,244,.447,.396,50,65,.769,36,109,145,58,34,9,60,56,295,12
Brandon Bass,PF,27,BOS,81,69,2239,286,589,.486,0,2,0,286,587,.487,.486,129,150,.860,129,296,425,84,44,64,80,188,701,12
Shane Battier,SF,34,MIA,72,20,1786,152,362,.420,136,316,.430,16,46,.348,.608,32,38,.842,37,128,165,72,41,55,34,149,472,12
Nicolas Batum,SF,24,POR,73,73,2807,352,833,.423,165,444,.372,187,389,.481,.522,178,210,.848,97,315,412,360,91,83,190,139,1047,12
Jerryd Bayless,PG,24,MEM,80,4,1765,260,621,.419,71,201,.353,189,420,.450,.476,102,122,.836,22,154,176,264,59,17,120,168,693,12
Aron Baynes,C,26,SAS,16,0,141,18,36,.500,0,1,0,18,35,.514,.500,7,12,.583,12,20,32,5,1,6,11,23,43,12
Kent Bazemore,SG,23,GSW,61,0,267,43,116,.371,10,34,.294,33,82,.402,.414,27,44,.614,5,17,22,22,17,4,18,27,123,12
Bradley Beal,SG,19,WAS,56,46,1745,282,687,.410,91,236,.386,191,451,.424,.477,125,159,.786,43,168,211,137,50,29,90,113,780,12
Michael Beasley,SF,24,PHO,75,20,1554,310,766,.405,45,144,.313,265,622,.426,.434,94,126,.746,52,230,282,111,31,34,144,107,759,12
Rodrigue Beaubois,PG,24,DAL,45,0,549,65,176,.369,21,72,.292,44,104,.423,.429,30,38,.789,9,48,57,84,19,4,33,54,181,12
Marco Belinelli,SG,26,CHI,73,27,1882,241,610,.395,79,221,.357,162,389,.416,.460,141,168,.839,13,127,140,148,44,6,82,140,702,12
Patrick Beverley,PG,24,HOU,41,0,713,79,189,.418,36,96,.375,43,93,.462,.513,34,41,.829,45,64,109,117,37,21,44,83,228,12
Andris Biedriņš,C,26,GSW,53,9,495,10,21,.476,0,0,0,10,21,.476,.476,4,13,.308,34,119,153,14,15,42,14,101,24,12
Chauncey Billups,SG,36,LAC,22,22,418,53,132,.402,33,90,.367,20,42,.476,.527,45,48,.938,2,30,32,49,12,1,26,25,184,12
Bismack Biyombo,C,20,CHA,80,65,2186,156,346,.451,0,0,0,156,346,.451,.451,74,142,.521,194,388,582,35,28,143,82,195,386,12
DeJuan Blair,PF,23,SAS,61,16,851,142,271,.524,0,1,0,142,270,.526,.524,44,70,.629,66,164,230,45,37,10,49,112,328,12
Steve Blake,PG,32,LAL,45,13,1175,114,270,.422,72,171,.421,42,99,.424,.556,27,35,.771,21,111,132,173,34,6,62,83,327,12
Andray Blatche,C,26,BRK,82,8,1555,346,676,.512,3,22,.136,343,654,.524,.514,148,216,.685,161,256,417,85,86,54,123,163,843,12
Eric Bledsoe,PG,23,LAC,76,12,1553,253,568,.445,31,78,.397,222,490,.453,.473,106,134,.791,78,147,225,233,109,55,137,112,643,12
Keith Bogans,SG,32,BRK,74,23,1408,108,284,.380,84,245,.343,24,39,.615,.528,11,17,.647,16,104,120,76,28,4,49,108,311,12
Andrew Bogut,C,28,GSW,32,32,786,83,184,.451,1,1,1.000,82,183,.448,.454,19,38,.500,68,177,245,67,20,55,35,85,186,12
Matt Bonner,PF,32,SAS,68,4,909,112,230,.487,53,120,.442,59,110,.536,.602,11,15,.733,25,104,129,36,17,19,16,86,288,12
Trevor Booker,PF,25,WAS,48,14,887,108,220,.491,0,5,0,108,215,.502,.491,40,72,.556,98,141,239,40,32,16,31,95,256,12
Carlos Boozer,PF,31,CHI,79,79,2546,544,1140,.477,0,2,0,544,1138,.478,.477,193,264,.731,175,596,771,179,66,28,176,239,1281,12
Chris Bosh,C,28,MIA,74,74,2454,485,907,.535,21,74,.284,464,833,.557,.546,241,302,.798,131,370,501,123,66,101,128,168,1232,12
Avery Bradley,PG,22,BOS,50,50,1435,192,478,.402,40,126,.317,152,352,.432,.444,37,49,.755,30,81,111,104,64,19,72,129,461,12
Elton Brand,C,33,DAL,72,18,1527,226,478,.473,0,1,0,226,477,.474,.473,66,93,.710,130,300,430,70,50,90,57,192,518,12
Corey Brewer,SF,26,DEN,82,2,2003,375,883,.425,91,307,.296,284,576,.493,.476,149,216,.690,55,180,235,124,118,23,102,154,990,12
Ronnie Brewer,SF,27,TOT,60,34,853,70,198,.354,23,76,.303,47,122,.385,.412,16,39,.410,42,98,140,50,43,6,18,33,179,12
Aaron Brooks,PG,28,TOT,53,20,997,143,316,.453,50,134,.373,93,182,.511,.532,40,52,.769,13,67,80,114,30,10,67,94,376,12
MarShon Brooks,SG,24,BRK,73,2,912,155,335,.463,15,55,.273,140,280,.500,.485,69,94,.734,32,72,104,76,34,16,69,93,394,12
Kwame Brown,C,30,PHI,22,11,269,17,37,.459,0,0,0,17,37,.459,.459,7,19,.368,23,51,74,9,6,10,8,37,41,12
Shannon Brown,SG,27,PHO,59,22,1402,240,571,.420,39,141,.277,201,430,.467,.454,98,125,.784,44,105,149,108,59,15,74,92,617,12
Kobe Bryant,SG,34,LAL,78,78,3013,738,1595,.463,132,407,.324,606,1188,.510,.504,525,626,.839,66,367,433,469,106,25,287,173,2133,12
Chase Budinger,SF,24,MIN,23,1,508,79,191,.414,26,81,.321,53,110,.482,.482,32,42,.762,15,56,71,25,14,7,23,29,216,12
Alec Burks,SG,21,UTA,64,0,1137,163,388,.420,33,92,.359,130,296,.439,.463,92,129,.713,37,108,145,92,35,13,74,114,451,12
Caron Butler,SF,32,LAC,78,78,1879,305,720,.424,128,330,.388,177,390,.454,.513,75,90,.833,41,182,223,78,51,11,72,139,813,12
Jimmy Butler,SF,23,CHI,82,20,2134,239,512,.467,40,105,.381,199,407,.489,.506,187,233,.803,136,192,328,115,78,31,62,97,705,12
Will Bynum,PG,30,DET,65,0,1219,253,540,.469,24,76,.316,229,464,.494,.491,106,131,.809,28,69,97,231,45,5,125,128,636,12
José Calderón,PG,31,TOT,73,58,2160,312,635,.491,130,282,.461,182,353,.516,.594,72,80,.900,20,156,176,518,58,8,126,99,826,12
Marcus Camby,PF,38,NYK,24,4,250,17,53,.321,0,0,0,17,53,.321,.321,8,19,.421,24,56,80,14,7,14,15,28,42,12
DeMarre Carroll,SF,26,UTA,66,12,1111,149,324,.460,20,70,.286,129,254,.508,.491,75,98,.765,87,101,188,61,58,24,34,119,393,12
Matt Carroll,SG,32,CHA,1,0,6,0,0,0,0,0,0,0,0,0,0,0,0,0,0,0,0,1,0,0,0,1,0,12
Vince Carter,SF,36,DAL,81,3,2093,372,855,.435,162,399,.406,210,456,.461,.530,182,223,.816,58,276,334,194,74,44,106,226,1088,12
Omri Casspi,SF,24,CLE,43,1,503,63,160,.394,25,76,.329,38,84,.452,.472,22,41,.537,20,94,114,28,25,12,22,45,173,12
Mario Chalmers,PG,26,MIA,77,77,2068,227,529,.429,123,301,.409,104,228,.456,.545,89,112,.795,19,152,171,273,118,12,119,196,666,12
Tyson Chandler,C,30,NYK,66,66,2164,255,400,.638,0,0,0,255,400,.638,.638,179,258,.694,269,434,703,62,42,75,87,188,689,12
Wilson Chandler,PF,25,DEN,43,8,1079,210,455,.462,52,126,.413,158,329,.480,.519,88,111,.793,45,173,218,58,45,12,60,119,560,12
Josh Childress,SF,29,BRK,14,0,100,6,21,.286,1,3,.333,5,18,.278,.310,1,2,.500,6,9,15,5,2,2,0,3,14,12
Earl Clark,PF,25,LAL,59,36,1363,170,386,.440,35,104,.337,135,282,.479,.486,53,76,.697,82,243,325,65,36,44,62,102,428,12
Victor Claver,SF,24,POR,49,16,812,74,189,.392,25,87,.287,49,102,.480,.458,14,30,.467,31,88,119,43,26,12,43,75,187,12
Norris Cole,PG,24,MIA,80,4,1590,179,425,.421,35,98,.357,144,327,.440,.462,52,80,.650,18,112,130,164,57,7,104,155,445,12
Jason Collins,C,34,TOT,38,9,384,9,29,.310,0,0,0,9,29,.310,.310,23,32,.719,22,38,60,8,12,10,18,85,41,12
Darren Collison,PG,25,DAL,81,47,2372,341,724,.471,48,136,.353,293,588,.498,.504,242,275,.880,31,188,219,415,100,8,173,139,972,12
Nick Collison,C,32,OKC,81,2,1583,176,296,.595,0,4,0,176,292,.603,.595,60,78,.769,123,210,333,121,51,30,69,197,412,12
Mike Conley,PG,25,MEM,80,80,2757,414,940,.440,106,293,.362,308,647,.476,.497,234,282,.830,43,182,225,487,174,24,189,171,1168,12
Will Conroy,PG,30,MIN,4,0,20,0,9,0,0,3,0,0,6,0,0,1,2,.500,1,0,1,0,0,0,0,1,1,12
Daequan Cook,SG,25,TOT,49,1,441,51,167,.305,26,91,.286,25,76,.329,.383,9,12,.750,7,54,61,19,8,7,15,26,137,12
Chris Copeland,PF,28,NYK,56,13,862,182,380,.479,59,140,.421,123,240,.513,.557,63,83,.759,34,85,119,27,16,12,50,104,486,12
DeMarcus Cousins,C,22,SAC,75,74,2289,482,1036,.465,4,22,.182,478,1014,.471,.467,312,423,.738,222,524,746,199,108,55,225,269,1280,12
Jamal Crawford,SG,32,LAC,76,0,2230,445,1016,.438,149,396,.376,296,620,.477,.511,216,248,.871,22,106,128,193,79,13,146,71,1255,12
Jordan Crawford,SG,24,TOT,70,14,1709,301,725,.415,83,246,.337,218,479,.455,.472,129,159,.811,44,165,209,225,39,7,141,106,814,12
Jae Crowder,SF,22,DAL,78,16,1353,141,367,.384,63,192,.328,78,175,.446,.470,47,73,.644,35,152,187,94,63,17,49,128,392,12
Dante Cunningham,PF,25,MIN,80,9,2010,314,671,.468,0,6,0,314,665,.472,.468,67,103,.650,142,266,408,67,84,38,56,153,695,12
Jared Cunningham,SG,21,DAL,8,0,26,6,14,.429,2,3,.667,4,11,.364,.500,2,2,1.000,1,2,3,1,1,0,2,3,16,12
Eddy Curry,C,30,DAL,2,0,25,4,8,.500,0,0,0,4,8,.500,.500,1,4,.250,2,2,4,0,0,0,3,7,9,12
Stephen Curry,PG,24,GSW,78,78,2983,626,1388,.451,272,600,.453,354,788,.449,.549,262,291,.900,59,255,314,539,126,12,240,198,1786,12
Samuel Dalembert,C,31,MIL,47,23,765,137,253,.542,1,1,1.000,136,252,.540,.543,38,55,.691,105,171,276,21,17,53,51,90,313,12
Marquis Daniels,SF,32,MIL,59,33,1085,132,351,.376,20,72,.278,112,279,.401,.405,40,54,.741,48,102,150,65,51,10,45,77,324,12
Anthony Davis,PF,19,NOH,64,60,1846,349,676,.516,0,6,0,349,670,.521,.516,169,225,.751,165,357,522,63,75,112,89,158,867,12
Ed Davis,C-PF,23,TOT,81,28,1631,260,482,.539,0,0,0,260,482,.539,.539,103,167,.617,152,308,460,63,38,85,63,191,623,12
Glen Davis,PF,27,ORL,34,33,1064,214,478,.448,0,2,0,214,476,.450,.448,84,117,.718,55,191,246,70,32,21,64,88,512,12
Austin Daye,SF,24,TOT,55,0,676,90,208,.433,41,98,.418,49,110,.445,.531,26,34,.765,16,107,123,42,14,22,29,82,247,12
Nando De Colo,SG,25,SAS,72,6,920,105,241,.436,31,82,.378,74,159,.465,.500,35,44,.795,23,115,138,138,41,6,81,87,276,12
Carlos Delfino,SF,30,HOU,67,5,1689,251,620,.405,158,421,.375,93,199,.467,.532,48,56,.857,18,202,220,135,68,9,72,114,708,12
Luol Deng,SF,27,CHI,75,75,2903,466,1093,.426,75,233,.322,391,860,.455,.461,230,282,.816,162,314,476,222,81,32,144,105,1237,12
Justin Dentmon,PG,27,DAL,2,0,4,0,2,0,0,0,0,0,2,0,0,0,0,0,0,0,0,0,0,0,0,0,0,12
DeMar DeRozan,SG,23,TOR,82,82,3013,548,1231,.445,34,120,.283,514,1111,.463,.459,355,427,.831,48,272,320,204,76,24,151,173,1485,12
Boris Diaw,PF,30,SAS,75,20,1709,179,332,.539,30,78,.385,149,254,.587,.584,47,65,.723,66,188,254,180,52,27,84,143,435,12
DeSagana Diop,C,31,CHA,22,1,226,8,27,.296,0,1,0,8,26,.308,.296,0,1,0,10,41,51,13,5,16,8,19,16,12
Keyon Dooling,PG,32,MEM,7,0,82,10,21,.476,5,12,.417,5,9,.556,.595,6,7,.857,0,1,1,8,1,0,5,8,31,12
Toney Douglas,PG,26,TOT,71,0,1289,188,466,.403,82,216,.380,106,250,.424,.491,76,84,.905,34,104,138,151,71,3,81,145,534,12
Chris Douglas-Roberts,SG,26,DAL,6,0,63,5,14,.357,0,4,0,5,10,.500,.357,7,10,.700,0,5,5,4,2,0,1,4,17,12
Goran Dragić,PG,26,PHO,77,77,2581,401,906,.443,88,276,.319,313,630,.497,.491,244,326,.748,60,178,238,569,124,26,212,214,1134,12
Andre Drummond,C,19,DET,60,10,1243,208,342,.608,1,2,.500,207,340,.609,.610,59,159,.371,169,288,457,30,59,95,57,144,476,12
Jared Dudley,SF,27,PHO,79,50,2170,313,669,.468,106,271,.391,207,398,.520,.547,129,162,.796,79,166,245,203,75,8,101,128,861,12
Chris Duhon,PG,30,LAL,46,9,820,47,123,.382,33,91,.363,14,32,.438,.516,6,13,.462,11,57,68,133,20,1,40,56,133,12
Tim Duncan,C,36,SAS,69,69,2078,490,976,.502,2,7,.286,488,969,.504,.503,245,300,.817,124,562,686,184,50,183,147,117,1227,12
Mike Dunleavy,SF,32,MIL,75,3,1943,276,624,.442,128,299,.428,148,325,.455,.545,105,128,.820,31,260,291,145,39,35,90,135,785,12
Kevin Durant,SF,24,OKC,81,81,3119,731,1433,.510,139,334,.416,592,1099,.539,.559,679,750,.905,46,594,640,374,116,105,280,143,2280,12
Devin Ebanks,SF,23,LAL,19,3,197,24,73,.329,6,22,.273,18,51,.353,.370,11,14,.786,10,31,41,10,3,1,11,23,65,12
Wayne Ellington,SG,25,TOT,78,21,1661,226,529,.427,94,240,.392,132,289,.457,.516,68,75,.907,25,141,166,104,45,3,57,81,614,12
Monta Ellis,SG,27,MIL,82,82,3076,597,1436,.416,94,328,.287,503,1108,.454,.448,289,374,.773,45,271,316,496,169,36,254,164,1577,12
Kim English,SG,24,DET,41,0,407,42,112,.375,14,50,.280,28,62,.452,.438,21,29,.724,8,29,37,26,16,3,19,46,119,12
Jeremy Evans,PF,25,UTA,37,0,215,27,44,.614,0,1,0,27,43,.628,.614,21,33,.636,26,32,58,11,8,13,8,30,75,12
Reggie Evans,PF,32,BRK,80,56,1967,125,261,.479,0,0,0,125,261,.479,.479,113,222,.509,260,628,888,43,74,13,111,199,363,12
Tyreke Evans,SG,23,SAC,65,61,2016,366,765,.478,45,133,.338,321,632,.508,.508,210,271,.775,56,231,287,229,90,27,128,133,987,12
Festus Ezeli,C,23,GSW,78,41,1120,74,169,.438,0,0,0,74,169,.438,.438,43,81,.531,141,172,313,22,23,74,63,157,191,12
Kenneth Faried,PF,23,DEN,80,80,2248,380,689,.552,0,0,0,380,689,.552,.552,163,266,.613,260,474,734,77,81,83,113,234,923,12
Derrick Favors,PF,21,UTA,77,8,1787,274,568,.482,0,5,0,274,563,.487,.482,179,260,.688,184,362,546,75,67,130,129,247,727,12
Raymond Felton,PG,28,NYK,68,68,2313,377,882,.427,93,258,.360,284,624,.455,.480,101,128,.789,51,143,194,372,94,14,155,130,948,12
Landry Fields,SF,24,TOR,51,22,1037,102,223,.457,2,14,.143,100,209,.478,.462,34,53,.642,59,149,208,60,32,8,42,63,240,12
Derek Fisher,SG-PG,38,TOT,33,9,575,55,161,.342,30,80,.375,25,81,.309,.435,35,38,.921,2,35,37,47,19,3,30,55,175,12
Evan Fournier,SG,20,DEN,38,4,428,75,152,.493,22,54,.407,53,98,.541,.566,30,39,.769,6,29,35,44,19,1,32,65,202,12
Randy Foye,SG,29,UTA,82,72,2249,293,738,.397,178,434,.410,115,304,.378,.518,118,144,.819,17,110,127,167,66,27,92,190,882,12
Jimmer Fredette,SG,23,SAC,69,0,967,172,409,.421,65,156,.417,107,253,.423,.500,85,99,.859,19,52,71,92,31,3,68,64,494,12
Enes Freedom,C,20,UTA,70,2,1078,206,379,.544,1,1,1.000,205,378,.542,.545,93,117,.795,135,169,304,31,28,32,101,116,506,12
Joel Freeland,PF,25,POR,51,1,477,58,142,.408,0,0,0,58,142,.408,.408,18,27,.667,40,79,119,13,13,11,19,67,134,12
Danilo Gallinari,SF,24,DEN,71,71,2309,364,871,.418,135,362,.373,229,509,.450,.495,286,348,.822,65,302,367,176,64,36,111,130,1149,12
Francisco García,SG-SF,31,TOT,58,20,1029,118,300,.393,67,179,.374,51,121,.421,.505,18,21,.857,8,83,91,63,46,38,32,88,321,12
Kevin Garnett,C,36,BOS,68,68,2022,422,850,.496,2,16,.125,420,834,.504,.498,158,201,.786,75,455,530,159,78,62,110,154,1004,12
Diante Garrett,PG,24,PHO,19,0,149,16,49,.327,3,15,.200,13,34,.382,.357,5,10,.500,5,10,15,31,10,0,16,5,40,12
Marc Gasol,C,28,MEM,80,80,2796,429,869,.494,1,14,.071,428,855,.501,.494,268,316,.848,184,438,622,318,80,139,157,255,1127,12
Pau Gasol,PF,32,LAL,49,42,1655,270,579,.466,8,28,.286,262,551,.475,.473,125,178,.702,111,310,421,200,24,61,104,93,673,12
Rudy Gay,SF,26,TOT,75,74,2687,521,1253,.416,84,260,.323,437,993,.440,.449,240,295,.814,99,362,461,202,113,53,198,182,1366,12
Alonzo Gee,SF,25,CLE,82,82,2541,305,744,.410,69,219,.315,236,525,.450,.456,163,205,.795,75,245,320,133,107,29,132,199,842,12
Mickaël Gelabale,SF,29,MIN,36,13,644,72,139,.518,16,52,.308,56,87,.644,.576,21,24,.875,32,67,99,26,16,4,16,47,181,12
Paul George,SF,22,IND,79,79,2972,493,1176,.419,170,469,.362,323,707,.457,.491,221,274,.807,88,515,603,327,143,51,233,227,1377,12
Daniel Gibson,PG,26,CLE,46,3,919,84,247,.340,56,163,.344,28,84,.333,.453,26,37,.703,5,55,60,82,30,4,31,89,250,12
Taj Gibson,PF,27,CHI,65,5,1459,214,441,.485,0,4,0,214,437,.490,.485,89,131,.679,125,220,345,61,27,90,76,166,517,12
Manu Ginóbili,SG,35,SAS,60,0,1393,229,539,.425,83,235,.353,146,304,.480,.502,164,206,.796,30,171,201,274,80,13,132,114,705,12
Drew Gooden,C,31,MIL,16,0,151,20,61,.328,1,5,.200,19,56,.339,.336,11,16,.688,13,18,31,6,5,6,9,21,52,12
Ben Gordon,SG,29,CHA,75,0,1560,310,760,.408,113,292,.387,197,468,.421,.482,107,127,.843,18,112,130,141,35,16,136,134,840,12
Eric Gordon,SG,24,NOH,42,40,1264,235,584,.402,56,173,.324,179,411,.436,.450,187,222,.842,10,67,77,137,45,8,117,75,713,12
Marcin Gortat,C,28,PHO,61,61,1876,295,566,.521,0,3,0,295,563,.524,.521,90,138,.652,128,388,516,75,40,98,99,127,680,12
Andrew Goudelock,SG,24,LAL,1,0,6,0,2,0,0,0,0,0,2,0,0,0,0,0,1,0,1,0,0,0,0,0,0,12
Danny Granger,SF,29,IND,5,0,74,10,35,.286,2,10,.200,8,25,.320,.314,5,8,.625,3,6,9,3,2,1,4,6,27,12
Aaron Gray,C,28,TOR,42,16,513,48,90,.533,0,0,0,48,90,.533,.533,23,44,.523,48,85,133,33,7,5,36,85,119,12
Danny Green,SG,25,SAS,80,80,2201,297,663,.448,177,413,.429,120,250,.480,.581,67,79,.848,36,208,244,141,92,54,94,124,838,12
Draymond Green,SF,22,GSW,79,1,1061,84,257,.327,14,67,.209,70,190,.368,.354,45,55,.818,58,202,260,53,42,25,51,159,227,12
Gerald Green,SF,27,IND,60,7,1080,155,424,.366,59,188,.314,96,236,.407,.435,52,65,.800,31,110,141,50,19,23,53,64,421,12
Jeff Green,PF,26,BOS,81,17,2252,376,806,.467,70,182,.385,306,624,.490,.510,214,265,.808,55,263,318,128,56,68,132,175,1036,12
Willie Green,SG,31,LAC,72,60,1188,178,386,.461,71,166,.428,107,220,.486,.553,23,32,.719,17,80,97,55,29,12,31,96,450,12
Blake Griffin,PF,23,LAC,80,80,2598,577,1072,.538,5,28,.179,572,1044,.548,.541,281,426,.660,186,476,662,299,97,50,185,231,1440,12
Hamed Haddadi,C,27,TOT,30,0,322,35,82,.427,0,0,0,35,82,.427,.427,14,27,.519,43,68,111,12,6,27,31,60,84,12
Jordan Hamilton,SF,22,DEN,40,1,397,84,201,.418,27,73,.370,57,128,.445,.485,13,26,.500,32,63,95,23,15,8,19,24,208,12
Richard Hamilton,SG,34,CHI,50,45,1088,204,475,.429,16,52,.308,188,423,.444,.446,66,77,.857,16,67,83,119,24,5,84,93,490,12
Ben Hansbrough,PG,25,IND,28,0,200,15,45,.333,6,23,.261,9,22,.409,.400,21,27,.778,2,16,18,21,7,2,18,23,57,12
Tyler Hansbrough,PF,27,IND,81,8,1366,176,407,.432,0,3,0,176,404,.436,.432,216,300,.720,161,212,373,36,29,18,78,152,568,12
James Harden,SG,23,HOU,78,78,2985,585,1337,.438,179,486,.368,406,851,.477,.504,674,792,.851,62,317,379,455,142,38,295,178,2023,12
Maurice Harkless,SF,19,ORL,76,59,1974,260,564,.461,32,117,.274,228,447,.510,.489,73,128,.570,122,213,335,50,88,62,69,144,625,12
Josh Harrellson,C,23,MIA,6,0,31,4,9,.444,1,5,.200,3,4,.750,.500,1,2,.500,3,4,7,0,1,1,3,4,10,12
Al Harrington,C,32,ORL,10,0,119,20,57,.351,8,30,.267,12,27,.444,.421,3,4,.750,6,21,27,10,4,1,7,18,51,12
Devin Harris,SG,29,ATL,58,34,1421,194,443,.438,77,230,.335,117,213,.549,.525,112,154,.727,6,110,116,197,64,13,88,103,577,12
Terrel Harris,SG,25,TOT,20,0,137,4,27,.148,0,8,0,4,19,.211,.148,7,10,.700,4,22,26,9,2,3,17,17,15,12
Tobias Harris,SF-PF,20,TOT,55,34,1299,233,512,.455,34,108,.315,199,404,.493,.488,103,137,.752,73,214,287,69,32,44,66,120,603,12
Udonis Haslem,PF,32,MIA,75,59,1414,129,251,.514,0,0,0,129,251,.514,.514,32,45,.711,97,307,404,38,30,15,45,173,290,12
Spencer Hawes,C,24,PHI,82,40,2233,376,811,.464,31,87,.356,345,724,.477,.483,122,157,.777,173,417,590,183,24,113,131,233,905,12
Chuck Hayes,C,29,SAC,74,1,1209,84,190,.442,0,1,0,84,189,.444,.442,30,48,.625,113,186,299,112,31,18,44,114,198,12
Gordon Hayward,SF,22,UTA,72,27,2104,336,773,.435,102,246,.415,234,527,.444,.501,243,294,.827,51,174,225,213,58,38,120,125,1017,12
Lazar Hayward,SF,26,MIN,4,0,31,2,10,.200,0,4,0,2,6,.333,.200,6,6,1.000,0,4,4,3,2,0,0,3,10,12
Brendan Haywood,C,33,CHA,61,17,1162,93,216,.431,0,1,0,93,215,.433,.431,30,66,.455,125,165,290,29,16,49,50,125,216,12
Gerald Henderson,SG,25,CHA,68,58,2133,382,855,.447,33,100,.330,349,755,.462,.466,258,313,.824,55,195,250,177,68,34,108,149,1055,12
Xavier Henry,SF,21,NOH,50,2,625,66,161,.410,4,11,.364,62,150,.413,.422,58,92,.630,21,69,90,13,16,5,31,72,194,12
John Henson,PF,22,MIL,63,9,827,162,336,.482,0,3,0,162,333,.486,.482,56,105,.533,116,181,297,31,19,42,47,83,380,12
Roy Hibbert,C,26,IND,79,79,2269,385,859,.448,1,4,.250,384,855,.449,.449,166,224,.741,296,360,656,113,39,206,162,279,937,12
J.J. Hickson,C,24,POR,80,80,2323,418,744,.562,0,2,0,418,742,.563,.562,182,268,.679,266,562,828,88,48,51,145,160,1018,12
Cory Higgins,SG,23,CHA,6,0,32,6,19,.316,1,5,.200,5,14,.357,.342,1,2,.500,1,2,3,5,3,0,0,5,14,12
Nenê,PF,30,WAS,61,49,1659,285,594,.480,0,1,0,285,593,.481,.480,196,269,.729,101,306,407,177,55,37,139,171,766,12
George Hill,PG,26,IND,76,76,2620,386,871,.443,130,353,.368,256,518,.494,.518,174,213,.817,47,237,284,355,81,26,116,134,1076,12
Grant Hill,SF,40,LAC,29,0,437,38,98,.388,3,11,.273,35,87,.402,.403,14,24,.583,6,43,49,26,11,7,25,39,93,12
Jordan Hill,PF,25,LAL,29,1,458,77,155,.497,0,2,0,77,153,.503,.497,40,61,.656,82,84,166,13,8,19,26,55,194,12
Kirk Hinrich,PG,32,CHI,60,60,1764,159,422,.377,71,182,.390,88,240,.367,.461,70,98,.714,16,142,158,314,63,25,99,192,459,12
Jrue Holiday,PG,22,PHI,78,78,2926,555,1288,.431,91,247,.368,464,1041,.446,.466,182,242,.752,89,240,329,625,123,32,292,170,1383,12
Justin Holiday,SG,23,PHI,9,0,142,16,48,.333,4,16,.250,12,32,.375,.375,6,8,.750,0,14,14,15,3,6,9,7,42,12
Ryan Hollins,C,28,LAC,60,0,663,70,114,.614,0,0,0,70,114,.614,.614,66,88,.750,50,89,139,11,6,34,44,133,206,12
Tyler Honeycutt,SF,22,SAC,9,0,32,3,11,.273,0,2,0,3,9,.333,.273,2,2,1.000,3,7,10,2,0,1,5,2,8,12
Al Horford,C,26,ATL,74,74,2756,576,1060,.543,3,6,.500,573,1054,.544,.545,134,208,.644,195,562,757,240,78,78,147,163,1289,12
Dwight Howard,C,27,LAL,76,76,2722,470,813,.578,1,6,.167,469,807,.581,.579,355,721,.492,251,694,945,108,84,186,225,291,1296,12
Josh Howard,SF,32,MIN,11,4,207,31,77,.403,5,16,.313,26,61,.426,.435,7,12,.583,9,27,36,4,10,3,10,18,74,12
Juwan Howard,PF,39,MIA,7,2,51,10,19,.526,0,0,0,10,19,.526,.526,1,1,1.000,0,8,8,6,0,0,4,9,21,12
Kris Humphries,PF,27,BRK,65,21,1191,139,310,.448,0,2,0,139,308,.451,.448,97,123,.789,126,239,365,32,16,33,57,127,375,12
Serge Ibaka,PF,23,OKC,80,80,2486,446,778,.573,20,57,.351,426,721,.591,.586,143,191,.749,222,395,617,43,28,242,125,213,1055,12
Andre Iguodala,SG,29,DEN,80,80,2779,396,879,.451,91,287,.317,305,592,.515,.502,155,270,.574,82,341,423,433,139,52,206,127,1038,12
Ersan İlyasova,PF,25,MIL,73,54,2012,371,803,.462,95,214,.444,276,589,.469,.521,125,157,.796,154,366,520,117,68,36,75,185,962,12
Kyrie Irving,PG,20,CLE,59,59,2048,484,1070,.452,109,279,.391,375,791,.474,.503,248,290,.855,34,182,216,350,89,21,191,146,1325,12
Royal Ivey,SG,31,PHI,53,5,698,62,144,.431,37,88,.420,25,56,.446,.559,9,16,.563,16,41,57,32,23,3,20,73,170,12
Jarrett Jack,SG,29,GSW,79,4,2349,387,857,.452,82,203,.404,305,654,.466,.499,167,198,.843,21,222,243,439,60,11,157,134,1023,12
Reggie Jackson,PG,22,OKC,70,0,993,149,325,.458,24,104,.231,125,221,.566,.495,52,62,.839,21,145,166,122,29,13,53,84,374,12
Stephen Jackson,SF,34,SAS,55,6,1075,123,330,.373,46,170,.271,77,160,.481,.442,49,70,.700,22,133,155,80,37,14,77,89,341,12
Bernard James,C,27,DAL,46,11,457,53,103,.515,0,2,0,53,101,.525,.515,25,41,.610,52,79,131,6,12,38,18,64,131,12
Damion James,SF,25,BRK,2,0,0,0,0,0,0,0,0,0,0,0,0,0,0,0,0,1,1,0,0,0,0,0,0,12
LeBron James,PF,28,MIA,76,76,2877,765,1354,.565,103,254,.406,662,1100,.602,.603,403,535,.753,97,513,610,551,129,67,226,110,2036,12
Mike James,PG,37,DAL,45,23,862,101,271,.373,48,125,.384,53,146,.363,.461,23,29,.793,9,63,72,139,26,3,55,95,273,12
Antawn Jamison,PF,36,LAL,76,6,1636,267,575,.464,84,233,.361,183,342,.535,.537,94,136,.691,109,253,362,50,30,22,53,124,712,12
Al Jefferson,C,28,UTA,78,78,2578,611,1236,.494,2,17,.118,609,1219,.500,.495,167,217,.770,156,564,720,164,80,89,105,170,1391,12
Richard Jefferson,SF,32,GSW,56,1,568,62,136,.456,14,45,.311,48,91,.527,.507,38,53,.717,5,79,84,31,14,7,23,45,176,12
Jared Jeffries,PF,31,POR,38,0,350,16,54,.296,0,2,0,16,52,.308,.296,12,23,.522,26,34,60,14,6,6,17,58,44,12
Charles Jenkins,SG-PG,23,TOT,59,1,441,49,121,.405,1,2,.500,48,119,.403,.409,12,22,.545,8,24,32,44,15,2,21,22,111,12
John Jenkins,SG,21,ATL,61,2,902,131,294,.446,53,138,.384,78,156,.500,.536,59,70,.843,17,77,94,56,12,10,40,37,374,12
Brandon Jennings,PG,23,MIL,80,80,2897,497,1247,.399,173,461,.375,324,786,.412,.468,230,281,.819,59,187,246,521,125,10,203,155,1397,12
Jonas Jerebko,PF,25,DET,49,2,892,142,316,.449,25,83,.301,117,233,.502,.489,68,88,.773,68,117,185,43,38,8,42,90,377,12
Amir Johnson,PF,25,TOR,81,38,2325,336,606,.554,5,13,.385,331,593,.558,.559,136,187,.727,227,384,611,122,81,110,117,301,813,12
Chris Johnson,C,27,MIN,30,0,284,48,75,.640,0,0,0,48,75,.640,.640,21,34,.618,20,40,60,8,7,28,13,49,117,12
Chris Johnson,SF,22,MEM,8,0,102,11,25,.440,6,18,.333,5,7,.714,.560,1,2,.500,5,6,11,2,4,0,3,5,29,12
Ivan Johnson,PF,28,ATL,69,5,1035,185,356,.520,1,13,.077,184,343,.536,.521,81,131,.618,76,190,266,46,56,14,71,131,452,12
James Johnson,SF,25,SAC,54,11,878,117,283,.413,2,21,.095,115,262,.439,.417,40,67,.597,49,96,145,58,41,50,68,99,276,12
Joe Johnson,SG,31,BRK,72,72,2642,445,1052,.423,148,395,.375,297,657,.452,.493,132,161,.820,53,165,218,253,49,14,123,99,1170,12
Orlando Johnson,SG,23,IND,51,0,619,72,180,.400,36,94,.383,36,86,.419,.500,23,32,.719,20,90,110,47,11,9,29,51,203,12
Wesley Johnson,SF,25,PHO,50,21,953,161,396,.407,50,155,.323,111,241,.461,.470,27,35,.771,21,102,123,34,22,18,48,56,399,12
Darius Johnson-Odom,SG,23,LAL,4,0,6,0,4,0,0,1,0,0,3,0,0,0,0,0,1,3,4,1,0,0,0,0,0,12
Dahntay Jones,SF,32,TOT,78,19,1016,82,222,.369,11,49,.224,71,173,.410,.394,87,113,.770,24,77,101,48,22,6,38,119,262,12
DeQuan Jones,SF,22,ORL,63,17,803,95,218,.436,9,35,.257,86,183,.470,.456,34,51,.667,17,88,105,16,19,22,30,55,233,12
Dominique Jones,PG,24,DAL,29,3,338,40,109,.367,1,9,.111,39,100,.390,.372,35,53,.660,18,27,45,83,14,2,38,29,116,12
James Jones,SF,32,MIA,38,0,221,21,61,.344,16,53,.302,5,8,.625,.475,2,4,.500,0,22,22,13,2,6,3,16,60,12
Kevin Jones,PF,23,CLE,32,0,334,43,107,.402,0,0,0,43,107,.402,.402,9,15,.600,38,40,78,10,9,5,8,25,95,12
Perry Jones,SF,21,OKC,38,1,280,39,99,.394,0,2,0,39,97,.402,.394,10,15,.667,12,50,62,10,5,6,15,23,88,12
Solomon Jones,PF,28,NYK,2,1,26,0,1,0,0,0,0,0,1,0,0,0,0,0,1,2,3,0,0,1,3,3,0,12
Terrence Jones,PF,21,HOU,19,0,276,43,94,.457,5,19,.263,38,75,.507,.484,13,17,.765,28,37,65,15,12,19,13,21,104,12
DeAndre Jordan,C,24,LAC,82,82,2010,314,488,.643,0,0,0,314,488,.643,.643,96,249,.386,210,384,594,28,48,112,100,192,724,12
Cory Joseph,PG,21,SAS,28,9,388,51,110,.464,6,21,.286,45,89,.506,.491,18,21,.857,12,40,52,53,15,4,21,25,126,12
Kris Joseph,SF,24,TOT,10,0,54,2,14,.143,0,3,0,2,11,.182,.143,5,8,.625,1,6,7,1,3,0,2,3,9,12
Chris Kaman,C,30,DAL,66,52,1363,313,617,.507,0,1,0,313,616,.508,.507,67,85,.788,97,275,372,51,29,52,103,141,693,12
Jason Kidd,SG,39,NYK,76,48,2043,152,409,.372,114,325,.351,38,84,.452,.511,40,48,.833,50,273,323,249,125,25,76,125,458,12
Michael Kidd-Gilchrist,SF,19,CHA,78,77,2025,281,613,.458,2,9,.222,279,604,.462,.460,140,187,.749,131,324,455,117,54,70,101,164,704,12
Andrei Kirilenko,SF,31,MIN,64,64,2034,284,560,.507,35,120,.292,249,440,.566,.538,188,250,.752,102,260,362,177,96,62,119,82,791,12
Linas Kleiza,SF,28,TOR,20,3,376,48,144,.333,20,66,.303,28,78,.359,.403,32,38,.842,10,42,52,16,4,2,14,45,148,12
Brandon Knight,PG,21,DET,75,75,2365,357,878,.407,120,327,.367,237,551,.430,.475,165,225,.733,54,193,247,303,58,8,205,157,999,12
Kyle Korver,SF,31,ATL,74,60,2259,277,601,.461,189,414,.457,88,187,.471,.618,67,78,.859,23,270,293,146,70,37,70,170,810,12
Kosta Koufos,C,23,DEN,81,81,1817,295,508,.581,0,1,0,295,507,.582,.581,58,104,.558,211,351,562,32,44,103,53,246,648,12
Viacheslav Kravtsov,C,25,DET,25,0,224,33,46,.717,0,0,0,33,46,.717,.717,11,37,.297,24,21,45,9,5,9,14,32,77,12
Doron Lamb,SG,21,TOT,47,0,577,60,163,.368,14,37,.378,46,126,.365,.411,20,34,.588,8,38,46,32,13,0,26,52,154,12
Jeremy Lamb,SF,20,OKC,23,0,147,24,68,.353,9,30,.300,15,38,.395,.419,14,14,1.000,5,13,18,5,2,2,6,13,71,12
Carl Landry,PF,29,GSW,81,2,1876,325,602,.540,1,3,.333,324,599,.541,.541,223,273,.817,180,303,483,65,35,31,115,190,874,12
Ty Lawson,PG,25,DEN,73,71,2513,448,971,.461,85,232,.366,363,739,.491,.505,235,311,.756,36,162,198,501,107,8,182,135,1216,12
Courtney Lee,SG,27,BOS,78,39,1941,246,530,.464,58,156,.372,188,374,.503,.519,62,72,.861,31,159,190,143,89,21,84,139,612,12
David Lee,PF,29,GSW,79,79,2907,602,1160,.519,0,4,0,602,1156,.521,.519,255,320,.797,218,668,886,279,67,22,207,246,1459,12
Malcolm Lee,SG,22,MIN,16,12,289,29,76,.382,8,24,.333,21,52,.404,.434,12,20,.600,15,24,39,20,12,6,10,30,78,12
Kawhi Leonard,SF,21,SAS,58,57,1810,260,526,.494,65,174,.374,195,352,.554,.556,104,126,.825,63,283,346,93,97,32,62,99,689,12
Meyers Leonard,C,20,POR,69,9,1206,151,277,.545,3,7,.429,148,270,.548,.551,72,89,.809,80,175,255,33,11,38,49,168,377,12
Jon Leuer,PF-C,23,TOT,28,0,187,25,52,.481,0,3,0,25,49,.510,.481,6,13,.462,13,24,37,8,6,0,8,21,56,12
Rashard Lewis,PF,33,MIA,55,9,792,103,249,.414,51,131,.389,52,118,.441,.516,28,45,.622,19,102,121,30,21,14,33,67,285,12
DeAndre Liggins,SG,24,OKC,39,1,290,21,47,.447,7,19,.368,14,28,.500,.521,9,18,.500,13,40,53,15,18,3,14,33,58,12
Damian Lillard,PG,22,POR,82,82,3167,553,1288,.429,185,503,.368,368,785,.469,.501,271,321,.844,42,215,257,531,74,19,243,172,1562,12
Jeremy Lin,PG,24,HOU,82,82,2640,396,897,.441,87,257,.339,309,640,.483,.490,216,275,.785,32,215,247,497,134,29,236,205,1095,12
Shaun Livingston,PG,27,TOT,66,16,1455,166,346,.480,0,4,0,166,342,.485,.480,85,98,.867,31,127,158,215,48,31,76,127,417,12
Brook Lopez,C,24,BRK,74,74,2253,570,1094,.521,0,1,0,570,1093,.522,.521,297,392,.758,208,304,512,70,33,154,131,152,1437,12
Robin Lopez,C,24,NOH,82,82,2136,384,719,.534,0,0,0,384,719,.534,.534,161,207,.778,226,236,462,64,32,128,110,167,929,12
Kevin Love,PF,24,MIN,18,18,618,105,298,.352,20,92,.217,85,206,.413,.386,100,142,.704,64,188,252,42,13,9,39,34,330,12
Kyle Lowry,PG,26,TOR,68,52,2020,250,623,.401,101,279,.362,149,344,.433,.482,190,239,.795,56,265,321,435,94,24,157,218,791,12
John Lucas III,PG,30,TOR,63,0,827,129,334,.386,57,151,.377,72,183,.393,.472,18,25,.720,8,57,65,105,23,1,26,50,333,12
Scott Machado,PG,22,HOU,6,0,21,3,6,.500,0,1,0,3,5,.600,.500,2,2,1.000,0,1,1,6,2,0,8,0,8,12
Shelvin Mack,PG-SG,22,TOT,31,3,416,58,126,.460,18,49,.367,40,77,.519,.532,9,16,.563,3,37,40,68,15,0,34,39,143,12
Corey Maggette,SF,33,DET,18,0,257,27,76,.355,5,21,.238,22,55,.400,.388,36,48,.750,5,20,25,19,6,2,17,42,95,12
Ian Mahinmi,C,26,IND,80,2,1322,149,329,.453,0,2,0,149,327,.456,.453,104,171,.608,115,196,311,27,39,66,92,201,402,12
Shawn Marion,PF,34,DAL,67,67,2010,355,690,.514,23,73,.315,332,617,.538,.531,79,101,.782,146,379,525,163,75,47,103,111,812,12
Kendall Marshall,PG,21,PHO,48,3,702,56,151,.371,23,73,.315,33,78,.423,.447,8,14,.571,4,38,42,143,22,4,57,48,143,12
Cartier Martin,SF,28,WAS,41,3,694,96,252,.381,58,146,.397,38,106,.358,.496,20,28,.714,11,89,100,20,19,6,32,58,270,12
Kenyon Martin,C,35,NYK,18,11,431,56,93,.602,0,0,0,56,93,.602,.602,17,40,.425,34,61,95,8,16,17,16,64,129,12
Kevin Martin,SG,29,OKC,77,0,2136,350,778,.450,158,371,.426,192,407,.472,.551,219,246,.890,31,147,178,106,72,8,101,138,1077,12
Roger Mason,SG,32,NOH,69,13,1219,132,305,.433,66,159,.415,66,146,.452,.541,39,43,.907,11,121,132,74,26,11,51,104,369,12
Wesley Matthews,SG,26,POR,69,69,2403,352,808,.436,169,425,.398,183,383,.478,.540,149,187,.797,35,156,191,174,90,18,109,172,1022,12
Jason Maxiell,PF,29,DET,72,71,1789,204,457,.446,0,0,0,204,457,.446,.446,90,145,.621,135,274,409,54,32,95,81,172,498,12
Eric Maynor,PG-SG,25,TOT,64,0,963,106,281,.377,34,96,.354,72,185,.389,.438,45,62,.726,9,37,46,182,22,1,79,55,291,12
O.J. Mayo,SG,25,DAL,82,82,2913,461,1026,.449,142,349,.407,319,677,.471,.519,191,233,.820,36,255,291,361,93,23,210,195,1255,12
Luc Mbah a Moute,SF,26,MIL,58,45,1326,151,377,.401,13,37,.351,138,340,.406,.418,72,126,.571,89,167,256,55,42,14,70,82,387,12
JaVale McGee,C,25,DEN,79,0,1433,303,527,.575,1,1,1.000,302,526,.574,.576,110,186,.591,158,223,381,24,30,157,90,184,717,12
Dominic McGuire,SF,27,TOT,26,10,387,24,56,.429,0,0,0,24,56,.429,.429,3,10,.300,19,59,78,20,13,11,12,39,51,12
Josh McRoberts,PF,25,TOT,67,22,1487,156,343,.455,24,84,.286,132,259,.510,.490,65,85,.765,93,232,325,141,32,27,66,131,401,12
Jodie Meeks,SG,25,LAL,78,10,1663,205,530,.387,122,342,.357,83,188,.441,.502,86,96,.896,37,134,171,69,58,5,52,103,618,12
Fab Melo,C,22,BOS,6,0,36,3,6,.500,0,0,0,3,6,.500,.500,1,4,.250,0,3,3,0,2,2,1,7,7,12
Khris Middleton,SG,21,DET,27,0,475,62,141,.440,14,45,.311,48,96,.500,.489,27,32,.844,4,46,50,28,15,4,11,53,165,12
C.J. Miles,SF,25,CLE,65,13,1364,255,614,.415,126,328,.384,129,286,.451,.518,93,107,.869,24,150,174,63,49,17,69,138,729,12
Darko Miličić,C,27,BOS,1,0,5,0,1,0,0,0,0,0,1,0,0,0,0,0,0,1,1,0,0,0,2,1,0,12
Andre Miller,PG,36,DEN,82,11,2151,303,632,.479,17,64,.266,286,568,.504,.493,163,194,.840,60,178,238,484,73,11,172,159,786,12
Darius Miller,SF,22,NOH,52,2,694,44,108,.407,22,56,.393,22,52,.423,.509,8,8,1.000,8,70,78,44,17,12,23,89,118,12
Mike Miller,SF,32,MIA,59,17,900,100,231,.433,73,175,.417,27,56,.482,.591,8,11,.727,18,139,157,99,21,4,35,63,281,12
Quincy Miller,PF,20,DEN,7,0,26,4,12,.333,0,1,0,4,11,.364,.333,1,2,.500,1,1,2,3,1,0,1,3,9,12
Patty Mills,PG,24,SAS,58,2,656,113,241,.469,52,130,.400,61,111,.550,.577,16,19,.842,9,41,50,62,26,4,39,55,294,12
Paul Millsap,PF,27,UTA,78,78,2375,429,875,.490,13,39,.333,416,836,.498,.498,264,356,.742,177,377,554,201,102,80,138,232,1135,12
Nazr Mohammed,C,35,CHI,63,12,693,66,180,.367,0,2,0,66,178,.371,.367,34,47,.723,73,122,195,26,21,32,24,97,166,12
Greg Monroe,C,22,DET,81,81,2687,514,1058,.486,0,4,0,514,1054,.488,.486,270,392,.689,236,541,777,281,105,55,234,190,1298,12
E'Twaun Moore,SG,23,ORL,75,21,1682,237,598,.396,67,197,.340,170,401,.424,.452,47,59,.797,48,119,167,206,51,23,105,122,588,12
Darius Morris,PG,22,LAL,48,17,683,73,188,.388,24,66,.364,49,122,.402,.452,24,37,.649,24,33,57,76,21,2,45,58,194,12
Marcus Morris,PF-SF,23,TOT,77,23,1524,222,526,.422,86,233,.369,136,293,.464,.504,66,117,.564,80,197,277,62,45,20,77,160,596,12
Markieff Morris,PF,23,PHO,82,32,1837,266,653,.407,45,134,.336,221,519,.426,.442,93,127,.732,131,265,396,108,77,64,104,209,670,12
Anthony Morrow,SG,27,TOT,41,1,383,64,145,.441,16,43,.372,48,102,.471,.497,20,22,.909,11,19,30,13,13,1,8,43,164,12
Donatas Motiejūnas,PF,22,HOU,44,14,538,97,213,.455,24,83,.289,73,130,.562,.512,32,51,.627,36,57,93,31,7,10,37,73,250,12
Arnett Moultrie,PF,22,PHI,47,0,542,78,134,.582,0,0,0,78,134,.582,.582,18,28,.643,76,69,145,10,17,10,19,43,174,12
Timofey Mozgov,C,26,DEN,41,1,366,44,87,.506,0,2,0,44,85,.518,.506,20,26,.769,50,57,107,9,6,18,25,57,108,12
Byron Mullens,PF,23,CHA,53,41,1428,217,563,.385,66,208,.317,151,355,.425,.444,64,99,.646,71,266,337,81,34,32,74,110,564,12
Kevin Murphy,SG,22,UTA,17,0,52,7,28,.250,1,5,.200,6,23,.261,.268,0,0,0,0,4,4,2,1,0,3,4,15,12
Troy Murphy,PF,32,DAL,14,1,256,22,61,.361,11,35,.314,11,26,.423,.451,10,11,.909,7,42,49,7,10,6,7,29,65,12
Steve Nash,PG,38,LAL,50,50,1627,236,475,.497,57,130,.438,179,345,.519,.557,107,116,.922,26,116,142,333,30,5,126,70,636,12
Gary Neal,SG,28,SAS,68,17,1484,246,597,.412,89,251,.355,157,346,.454,.487,64,74,.865,13,130,143,129,30,2,69,93,645,12
Jameer Nelson,PG,30,ORL,56,56,1977,306,780,.392,121,355,.341,185,425,.435,.470,89,102,.873,23,186,209,413,71,6,154,161,822,12
Andrew Nicholson,PF,23,ORL,75,28,1249,256,486,.527,0,0,0,256,486,.527,.527,75,94,.798,69,189,258,44,24,32,79,133,587,12
Joakim Noah,C,27,CHI,66,64,2426,303,630,.481,0,5,0,303,625,.485,.481,178,237,.751,260,473,733,262,78,141,176,185,784,12
Steve Novak,SF,29,NYK,81,1,1641,178,430,.414,149,351,.425,29,79,.367,.587,30,33,.909,17,135,152,35,28,8,12,97,535,12
Dirk Nowitzki,PF,34,DAL,53,47,1661,343,728,.471,65,157,.414,278,571,.487,.516,166,193,.860,37,326,363,132,38,37,70,93,917,12
Jermaine O'Neal,C,34,PHO,55,4,1029,179,371,.482,0,0,0,179,371,.482,.482,96,115,.835,82,211,293,42,19,78,73,126,454,12
Kyle O'Quinn,C,22,ORL,57,5,638,101,197,.513,0,1,0,101,196,.515,.513,30,45,.667,65,144,209,52,11,26,37,107,232,12
Lamar Odom,PF,33,LAC,82,2,1616,146,366,.399,18,90,.200,128,276,.464,.423,20,42,.476,117,363,480,142,69,58,86,214,330,12
Tim Ohlbrecht,C,24,HOU,3,0,12,1,3,.333,0,0,0,1,3,.333,.333,1,1,1.000,0,1,1,1,1,0,4,1,3,12
Emeka Okafor,C,30,WAS,79,77,2052,328,687,.477,0,0,0,328,687,.477,.477,109,191,.571,199,493,692,93,45,77,107,145,765,12
Daniel Orton,C,22,OKC,13,0,104,12,26,.462,0,0,0,12,26,.462,.462,9,17,.529,13,13,26,4,4,3,4,13,33,12
Travis Outlaw,SF,28,SAC,38,2,444,74,177,.418,14,50,.280,60,127,.472,.458,38,52,.731,17,44,61,21,11,8,19,35,200,12
Zaza Pachulia,C,28,ATL,52,15,1134,114,241,.473,0,3,0,114,238,.479,.473,78,103,.757,132,204,336,79,35,12,70,128,306,12
Jannero Pargo,PG,33,TOT,32,0,507,78,212,.368,39,116,.336,39,96,.406,.460,12,13,.923,10,25,35,67,18,3,41,42,207,12
Jeremy Pargo,PG-SG,26,TOT,39,11,655,99,250,.396,25,74,.338,74,176,.420,.446,42,62,.677,8,41,49,92,13,2,50,46,265,12
Tony Parker,PG,30,SAS,66,66,2174,519,995,.522,24,68,.353,495,927,.534,.534,279,330,.845,18,180,198,499,54,6,170,92,1341,12
Chandler Parsons,SF,24,HOU,76,76,2758,456,939,.486,152,395,.385,304,544,.559,.567,113,155,.729,79,325,404,269,75,32,147,148,1177,12
Patrick Patterson,PF,23,TOT,71,41,1775,319,623,.512,51,132,.386,268,491,.546,.553,48,63,.762,113,224,337,81,31,40,61,138,737,12
Chris Paul,PG,27,LAC,70,70,2335,412,856,.481,76,232,.328,336,624,.538,.526,286,323,.885,53,209,262,678,169,10,159,143,1186,12
Sasha Pavlović,SG,29,POR,39,1,528,42,119,.353,18,60,.300,24,59,.407,.429,1,6,.167,7,49,56,32,24,5,14,59,103,12
Nikola Peković,C,27,MIN,62,62,1959,385,741,.520,0,0,0,385,741,.520,.520,241,324,.744,230,315,545,53,43,50,101,143,1011,12
Kendrick Perkins,C,28,OKC,78,78,1954,143,313,.457,0,1,0,143,312,.458,.457,44,72,.611,110,356,466,111,43,83,109,227,330,12
Johan Petro,C,27,ATL,31,8,352,48,110,.436,1,4,.250,47,106,.443,.441,11,12,.917,33,79,112,16,10,9,24,48,108,12
Paul Pierce,SF,35,BOS,77,77,2575,476,1092,.436,145,382,.380,331,710,.466,.502,333,423,.787,45,442,487,370,84,30,214,210,1430,12
Mickaël Piétrus,SF,30,TOR,19,16,386,34,98,.347,20,64,.313,14,34,.412,.449,12,18,.667,5,31,36,9,12,6,16,33,100,12
Dexter Pittman,C,24,TOT,11,0,32,4,11,.364,0,0,0,4,11,.364,.364,0,3,0,7,5,12,0,0,0,3,8,8,12
Miles Plumlee,C,24,IND,14,0,55,5,21,.238,0,0,0,5,21,.238,.238,3,4,.750,12,10,22,2,0,3,3,5,13,12
Quincy Pondexter,SF,24,MEM,59,1,1243,128,299,.428,60,152,.395,68,147,.463,.528,59,75,.787,43,89,132,61,35,6,42,95,375,12
A.J. Price,PG,26,WAS,57,22,1278,161,413,.390,70,200,.350,91,213,.427,.475,49,62,.790,20,94,114,205,33,3,64,73,441,12
Ronnie Price,PG,29,POR,39,0,510,39,120,.325,10,39,.256,29,81,.358,.367,17,24,.708,13,31,44,73,26,3,34,61,105,12
Pablo Prigioni,PG,35,NYK,78,18,1263,100,220,.455,53,134,.396,47,86,.547,.575,22,25,.880,41,102,143,236,69,2,86,127,275,12
Tayshaun Prince,SF,32,TOT,82,81,2631,359,820,.438,38,94,.404,321,726,.442,.461,96,130,.738,72,292,364,196,48,25,89,86,852,12
Joel Przybilla,C,33,MIL,12,1,68,1,4,.250,0,0,0,1,4,.250,.250,0,2,0,5,16,21,4,1,2,4,10,2,12
Chris Quinn,SG,29,CLE,7,0,78,4,16,.250,0,5,0,4,11,.364,.250,2,2,1.000,1,1,2,9,3,0,6,4,10,12
Vladimir Radmanović,PF,32,CHI,25,0,144,13,43,.302,5,27,.185,8,16,.500,.360,2,3,.667,10,18,28,8,8,4,7,29,33,12
Anthony Randolph,PF,23,DEN,39,0,329,56,114,.491,0,8,0,56,106,.528,.491,31,45,.689,29,66,95,12,19,21,37,41,143,12
Shavlik Randolph,PF,29,BOS,16,0,198,28,48,.583,0,0,0,28,48,.583,.583,11,27,.407,28,42,70,4,8,7,10,38,67,12
Zach Randolph,PF,31,MEM,76,75,2607,471,1024,.460,2,23,.087,469,1001,.469,.461,225,300,.750,310,544,854,108,61,31,150,180,1169,12
J.J. Redick,SG,28,TOT,78,13,2379,382,880,.434,165,451,.366,217,429,.506,.528,171,190,.900,17,154,171,296,38,9,138,117,1100,12
Jason Richardson,SG,32,PHI,33,33,936,135,336,.402,57,167,.341,78,169,.462,.487,20,33,.606,19,108,127,51,40,15,26,57,347,12
Quentin Richardson,SF,32,NYK,1,0,29,1,11,.091,1,4,.250,0,7,0,.136,2,2,1.000,5,5,10,1,0,0,2,1,5,12
Luke Ridnour,SG,31,MIN,82,82,2474,367,811,.453,66,212,.311,301,599,.503,.493,139,164,.848,41,165,206,311,82,15,130,187,939,12
Austin Rivers,SG,20,NOH,61,26,1418,145,390,.372,28,86,.326,117,304,.385,.408,59,108,.546,16,93,109,127,26,9,74,122,377,12
Brian Roberts,PG,27,NOH,78,5,1324,213,511,.417,59,153,.386,154,358,.430,.475,70,77,.909,17,80,97,219,37,3,71,108,555,12
Nate Robinson,PG,28,CHI,82,23,2086,399,921,.433,141,348,.405,258,573,.450,.510,135,169,.799,29,155,184,358,85,10,144,207,1074,12
Thomas Robinson,PF,21,TOT,70,0,1056,138,321,.430,0,1,0,138,320,.431,.430,57,109,.523,122,193,315,46,41,26,88,124,333,12
Rajon Rondo,PG,26,BOS,38,38,1423,225,465,.484,12,50,.240,213,415,.513,.497,60,93,.645,43,169,212,420,70,9,148,96,522,12
Terrence Ross,SG,21,TOR,73,2,1239,186,457,.407,65,196,.332,121,261,.464,.478,30,42,.714,35,109,144,53,43,14,48,122,467,12
Brandon Roy,SG,28,MIN,5,5,122,11,35,.314,0,9,0,11,26,.423,.314,7,10,.700,3,11,14,23,3,0,7,5,29,12
Ricky Rubio,PG,22,MIN,57,47,1691,185,514,.360,27,92,.293,158,422,.374,.386,211,264,.799,44,185,229,418,137,5,172,143,608,12
Brandon Rush,SF,27,GSW,2,0,25,6,9,.667,0,2,0,6,7,.857,.667,2,3,.667,0,1,1,2,0,0,3,5,14,12
Robert Sacre,C,23,LAL,32,3,203,18,48,.375,0,0,0,18,48,.375,.375,7,11,.636,9,25,34,6,0,10,10,38,43,12
John Salmons,SF,33,SAC,76,72,2278,244,612,.399,99,267,.371,145,345,.420,.480,85,110,.773,33,174,207,226,51,25,85,143,672,12
Samardo Samuels,C,24,CLE,18,1,196,22,60,.367,0,1,0,22,59,.373,.367,14,24,.583,10,18,28,8,3,3,6,30,58,12
Larry Sanders,C,24,MIL,71,55,1937,306,605,.506,0,2,0,306,603,.507,.506,84,136,.618,224,448,672,83,53,201,87,233,696,12
Luis Scola,PF,32,PHO,82,67,2184,432,915,.472,3,16,.188,429,899,.477,.474,181,230,.787,158,383,541,182,67,35,126,257,1048,12
Mike Scott,PF,24,ATL,40,1,376,70,147,.476,0,1,0,70,146,.479,.476,43,56,.768,39,71,110,12,4,2,21,32,183,12
Thabo Sefolosha,SG,28,OKC,81,81,2229,224,466,.481,108,258,.419,116,208,.558,.597,57,69,.826,58,259,317,125,103,44,64,177,613,12
Josh Selby,PG,21,MEM,10,0,59,6,22,.273,1,6,.167,5,16,.313,.295,7,11,.636,0,5,5,4,2,0,7,7,20,12
Kevin Séraphin,C,23,WAS,79,8,1721,330,716,.461,0,0,0,330,716,.461,.461,61,88,.693,107,239,346,57,24,59,130,211,721,12
Ramon Sessions,SG,26,CHA,61,0,1652,276,676,.408,33,107,.308,243,569,.427,.433,291,347,.839,27,142,169,230,48,7,104,91,876,12
Tornike Shengelia,SF,21,BRK,19,0,93,10,23,.435,1,2,.500,9,21,.429,.457,9,16,.563,9,14,23,3,3,1,11,11,30,12
Iman Shumpert,SG,22,NYK,45,45,996,109,275,.396,51,127,.402,58,148,.392,.489,36,47,.766,31,105,136,75,43,7,37,99,305,12
Alexey Shved,SG,24,MIN,77,16,1840,236,635,.372,85,288,.295,151,347,.435,.439,108,150,.720,41,134,175,286,54,27,147,117,665,12
Henry Sims,C,22,NOH,2,0,5,2,3,.667,0,0,0,2,3,.667,.667,0,0,0,2,0,2,0,0,0,1,1,4,12
Kyle Singler,SF,24,DET,82,74,2293,275,642,.428,70,200,.350,205,442,.464,.483,100,124,.806,109,221,330,77,57,37,98,217,720,12
Chris Singleton,PF,23,WAS,57,11,924,92,241,.382,7,36,.194,85,205,.415,.396,40,70,.571,51,133,184,37,38,24,45,124,231,12
Donald Sloan,SG-PG,25,TOT,23,0,263,27,78,.346,7,19,.368,20,59,.339,.391,20,25,.800,3,25,28,38,5,0,14,17,81,12
Greg Smith,C,22,HOU,70,10,1110,170,274,.620,0,1,0,170,273,.623,.620,81,130,.623,111,210,321,25,18,40,41,175,421,12
Ish Smith,PG,24,TOT,52,3,516,56,159,.352,8,27,.296,48,132,.364,.377,3,7,.429,12,49,61,87,21,9,37,26,123,12
J.R. Smith,SG,27,NYK,80,0,2678,527,1249,.422,155,436,.356,372,813,.458,.484,237,311,.762,64,361,425,218,100,24,134,226,1446,12
Jason Smith,C,26,NOH,51,0,876,167,341,.490,0,4,0,167,337,.496,.490,86,102,.843,64,122,186,34,15,45,55,123,420,12
Josh Smith,PF,27,ATL,76,76,2683,550,1182,.465,61,201,.303,489,981,.498,.491,166,321,.517,133,506,639,321,94,136,226,175,1327,12
Nolan Smith,PG,24,POR,40,0,288,42,114,.368,6,28,.214,36,86,.419,.395,20,28,.714,7,20,27,35,7,1,29,26,110,12
Marreese Speights,C,25,TOT,79,3,1300,260,584,.445,3,10,.300,257,574,.448,.448,135,175,.771,146,240,386,47,24,53,80,175,658,12
Tiago Splitter,PF,28,SAS,81,58,1997,315,563,.560,0,2,0,315,561,.561,.560,208,285,.730,144,371,515,130,63,64,100,161,838,12
Jerry Stackhouse,SF,38,BRK,37,0,544,66,172,.384,30,89,.337,36,83,.434,.471,20,23,.870,5,28,33,35,7,4,24,31,182,12
Lance Stephenson,SG,22,IND,78,72,2278,275,598,.460,62,188,.330,213,410,.520,.512,75,115,.652,47,257,304,223,81,16,109,162,687,12
DeShawn Stevenson,SG,31,ATL,56,31,1158,98,262,.374,76,209,.364,22,53,.415,.519,12,23,.522,18,104,122,52,29,6,23,69,284,12
Greg Stiemsma,C,27,MIN,76,19,1209,127,278,.457,0,0,0,127,278,.457,.457,53,69,.768,61,200,261,30,44,90,59,184,307,12
Julyan Stone,PG,24,DEN,4,0,28,2,2,1.000,0,0,0,2,2,1.000,1.000,3,4,.750,2,1,3,2,1,0,2,4,7,12
Amar'e Stoudemire,PF,30,NYK,29,0,682,154,267,.577,0,0,0,154,267,.577,.577,105,130,.808,60,85,145,13,10,21,50,89,413,12
Rodney Stuckey,SG,26,DET,76,24,2171,304,748,.406,55,182,.302,249,566,.440,.443,213,272,.783,43,169,212,270,51,17,134,127,876,12
Jared Sullinger,PF,20,BOS,45,5,892,111,225,.493,1,5,.200,110,220,.500,.496,47,63,.746,92,172,264,35,22,22,29,154,270,12
DaJuan Summers,PF,25,LAC,2,0,7,1,4,.250,0,0,0,1,4,.250,.250,0,0,0,0,2,2,1,0,0,0,0,2,12
Jeff Taylor,SF,23,CHA,77,29,1507,172,399,.431,53,154,.344,119,245,.486,.497,75,103,.728,51,99,150,63,47,15,48,136,472,12
Tyshawn Taylor,PG,22,BRK,38,0,221,32,87,.368,6,13,.462,26,74,.351,.402,15,27,.556,2,16,18,21,13,0,25,25,85,12
Jeff Teague,PG,24,ATL,80,78,2628,439,974,.451,89,248,.359,350,726,.482,.496,199,226,.881,25,155,180,579,117,28,230,181,1166,12
Marquis Teague,PG,19,CHI,48,0,392,43,113,.381,4,23,.174,39,90,.433,.398,9,16,.563,3,41,44,63,9,7,35,47,99,12
Mirza Teletović,PF,27,BRK,53,0,499,71,185,.384,37,108,.343,34,77,.442,.484,9,11,.818,33,62,95,23,13,8,20,53,188,12
Sebastian Telfair,PG,27,TOT,59,2,980,112,309,.362,53,150,.353,59,159,.371,.448,54,69,.783,13,71,84,153,37,11,64,104,331,12
Garrett Temple,SG,26,WAS,51,36,1156,105,258,.407,26,80,.325,79,178,.444,.457,26,37,.703,29,94,123,115,50,17,61,94,262,12
Jason Terry,SG,35,BOS,79,24,2124,281,648,.434,123,331,.372,158,317,.498,.529,114,131,.870,19,140,159,198,66,11,102,110,799,12
Hasheem Thabeet,C,25,OKC,66,4,770,64,106,.604,0,0,0,64,106,.604,.604,32,53,.604,69,126,195,11,30,60,41,148,160,12
Isaiah Thomas,PG,23,SAC,79,62,2122,366,832,.440,115,321,.358,251,511,.491,.509,253,287,.882,29,132,161,316,67,3,140,167,1100,12
Kurt Thomas,PF,40,NYK,39,17,392,45,83,.542,1,1,1.000,44,82,.537,.548,6,13,.462,24,65,89,21,10,16,8,52,97,12
Lance Thomas,SF,24,NOH,59,9,646,53,106,.500,0,0,0,53,106,.500,.500,43,59,.729,44,71,115,17,11,7,14,78,149,12
Malcolm Thomas,PF,24,TOT,12,0,57,5,10,.500,0,0,0,5,10,.500,.500,5,8,.625,5,11,16,4,2,2,3,8,15,12
Tyrus Thomas,PF,26,CHA,26,2,360,48,136,.353,3,8,.375,45,128,.352,.364,26,31,.839,16,44,60,19,14,15,17,51,125,12
Jason Thompson,PF,26,SAC,82,81,2285,374,745,.502,0,3,0,374,742,.504,.502,143,206,.694,172,377,549,84,48,61,101,227,891,12
Klay Thompson,SG,22,GSW,82,82,2936,508,1205,.422,211,526,.401,297,679,.437,.509,132,157,.841,32,274,306,183,86,45,157,237,1359,12
Tristan Thompson,PF,21,CLE,82,82,2564,390,799,.488,0,3,0,390,796,.490,.488,177,291,.608,306,467,773,108,60,71,123,234,957,12
Marcus Thornton,SG,25,SAC,72,8,1726,332,774,.429,141,379,.372,191,395,.484,.520,111,126,.881,50,131,181,91,61,4,68,105,916,12
Jamaal Tinsley,PG,34,UTA,66,32,1221,86,234,.368,39,127,.307,47,107,.439,.451,18,26,.692,17,98,115,290,64,14,106,106,229,12
Anthony Tolliver,SF,27,ATL,62,11,963,82,216,.380,45,133,.338,37,83,.446,.484,44,51,.863,31,124,155,32,15,12,36,66,253,12
P.J. Tucker,SG,27,PHO,79,45,1910,210,444,.473,22,70,.314,188,374,.503,.498,64,86,.744,132,218,350,109,62,19,67,145,506,12
Ronny Turiaf,C,30,LAC,65,0,701,49,97,.505,0,0,0,49,97,.505,.505,23,63,.365,45,107,152,35,19,35,29,80,121,12
Hedo Türkoğlu,SF,33,ORL,11,1,189,14,53,.264,1,24,.042,13,29,.448,.274,3,6,.500,4,22,26,23,7,1,12,11,32,12
Evan Turner,SF,24,PHI,82,82,2892,441,1053,.419,58,159,.365,383,894,.428,.446,154,208,.740,56,461,517,354,71,17,187,197,1094,12
Jeremy Tyler,C,21,TOT,21,0,68,9,24,.375,0,0,0,9,24,.375,.375,4,6,.667,6,14,20,1,1,2,6,10,22,12
Ekpe Udoh,C,25,MIL,76,9,1312,117,269,.435,0,1,0,117,268,.437,.435,89,119,.748,113,138,251,43,39,85,43,139,323,12
Beno Udrih,SG-PG,30,TOT,66,9,1457,210,476,.441,34,102,.333,176,374,.471,.477,84,103,.816,34,107,141,302,41,3,108,90,538,12
Jonas Valančiūnas,C,20,TOR,62,57,1482,204,366,.557,0,0,0,204,366,.557,.557,146,185,.789,121,251,372,45,17,78,94,188,554,12
Anderson Varejão,C,30,CLE,25,25,901,138,289,.478,0,5,0,138,284,.486,.478,77,102,.755,138,223,361,84,37,14,44,68,353,12
Jarvis Varnado,PF,24,TOT,13,0,58,3,7,.429,0,0,0,3,7,.429,.429,2,4,.500,2,7,9,3,1,2,6,10,8,12
Greivis Vásquez,PG,26,NOH,78,78,2685,438,1012,.433,83,243,.342,355,769,.462,.474,124,154,.805,43,294,337,704,66,6,247,190,1083,12
Jan Veselý,PF,22,WAS,51,4,601,57,114,.500,0,1,0,57,113,.504,.500,12,39,.308,43,79,122,28,15,17,27,107,126,12
Charlie Villanueva,PF,28,DET,69,0,1092,175,464,.377,90,259,.347,85,205,.415,.474,27,49,.551,49,192,241,54,31,39,39,96,467,12
Nikola Vučević,C,22,ORL,77,77,2559,461,889,.519,0,3,0,461,886,.520,.519,86,126,.683,273,644,917,143,61,79,141,218,1008,12
Dwyane Wade,SG,31,MIA,69,69,2391,569,1093,.521,17,66,.258,552,1027,.537,.528,308,425,.725,86,258,344,352,128,56,194,140,1463,12
Dion Waiters,SG,21,CLE,61,48,1756,336,815,.412,63,203,.310,273,612,.446,.451,159,213,.746,22,127,149,183,59,16,121,113,894,12
Kemba Walker,PG,22,CHA,82,82,2859,526,1244,.423,107,332,.322,419,912,.459,.466,296,371,.798,60,223,283,471,160,31,200,153,1455,12
John Wall,PG,22,WAS,49,42,1602,324,735,.441,12,45,.267,312,690,.452,.449,246,306,.804,35,161,196,373,65,37,157,117,906,12
Gerald Wallace,SF,30,BRK,69,68,2076,182,458,.397,46,163,.282,136,295,.461,.448,121,190,.637,69,250,319,181,97,46,110,118,531,12
Rasheed Wallace,C,38,NYK,21,0,296,55,142,.387,22,69,.319,33,73,.452,.465,14,20,.700,11,72,83,6,13,15,10,40,146,12
Luke Walton,PF,32,CLE,50,0,857,71,181,.392,20,67,.299,51,114,.447,.448,10,20,.500,38,107,145,166,42,13,60,98,172,12
Hakim Warrick,PF,30,TOT,28,14,489,67,165,.406,0,3,0,67,162,.414,.406,60,88,.682,21,68,89,25,13,6,29,37,194,12
C.J. Watson,PG,28,BRK,80,8,1521,192,459,.418,88,214,.411,104,245,.424,.514,71,91,.780,38,107,145,161,66,12,69,123,543,12
Earl Watson,PG,33,UTA,48,4,829,37,120,.308,5,28,.179,32,92,.348,.329,17,25,.680,23,64,87,190,40,8,69,94,96,12
Maalik Wayns,PG,21,TOT,27,1,202,26,88,.295,7,31,.226,19,57,.333,.335,17,19,.895,1,6,7,27,6,0,15,26,76,12
Martell Webster,SF,26,WAS,76,62,2200,281,636,.442,139,329,.422,142,307,.463,.551,168,198,.848,53,241,294,143,49,17,90,166,869,12
David West,PF,32,IND,73,73,2435,502,1009,.498,4,19,.211,498,990,.503,.500,242,315,.768,145,418,563,213,74,69,157,149,1250,12
Russell Westbrook,PG,24,OKC,82,82,2861,673,1535,.438,97,300,.323,576,1235,.466,.470,460,575,.800,111,317,428,607,145,24,273,189,1903,12
D.J. White,PF,26,BOS,12,0,86,12,23,.522,0,0,0,12,23,.522,.522,5,9,.556,4,9,13,4,1,6,2,5,29,12
James White,SF,30,NYK,57,16,435,50,116,.431,14,41,.341,36,75,.480,.491,11,19,.579,5,43,48,29,13,4,17,44,125,12
Chris Wilcox,C,30,BOS,61,7,830,110,153,.719,0,1,0,110,152,.724,.719,39,58,.672,55,125,180,22,32,28,34,125,259,12
Damien Wilkins,SG,33,PHI,61,21,1095,145,316,.459,17,51,.333,128,265,.483,.486,81,109,.743,32,73,105,91,37,18,49,98,388,12
Deron Williams,PG,28,BRK,78,78,2842,495,1124,.440,169,447,.378,326,677,.482,.516,317,369,.859,29,203,232,604,75,30,218,194,1476,12
Derrick Williams,PF,21,MIN,78,56,1916,338,786,.430,65,196,.332,273,590,.463,.471,192,272,.706,96,334,430,46,44,37,101,127,933,12
Lou Williams,SG,26,ATL,39,9,1119,187,443,.422,72,196,.367,115,247,.466,.503,105,121,.868,8,72,80,139,44,10,74,55,551,12
Marvin Williams,SF,26,UTA,73,51,1727,199,470,.423,54,166,.325,145,304,.477,.481,77,99,.778,55,208,263,77,37,38,60,98,529,12
Mo Williams,PG,30,UTA,46,46,1418,229,533,.430,59,154,.383,170,379,.449,.485,75,85,.882,24,86,110,285,46,9,125,105,592,12
Reggie Williams,SF,26,CHA,40,0,380,57,132,.432,22,72,.306,35,60,.583,.515,10,21,.476,8,43,51,39,12,1,19,19,146,12
Terrence Williams,SF,25,BOS,24,0,318,48,97,.495,5,15,.333,43,82,.524,.521,9,21,.429,4,40,44,38,11,2,22,13,110,12
Metta World Peace,SF,33,LAL,75,66,2530,332,824,.403,141,412,.342,191,412,.464,.488,124,169,.734,101,271,372,112,122,42,98,198,929,12
Brandan Wright,C,25,DAL,64,16,1149,241,404,.597,0,3,0,241,401,.601,.597,59,96,.615,85,175,260,38,26,76,34,78,541,12
Chris Wright,SG,23,DAL,3,0,4,1,2,.500,0,0,0,1,2,.500,.500,0,0,0,0,0,0,0,0,0,1,0,2,12
Dorell Wright,SF,27,PHI,79,8,1783,237,599,.396,135,361,.374,102,238,.429,.508,120,141,.851,42,260,302,150,62,35,64,98,729,12
Tony Wroten,SG,19,MEM,35,0,272,33,86,.384,4,16,.250,29,70,.414,.407,21,29,.724,13,15,28,43,8,4,29,34,91,12
Nick Young,SG,27,PHI,59,17,1411,224,542,.413,75,210,.357,149,332,.449,.482,105,128,.820,24,106,130,84,36,14,50,84,628,12
Sam Young,SG,27,IND,56,3,693,58,148,.392,16,52,.308,42,96,.438,.446,23,43,.535,26,97,123,42,15,8,33,62,155,12
Thaddeus Young,PF,24,PHI,76,76,2629,509,958,.531,1,8,.125,508,950,.535,.532,108,188,.574,182,389,571,125,133,55,90,191,1127,12
Luke Zeller,C,25,PHO,16,0,58,9,26,.346,1,5,.200,8,21,.381,.365,0,0,0,1,9,10,3,0,0,0,5,19,12
Tyler Zeller,C,23,CLE,77,55,2033,245,559,.438,0,4,0,245,555,.441,.438,120,157,.764,159,279,438,96,35,70,95,251,610,12
Quincy Acy,SF,23,TOT,63,0,847,66,141,.468,4,15,.267,62,126,.492,.482,35,53,.660,72,144,216,28,23,26,30,122,171,13
Steven Adams,C,20,OKC,81,20,1197,93,185,.503,0,0,0,93,185,.503,.503,79,136,.581,142,190,332,43,40,57,71,203,265,13
Jeff Adrien,PF,27,TOT,53,12,961,143,275,.520,0,0,0,143,275,.520,.520,76,119,.639,102,204,306,38,24,36,39,108,362,13
Arron Afflalo,SG,28,ORL,73,73,2552,464,1011,.459,128,300,.427,336,711,.473,.522,274,336,.815,32,230,262,248,35,3,146,136,1330,13
Alexis Ajinça,C,25,NOP,56,30,951,136,249,.546,0,1,0,136,248,.548,.546,56,67,.836,94,183,277,40,23,46,63,187,328,13
Cole Aldrich,C,25,NYK,46,2,330,33,61,.541,0,0,0,33,61,.541,.541,26,30,.867,37,92,129,14,8,30,18,40,92,13
LaMarcus Aldridge,PF,28,POR,69,69,2498,652,1423,.458,3,15,.200,649,1408,.461,.459,296,360,.822,166,599,765,178,63,68,123,147,1603,13
Lavoy Allen,PF,24,TOT,65,2,1072,134,300,.447,2,13,.154,132,287,.460,.450,33,50,.660,119,192,311,71,24,33,44,126,303,13
Ray Allen,SG,38,MIA,73,9,1936,240,543,.442,116,309,.375,124,234,.530,.549,105,116,.905,23,182,205,143,54,8,84,115,701,13
Tony Allen,SG,32,MEM,55,28,1278,204,413,.494,11,47,.234,193,366,.527,.507,76,121,.628,79,129,208,94,90,19,90,121,495,13
Al-Farouq Aminu,SF,23,NOP,80,65,2045,234,494,.474,13,48,.271,221,446,.496,.487,91,137,.664,129,367,496,114,82,38,88,147,572,13
Lou Amundson,PF,31,TOT,19,0,185,16,32,.500,0,0,0,16,32,.500,.500,6,24,.250,28,27,55,6,9,11,14,49,38,13
Chris Andersen,C,35,MIA,72,0,1396,177,275,.644,3,12,.250,174,263,.662,.649,120,169,.710,129,250,379,19,32,97,53,162,477,13
Alan Anderson,SF,31,BRK,78,26,1773,194,485,.400,84,248,.339,110,237,.464,.487,92,118,.780,40,135,175,81,48,11,62,147,564,13
James Anderson,SG,24,PHI,80,62,2309,309,717,.431,115,351,.328,194,366,.530,.511,77,106,.726,59,241,300,149,74,28,106,154,810,13
Ryan Anderson,PF,25,NOP,22,14,795,155,354,.438,67,164,.409,88,190,.463,.532,59,62,.952,66,76,142,17,10,7,20,47,436,13
Giannis Antetokounmpo,SF,19,MIL,77,23,1897,173,418,.414,41,118,.347,132,300,.440,.463,138,202,.683,78,261,339,150,60,61,122,173,525,13
Carmelo Anthony,PF,29,NYK,77,77,2982,743,1643,.452,167,415,.402,576,1228,.469,.503,459,541,.848,145,477,622,242,95,51,198,224,2112,13
Joel Anthony,C,31,TOT,33,0,186,12,32,.375,0,0,0,12,32,.375,.375,4,8,.500,15,23,38,2,3,12,3,17,28,13
Pero Antić,C,31,ATL,50,26,925,123,294,.418,56,171,.327,67,123,.545,.514,50,66,.758,57,152,209,58,19,12,55,126,352,13
Trevor Ariza,SF,28,WAS,77,77,2723,389,853,.456,180,442,.407,209,411,.509,.562,149,193,.772,99,376,475,191,126,20,132,179,1107,13
Hilton Armstrong,C,29,GSW,15,1,97,9,19,.474,0,0,0,9,19,.474,.474,7,16,.438,19,28,47,5,4,4,6,11,25,13
Darrell Arthur,SF,25,DEN,68,1,1161,162,410,.395,24,64,.375,138,346,.399,.424,53,62,.855,52,158,210,61,39,47,58,185,401,13
Ömer Aşık,C,27,HOU,48,19,968,101,190,.532,0,0,0,101,190,.532,.532,78,126,.619,101,277,378,25,14,37,59,92,280,13
D.J. Augustin,PG,26,TOT,71,9,1939,298,718,.415,133,332,.401,165,386,.427,.508,201,227,.885,15,115,130,313,53,3,125,147,930,13
Gustavo Ayón,C,28,ATL,26,14,429,52,102,.510,0,0,0,52,102,.510,.510,8,20,.400,42,83,125,28,25,10,29,47,112,13
Jeff Ayres,PF,26,SAS,73,10,952,101,174,.580,0,0,0,101,174,.580,.580,38,55,.691,89,169,258,60,13,25,63,146,240,13
Chris Babb,SG,23,BOS,14,0,132,8,30,.267,6,27,.222,2,3,.667,.367,0,0,0,4,13,17,3,6,0,3,13,22,13
Luke Babbitt,PF,24,NOP,27,2,473,60,154,.390,36,95,.379,24,59,.407,.506,14,18,.778,18,70,88,29,7,11,15,52,170,13
Leandro Barbosa,PG,31,PHO,20,0,368,56,131,.427,7,25,.280,49,106,.462,.454,31,39,.795,5,32,37,32,7,4,19,30,150,13
J.J. Barea,PG,29,MIN,79,1,1471,254,656,.387,73,231,.316,181,425,.426,.443,79,100,.790,16,138,154,303,26,0,125,129,660,13
Andrea Bargnani,C,28,NYK,42,39,1257,222,502,.442,30,108,.278,192,394,.487,.472,84,102,.824,69,153,222,45,14,52,58,100,558,13
Harrison Barnes,SF,21,GSW,78,24,2204,271,679,.399,66,190,.347,205,489,.419,.448,130,181,.718,66,245,311,116,65,20,84,158,738,13
Matt Barnes,SF,33,LAC,63,40,1735,231,527,.438,97,283,.343,134,244,.549,.530,66,90,.733,60,232,292,125,56,28,85,185,625,13
Will Barton,SG,23,POR,41,0,387,65,156,.417,10,33,.303,55,123,.447,.449,26,32,.813,16,58,74,33,9,7,18,31,166,13
Brandon Bass,PF,28,BOS,82,73,2266,352,725,.486,2,6,.333,350,719,.487,.487,205,239,.858,161,309,470,87,36,71,102,190,911,13
Shane Battier,SF,35,MIA,73,56,1468,105,275,.382,73,210,.348,32,65,.492,.515,15,23,.652,34,104,138,63,50,39,21,124,298,13
Nicolas Batum,SF,25,POR,82,82,2956,381,819,.465,145,402,.361,236,417,.566,.554,163,203,.803,116,495,611,420,75,57,208,156,1070,13
Jerryd Bayless,PG,25,TOT,72,19,1686,248,617,.402,76,212,.358,172,405,.425,.464,94,118,.797,22,123,145,194,60,9,82,161,666,13
Aron Baynes,C,27,SAS,53,4,491,71,163,.436,0,0,0,71,163,.436,.436,19,21,.905,57,88,145,34,2,5,36,77,161,13
Kent Bazemore,SG,24,TOT,67,15,911,147,343,.429,43,128,.336,104,215,.484,.491,66,109,.606,10,107,117,91,43,13,79,102,403,13
Bradley Beal,SG,20,WAS,73,73,2530,481,1149,.419,138,343,.402,343,806,.426,.479,149,189,.788,54,219,273,243,71,18,128,153,1249,13
Michael Beasley,SF,25,MIA,55,2,831,177,355,.499,21,54,.389,156,301,.518,.528,61,79,.772,31,141,172,42,23,21,57,93,436,13
Marco Belinelli,SF,27,SAS,80,25,2016,337,695,.485,126,293,.430,211,402,.525,.576,111,131,.847,18,208,226,179,50,7,95,130,911,13
Anthony Bennett,PF,20,CLE,52,0,663,80,225,.356,13,53,.245,67,172,.390,.384,44,69,.638,49,106,155,17,21,8,47,93,217,13
Patrick Beverley,PG,25,HOU,56,55,1751,199,481,.414,92,255,.361,107,226,.473,.509,83,102,.814,72,124,196,151,77,23,66,174,573,13
Andris Biedriņš,C,27,UTA,6,0,45,1,1,1.000,0,0,0,1,1,1.000,1.000,1,6,.167,2,15,17,0,0,0,2,6,3,13
Chauncey Billups,SG,37,DET,19,7,309,24,79,.304,14,48,.292,10,31,.323,.392,10,12,.833,4,24,28,42,8,1,25,25,72,13
Bismack Biyombo,C,21,CHA,77,9,1072,88,144,.611,0,0,0,88,144,.611,.611,46,89,.517,105,261,366,8,7,86,40,124,222,13
DeJuan Blair,PF,24,DAL,78,13,1214,210,393,.534,0,2,0,210,391,.537,.534,77,121,.636,139,229,368,70,60,21,77,192,497,13
Steve Blake,PG,33,TOT,55,28,1498,133,353,.377,79,210,.376,54,143,.378,.489,33,43,.767,13,146,159,307,54,8,102,85,378,13
Andray Blatche,PF,27,BRK,73,7,1618,321,674,.476,15,54,.278,306,620,.494,.487,164,221,.742,120,270,390,112,75,38,110,166,821,13
Eric Bledsoe,PG,24,PHO,43,40,1416,265,556,.477,50,140,.357,215,416,.517,.522,183,237,.772,27,175,202,235,69,14,143,99,763,13
Vander Blue,SG,21,BOS,3,0,15,2,4,.500,0,1,0,2,3,.667,.500,1,5,.200,0,3,3,1,0,0,2,1,5,13
Keith Bogans,SG,33,BOS,6,0,55,3,6,.500,3,6,.500,0,0,0,.750,3,3,1.000,0,3,3,3,1,0,1,2,12,13
Andrew Bogut,C,29,GSW,67,67,1769,235,375,.627,0,0,0,235,375,.627,.627,22,64,.344,182,489,671,112,47,121,97,210,492,13
Matt Bonner,PF,33,SAS,61,0,690,73,164,.445,42,98,.429,31,66,.470,.573,9,12,.750,16,114,130,31,15,11,16,49,197,13
Trevor Booker,PF,26,WAS,72,45,1553,222,403,.551,0,2,0,222,401,.554,.551,47,76,.618,149,230,379,64,41,45,58,131,491,13
Carlos Boozer,PF,32,CHI,76,76,2141,447,980,.456,0,2,0,447,978,.457,.456,148,193,.767,137,495,632,118,53,22,154,216,1042,13
Chris Bosh,C,29,MIA,79,79,2531,492,953,.516,74,218,.339,418,735,.569,.555,223,272,.820,98,424,522,87,80,78,125,192,1281,13
Avery Bradley,SG,23,BOS,60,58,1855,361,825,.438,79,200,.395,282,625,.451,.485,90,112,.804,48,178,226,85,63,11,96,145,891,13
Elton Brand,C,34,ATL,73,15,1414,179,332,.539,0,2,0,179,330,.542,.539,61,94,.649,97,264,361,74,40,88,60,192,419,13
Corey Brewer,SF,27,MIN,81,81,2609,388,807,.481,59,211,.280,329,596,.552,.517,163,227,.718,63,144,207,135,151,30,105,210,998,13
Ronnie Brewer,SF,28,TOT,24,3,160,3,15,.200,1,8,.125,2,7,.286,.233,0,2,0,2,12,14,10,6,1,2,4,7,13
Aaron Brooks,PG,29,TOT,72,12,1557,233,581,.401,96,248,.387,137,333,.411,.484,83,95,.874,43,97,140,233,52,13,117,146,645,13
MarShon Brooks,SG,25,TOT,35,0,316,57,125,.456,13,25,.520,44,100,.440,.508,32,44,.727,10,44,54,25,14,4,24,21,159,13
Lorenzo Brown,PG,23,PHI,26,0,224,26,86,.302,3,30,.100,23,56,.411,.320,9,13,.692,8,20,28,41,13,3,16,19,64,13
Shannon Brown,SG,28,TOT,29,1,251,24,66,.364,0,2,0,24,64,.375,.364,15,21,.714,7,21,28,9,13,0,18,24,63,13
Kobe Bryant,SG,35,LAL,6,6,177,31,73,.425,3,16,.188,28,57,.491,.445,18,21,.857,2,24,26,38,7,1,34,9,83,13
Chase Budinger,SF,25,MIN,41,8,751,100,254,.394,42,120,.350,58,134,.433,.476,32,39,.821,19,84,103,31,19,2,24,58,274,13
Reggie Bullock,SF,22,LAC,43,0,395,43,121,.355,22,73,.301,21,48,.438,.446,7,9,.778,11,43,54,12,9,1,13,26,115,13
Trey Burke,PG,21,UTA,70,68,2262,341,897,.380,111,336,.330,230,561,.410,.442,102,113,.903,37,171,208,396,42,6,131,145,895,13
Alec Burks,SG,22,UTA,78,12,2193,380,831,.457,50,143,.350,330,688,.480,.487,279,373,.748,59,198,257,212,69,14,149,190,1089,13
Caron Butler,SF,33,TOT,56,13,1419,213,540,.394,98,249,.394,115,291,.395,.485,63,75,.840,21,208,229,82,47,17,60,120,587,13
Jimmy Butler,SG,24,CHI,67,67,2591,275,693,.397,68,240,.283,207,453,.457,.446,260,338,.769,87,243,330,175,127,36,102,106,878,13
Rasual Butler,SG,34,IND,50,2,378,51,110,.464,26,62,.419,25,48,.521,.582,8,14,.571,6,35,41,17,7,9,11,30,136,13
Dwight Buycks,PG,24,TOR,14,0,146,15,48,.313,5,17,.294,10,31,.323,.365,8,9,.889,4,19,23,10,8,0,10,11,43,13
Andrew Bynum,C,26,TOT,26,19,516,94,225,.418,0,0,0,94,225,.418,.418,37,49,.755,53,92,145,29,6,29,34,31,225,13
Will Bynum,PG,31,DET,56,3,1054,184,430,.428,20,62,.323,164,368,.446,.451,97,121,.802,24,75,99,216,39,7,103,121,485,13
Nick Calathes,SG,24,MEM,71,7,1173,142,311,.457,19,61,.311,123,250,.492,.487,44,72,.611,23,114,137,207,66,8,101,117,347,13
José Calderón,PG,32,DAL,81,81,2468,341,748,.456,191,425,.449,150,323,.464,.584,52,63,.825,29,163,192,377,69,11,103,136,925,13
Kentavious Caldwell-Pope,SG,20,DET,80,41,1583,182,460,.396,59,185,.319,123,275,.447,.460,47,61,.770,38,118,156,55,75,12,28,145,470,13
Isaiah Canaan,PG,22,HOU,22,0,252,31,87,.356,18,55,.327,13,32,.406,.460,21,29,.724,7,17,24,22,8,4,21,25,101,13
DeMarre Carroll,SF,27,ATL,73,73,2341,302,642,.470,97,268,.362,205,374,.548,.546,109,141,.773,107,296,403,134,108,21,79,188,810,13
Vince Carter,SG,37,DAL,81,0,1973,330,811,.407,146,371,.394,184,440,.418,.497,161,196,.821,67,217,284,212,61,35,108,209,967,13
Michael Carter-Williams,PG,22,PHI,70,70,2414,427,1054,.405,55,208,.264,372,846,.440,.431,258,367,.703,101,336,437,441,130,43,247,213,1167,13
Omri Casspi,PF,25,HOU,71,2,1283,173,410,.422,61,176,.347,112,234,.479,.496,83,122,.680,55,205,260,88,44,14,72,100,490,13
Mario Chalmers,PG,27,MIA,73,73,2178,254,560,.454,87,226,.385,167,334,.500,.531,121,163,.742,41,173,214,357,119,16,162,210,716,13
Tyson Chandler,C,31,NYK,55,55,1662,191,322,.593,0,1,0,191,321,.595,.593,98,155,.632,159,370,529,59,36,63,71,145,480,13
Wilson Chandler,SF,26,DEN,62,55,1927,307,738,.416,122,351,.348,185,387,.478,.499,110,152,.724,58,236,294,114,46,31,79,193,846,13
Josh Childress,SF,30,NOP,4,0,24,0,0,0,0,0,0,0,0,0,0,0,0,0,0,3,3,2,1,0,1,1,0,13
Dionte Christmas,SF,27,PHO,31,0,198,22,62,.355,9,31,.290,13,31,.419,.427,18,24,.750,13,25,38,8,2,3,6,19,71,13
Earl Clark,PF,26,TOT,54,17,768,97,261,.372,41,122,.336,56,139,.403,.450,22,34,.647,22,121,143,18,17,25,31,67,257,13
Ian Clark,SG,22,UTA,23,0,172,26,67,.388,11,31,.355,15,36,.417,.470,5,7,.714,3,16,19,15,8,2,14,24,68,13
Victor Claver,SF,25,POR,21,0,184,17,42,.405,3,18,.167,14,24,.583,.440,10,11,.909,9,30,39,12,3,3,11,16,47,13
Norris Cole,PG,25,MIA,82,6,2014,207,500,.414,60,174,.345,147,326,.451,.474,53,68,.779,17,143,160,248,77,5,127,156,527,13
Jason Collins,C,35,BRK,22,1,172,11,24,.458,0,3,0,11,21,.524,.458,3,4,.750,7,12,19,4,8,1,7,30,25,13
Darren Collison,PG,26,LAC,80,35,2069,324,694,.467,71,189,.376,253,505,.501,.518,192,224,.857,47,141,188,297,93,15,132,150,911,13
Nick Collison,PF,33,OKC,81,0,1353,134,241,.556,4,17,.235,130,224,.580,.564,66,93,.710,116,177,293,104,30,28,71,187,338,13
Mike Conley,PG,26,MEM,73,73,2446,463,1030,.450,105,291,.361,358,739,.484,.500,225,276,.815,41,172,213,441,110,13,150,141,1256,13
Chris Copeland,SF,29,IND,41,0,265,55,117,.470,33,79,.418,22,38,.579,.611,10,14,.714,7,25,32,18,3,7,14,38,153,13
DeMarcus Cousins,C,23,SAC,71,71,2298,591,1191,.496,0,7,0,591,1184,.499,.496,432,595,.726,218,613,831,207,109,91,251,270,1614,13
Robert Covington,SF,23,HOU,7,0,34,6,14,.429,4,11,.364,2,3,.667,.571,0,0,0,2,3,5,0,2,0,1,3,16,13
Allen Crabbe,SG,21,POR,15,0,100,12,33,.364,6,14,.429,6,19,.316,.455,3,4,.750,1,8,9,6,2,1,3,10,33,13
Jamal Crawford,SG,33,LAC,69,24,2094,421,1011,.416,161,446,.361,260,565,.460,.496,279,322,.866,34,124,158,223,59,12,135,120,1282,13
Jordan Crawford,SG-PG,25,TOT,81,35,1859,327,788,.415,90,285,.316,237,503,.471,.472,146,169,.864,28,155,183,281,47,5,134,120,890,13
Jae Crowder,SF,23,DAL,78,8,1254,130,296,.439,50,151,.331,80,145,.552,.524,46,61,.754,46,148,194,60,59,21,41,100,356,13
Dante Cunningham,PF,26,MIN,81,7,1635,236,509,.464,0,5,0,236,504,.468,.464,38,67,.567,112,218,330,83,62,58,42,146,510,13
Jared Cunningham,SG,22,TOT,13,0,80,6,21,.286,1,7,.143,5,14,.357,.310,13,16,.813,1,5,6,8,3,0,2,16,26,13
Seth Curry,PG,23,TOT,2,0,13,1,3,.333,1,1,1.000,0,2,0,.500,0,0,0,0,1,1,0,2,0,0,0,3,13
Stephen Curry,PG,25,GSW,78,78,2846,652,1383,.471,261,615,.424,391,768,.509,.566,308,348,.885,46,288,334,666,128,14,294,194,1873,13
Samuel Dalembert,C,32,DAL,80,68,1614,214,377,.568,0,1,0,214,376,.569,.568,101,137,.737,200,341,541,38,41,94,90,210,529,13
Troy Daniels,SG,22,HOU,5,1,75,15,31,.484,12,25,.480,3,6,.500,.677,0,0,0,0,4,4,5,0,0,3,6,42,13
Gigi Datome,SF,26,DET,34,0,238,34,97,.351,7,39,.179,27,58,.466,.387,8,10,.800,14,32,46,11,6,1,11,20,83,13
Brandon Davies,PF,22,PHI,51,0,575,54,128,.422,2,10,.200,52,118,.441,.430,34,53,.642,38,71,109,28,24,8,35,92,144,13
Anthony Davis,PF,20,NOP,67,66,2358,522,1005,.519,2,9,.222,520,996,.522,.520,348,440,.791,207,466,673,105,89,189,109,200,1394,13
Ed Davis,PF,24,MEM,63,4,956,155,290,.534,0,0,0,155,290,.534,.534,47,89,.528,92,168,260,27,17,43,40,114,357,13
Glen Davis,PF,28,TOT,68,44,1662,271,593,.457,4,11,.364,267,582,.459,.460,95,137,.693,108,243,351,77,58,29,76,159,641,13
Austin Daye,SF,25,TOT,22,1,148,24,68,.353,12,37,.324,12,31,.387,.441,6,10,.600,5,22,27,8,4,4,5,18,66,13
Nando De Colo,SF,26,TOT,47,3,494,64,153,.418,18,53,.340,46,100,.460,.477,31,35,.886,14,59,73,65,22,6,35,48,177,13
Dewayne Dedmon,C,24,TOT,31,6,390,38,83,.458,0,0,0,38,83,.458,.458,21,32,.656,38,89,127,5,7,22,18,66,97,13
Matthew Dellavedova,SG,23,CLE,72,4,1271,122,296,.412,57,155,.368,65,141,.461,.508,38,48,.792,29,94,123,187,33,5,60,121,339,13
Luol Deng,SF,28,TOT,63,63,2213,371,860,.431,57,189,.302,314,671,.468,.465,212,268,.791,99,262,361,183,62,9,114,111,1011,13
DeMar DeRozan,SG,24,TOR,79,79,3017,604,1407,.429,64,210,.305,540,1197,.451,.452,519,630,.824,51,292,343,313,86,28,176,197,1791,13
Boris Diaw,PF,31,SAS,79,24,1974,302,580,.521,45,112,.402,257,468,.549,.559,68,92,.739,74,252,326,222,44,32,121,140,717,13
Gorgui Dieng,C,24,MIN,60,15,818,113,227,.498,1,1,1.000,112,226,.496,.500,59,93,.634,103,197,300,39,30,50,54,108,286,13
Toney Douglas,PG,27,TOT,51,17,675,73,190,.384,31,102,.304,42,88,.477,.466,25,34,.735,18,69,87,68,19,5,34,81,202,13
Chris Douglas-Roberts,SF,27,CHA,49,8,1016,111,252,.440,51,132,.386,60,120,.500,.542,66,82,.805,16,103,119,51,29,16,36,61,339,13
Goran Dragić,SG,27,PHO,76,75,2668,552,1093,.505,122,299,.408,430,794,.542,.561,316,416,.760,69,176,245,447,104,22,213,206,1542,13
Andre Drummond,C,20,DET,81,81,2619,479,769,.623,0,2,0,479,767,.625,.623,137,328,.418,440,631,1071,35,101,131,110,273,1095,13
Jared Dudley,SF,28,LAC,74,43,1729,196,447,.438,81,225,.360,115,222,.518,.529,38,58,.655,36,124,160,104,41,10,56,146,511,13
Tim Duncan,C,37,SAS,74,74,2158,444,906,.490,0,5,0,444,901,.493,.490,231,316,.731,158,563,721,220,43,139,159,134,1119,13
Mike Dunleavy,SF,33,CHI,82,61,2584,333,774,.430,123,324,.380,210,450,.467,.510,140,164,.854,46,299,345,186,64,46,108,163,929,13
Kevin Durant,SF,25,OKC,81,81,3122,849,1688,.503,192,491,.391,657,1197,.549,.560,703,805,.873,58,540,598,445,103,59,285,174,2593,13
Shane Edwards,SF,26,CLE,2,0,12,1,3,.333,0,0,0,1,3,.333,.333,0,0,0,1,1,2,0,0,0,1,1,2,13
Wayne Ellington,SG,26,DAL,45,1,393,55,126,.437,25,59,.424,30,67,.448,.536,10,11,.909,8,35,43,19,16,2,11,33,145,13
Monta Ellis,SG,28,DAL,82,82,3023,576,1278,.451,69,209,.330,507,1069,.474,.478,339,430,.788,38,257,295,471,141,23,264,197,1560,13
Melvin Ely,C,35,NOP,2,0,27,3,6,.500,0,0,0,3,6,.500,.500,0,0,0,0,1,1,0,0,1,0,5,6,13
Jeremy Evans,SF,26,UTA,66,4,1209,175,332,.527,0,2,0,175,330,.530,.527,51,75,.680,120,190,310,44,42,46,40,139,401,13
Reggie Evans,PF,33,TOT,54,20,899,71,150,.473,0,0,0,71,150,.473,.473,72,130,.554,115,219,334,21,37,3,58,119,214,13
Tyreke Evans,SF,24,NOP,72,22,2028,391,897,.436,21,95,.221,370,802,.461,.448,239,310,.771,76,265,341,363,84,21,175,155,1042,13
Kenneth Faried,PF,24,DEN,80,77,2178,447,820,.545,0,3,0,447,817,.547,.545,202,311,.650,238,446,684,96,70,69,135,193,1096,13
Jordan Farmar,PG,27,LAL,41,5,912,151,364,.415,70,160,.438,81,204,.397,.511,44,59,.746,20,84,104,199,38,8,95,65,416,13
Vítor Luiz Faverani,C,25,BOS,37,8,488,64,147,.435,12,40,.300,52,107,.486,.476,24,37,.649,42,86,128,16,14,27,41,74,164,13
Derrick Favors,PF,22,UTA,73,73,2201,390,747,.522,0,1,0,390,746,.523,.522,190,284,.669,199,438,637,91,75,108,129,236,970,13
Carrick Felix,SG,23,CLE,7,0,38,7,14,.500,2,5,.400,5,9,.556,.571,3,4,.750,1,5,6,4,0,0,4,4,19,13
Raymond Felton,PG,29,NYK,65,65,2017,240,608,.395,62,195,.318,178,413,.431,.446,88,122,.721,54,143,197,365,78,27,129,157,630,13
Landry Fields,SF,25,TOR,30,2,322,27,67,.403,0,5,0,27,62,.435,.403,14,22,.636,15,44,59,20,10,3,11,25,68,13
Derek Fisher,SG,39,OKC,81,0,1428,141,361,.391,88,229,.384,53,132,.402,.512,55,71,.775,12,110,122,117,70,3,49,157,425,13
Evan Fournier,SG,21,DEN,76,4,1503,228,544,.419,89,237,.376,139,307,.453,.501,93,123,.756,34,168,202,112,34,7,100,179,638,13
Randy Foye,SG,30,DEN,81,78,2485,361,875,.413,189,498,.380,172,377,.456,.521,157,185,.849,36,196,232,287,67,39,145,205,1068,13
Jamaal Franklin,SG,22,MEM,21,0,161,16,39,.410,5,11,.455,11,28,.393,.474,2,2,1.000,4,19,23,6,4,2,11,23,39,13
Jimmer Fredette,SG,24,TOT,49,0,519,107,227,.471,40,84,.476,67,143,.469,.559,19,21,.905,8,44,52,64,14,3,48,35,273,13
Enes Freedom,C,21,UTA,80,37,2138,419,853,.491,0,1,0,419,852,.492,.491,149,204,.730,222,376,598,75,28,42,144,230,987,13
Joel Freeland,C,26,POR,52,0,727,77,162,.475,0,2,0,77,160,.481,.475,20,29,.690,88,120,208,36,10,22,32,95,174,13
Channing Frye,PF,30,PHO,82,82,2312,336,778,.432,160,432,.370,176,346,.509,.535,78,95,.821,73,343,416,98,60,63,89,245,910,13
Francisco García,SF,32,HOU,55,4,1083,118,294,.401,69,193,.358,49,101,.485,.519,10,19,.526,21,101,122,63,27,33,30,120,315,13
Kevin Garnett,C,37,BRK,54,54,1109,157,356,.441,0,3,0,157,353,.445,.441,38,47,.809,60,298,358,82,43,40,69,123,352,13
Diante Garrett,PG,25,UTA,71,0,1048,101,265,.381,36,96,.375,65,169,.385,.449,10,12,.833,11,86,97,120,41,5,75,75,248,13
Marc Gasol,C,29,MEM,59,59,1970,336,711,.473,2,11,.182,334,700,.477,.474,185,241,.768,84,340,424,215,59,76,111,150,859,13
Pau Gasol,C,33,LAL,60,60,1884,425,885,.480,4,14,.286,421,871,.483,.482,187,254,.736,124,456,580,201,27,92,141,124,1041,13
Rudy Gay,SF,27,TOT,73,73,2531,537,1179,.455,65,197,.330,472,982,.481,.483,318,387,.822,113,324,437,209,95,56,224,171,1457,13
Alonzo Gee,SF,26,CLE,65,24,1020,98,236,.415,19,58,.328,79,178,.444,.456,43,61,.705,35,114,149,47,39,15,44,96,258,13
Paul George,SF,23,IND,80,80,2898,577,1362,.424,182,500,.364,395,862,.458,.490,401,464,.864,64,478,542,283,151,22,224,198,1737,13
Taj Gibson,PF,28,CHI,82,8,2351,429,896,.479,0,7,0,429,889,.483,.479,211,281,.751,200,358,558,91,41,112,150,207,1069,13
Manu Ginóbili,SG,36,SAS,68,3,1550,294,627,.469,90,258,.349,204,369,.553,.541,160,188,.851,30,172,202,293,70,17,139,128,838,13
Rudy Gobert,C,21,UTA,45,0,434,36,74,.486,0,0,0,36,74,.486,.486,32,65,.492,51,104,155,7,8,41,32,57,104,13
Ryan Gomes,SF,31,OKC,5,0,34,3,8,.375,0,2,0,3,6,.500,.375,0,0,0,0,4,4,1,0,0,1,5,6,13
Drew Gooden,C,32,WAS,22,0,395,76,143,.531,7,17,.412,69,126,.548,.556,24,27,.889,37,77,114,15,10,7,17,53,183,13
Archie Goodwin,SG,19,PHO,52,0,533,76,167,.455,5,36,.139,71,131,.542,.470,37,55,.673,25,62,87,20,20,11,44,45,194,13
Ben Gordon,SG,30,CHA,19,0,279,37,108,.343,8,29,.276,29,79,.367,.380,17,21,.810,3,24,27,21,10,2,21,18,99,13
Eric Gordon,SG,25,NOP,64,64,2057,356,817,.436,101,258,.391,255,559,.456,.498,175,223,.785,30,135,165,208,74,12,134,114,988,13
Marcin Gortat,C,29,WAS,81,80,2655,455,840,.542,1,1,1.000,454,839,.541,.542,157,229,.686,202,565,767,138,41,121,126,201,1068,13
Danny Granger,SF,30,TOT,41,2,847,116,307,.378,43,128,.336,73,179,.408,.448,63,67,.940,31,102,133,41,12,17,46,62,338,13
Aaron Gray,C,29,TOT,37,6,355,27,61,.443,0,1,0,27,60,.450,.443,11,20,.550,42,69,111,22,10,8,31,64,65,13
Danny Green,SG,26,SAS,68,59,1651,218,505,.432,132,318,.415,86,187,.460,.562,50,63,.794,25,204,229,104,65,61,76,107,618,13
Draymond Green,SF,23,GSW,82,12,1797,187,459,.407,55,165,.333,132,294,.449,.467,82,123,.667,86,323,409,152,102,72,91,231,511,13
Gerald Green,SG,28,PHO,82,48,2330,448,1006,.445,204,510,.400,244,496,.492,.547,195,230,.848,48,227,275,122,70,42,145,220,1295,13
Jeff Green,SF,27,BOS,82,82,2805,482,1171,.412,135,396,.341,347,775,.448,.469,283,356,.795,54,326,380,138,57,47,165,180,1382,13
Willie Green,SG,32,LAC,55,9,869,102,271,.376,41,121,.339,61,150,.407,.452,28,34,.824,12,66,78,50,22,11,34,96,273,13
Blake Griffin,PF,24,LAC,80,80,2863,718,1359,.528,12,44,.273,706,1315,.537,.533,482,674,.715,192,565,757,309,92,51,224,265,1930,13
Jorge Gutiérrez,PG,25,BRK,15,2,244,25,54,.463,3,12,.250,22,42,.524,.491,9,12,.750,3,19,22,30,10,1,14,37,62,13
Jordan Hamilton,SF,23,TOT,60,12,1019,147,376,.391,70,198,.354,77,178,.433,.484,40,51,.784,32,162,194,52,44,20,46,67,404,13
Justin Hamilton,C,23,TOT,8,0,72,9,20,.450,3,9,.333,6,11,.545,.525,5,5,1.000,4,3,7,0,5,0,4,8,26,13
Tyler Hansbrough,PF,28,TOR,64,4,978,93,196,.474,0,2,0,93,194,.479,.474,126,185,.681,120,167,287,17,28,19,47,132,312,13
Tim Hardaway Jr.,SG,21,NYK,81,1,1875,294,687,.428,130,358,.363,164,329,.498,.523,106,128,.828,19,102,121,66,44,7,47,144,824,13
James Harden,SG,24,HOU,73,73,2777,549,1205,.456,177,483,.366,372,722,.515,.529,576,665,.866,61,283,344,446,115,29,265,177,1851,13
Maurice Harkless,SF,20,ORL,80,41,1950,224,483,.464,59,154,.383,165,329,.502,.525,85,143,.594,69,195,264,80,97,50,86,140,592,13
Josh Harrellson,C,24,DET,32,0,317,38,82,.463,12,31,.387,26,51,.510,.537,5,7,.714,30,46,76,15,6,15,10,44,93,13
Al Harrington,PF,33,WAS,34,0,511,82,207,.396,34,100,.340,48,107,.449,.478,27,35,.771,15,65,80,28,14,0,34,72,225,13
Devin Harris,PG,30,DAL,40,0,818,96,254,.378,31,101,.307,65,153,.425,.439,92,115,.800,8,77,85,178,28,2,59,72,315,13
Elias Harris,SF,24,LAL,2,0,11,0,1,0,0,0,0,0,1,0,0,0,0,0,1,0,1,1,1,0,0,0,0,13
Manny Harris,SG,24,LAL,9,0,180,28,70,.400,7,20,.350,21,50,.420,.450,10,12,.833,7,27,34,11,4,1,9,10,73,13
Mike Harris,PF,30,UTA,20,0,225,29,61,.475,0,2,0,29,59,.492,.475,26,27,.963,15,18,33,5,16,7,11,36,84,13
Tobias Harris,PF,21,ORL,61,36,1850,332,716,.464,32,126,.254,300,590,.508,.486,197,244,.807,88,336,424,82,41,24,78,143,893,13
Udonis Haslem,PF,33,MIA,46,18,653,74,146,.507,0,0,0,74,146,.507,.507,25,44,.568,42,133,175,13,11,15,24,79,173,13
Spencer Hawes,C,25,TOT,80,78,2470,403,883,.456,128,308,.416,275,575,.478,.529,119,152,.783,131,529,660,240,44,94,173,237,1053,13
Chuck Hayes,C,30,TOT,61,1,754,56,130,.431,0,1,0,56,129,.434,.431,20,25,.800,69,141,210,35,34,12,33,95,132,13
Gordon Hayward,SF,23,UTA,77,77,2800,426,1032,.413,85,280,.304,341,752,.453,.454,311,381,.816,62,329,391,400,110,40,212,155,1248,13
Gerald Henderson,SG,26,CHA,77,77,2461,403,930,.433,40,115,.348,363,815,.445,.455,235,309,.761,31,279,310,199,51,32,113,159,1081,13
Xavier Henry,SF,22,LAL,43,5,908,144,345,.417,28,81,.346,116,264,.439,.458,116,177,.655,25,89,114,51,44,7,57,79,432,13
John Henson,PF,23,MIL,70,23,1856,344,639,.538,0,1,0,344,638,.539,.538,91,177,.514,171,326,497,113,41,116,114,185,779,13
Roy Hibbert,C,27,IND,81,81,2409,331,754,.439,2,5,.400,329,749,.439,.440,207,269,.770,202,336,538,91,29,182,148,269,871,13
J.J. Hickson,PF,25,DEN,69,52,1859,332,654,.508,0,8,0,332,646,.514,.508,150,290,.517,206,426,632,96,47,51,128,177,814,13
Nenê,PF,31,WAS,53,37,1560,299,594,.503,1,5,.200,298,589,.506,.504,155,266,.583,65,229,294,153,64,47,117,164,754,13
George Hill,PG,27,IND,76,76,2434,272,616,.442,95,260,.365,177,356,.497,.519,142,176,.807,53,230,283,265,75,23,92,158,781,13
Jordan Hill,PF,26,LAL,72,32,1500,286,521,.549,0,1,0,286,520,.550,.549,124,181,.685,194,341,535,54,29,64,75,172,696,13
Solomon Hill,SF,22,IND,28,0,226,17,40,.425,7,23,.304,10,17,.588,.513,6,7,.857,9,32,41,12,5,2,13,19,47,13
Kirk Hinrich,PG,33,CHI,73,61,2116,243,619,.393,85,242,.351,158,377,.419,.461,95,125,.760,31,161,192,286,80,26,120,203,666,13
Jrue Holiday,PG,23,NOP,34,34,1143,203,454,.447,30,77,.390,173,377,.459,.480,51,63,.810,28,114,142,268,56,12,105,92,487,13
Ryan Hollins,PF,29,LAC,61,0,482,53,72,.736,0,0,0,53,72,.736,.736,35,56,.625,31,59,90,8,9,31,29,87,141,13
Scotty Hopson,SG,24,CLE,2,0,7,0,4,0,0,2,0,0,2,0,0,1,2,.500,0,0,0,1,1,0,0,0,1,13
Al Horford,C,27,ATL,29,29,958,238,420,.567,4,11,.364,234,409,.572,.571,58,85,.682,66,178,244,76,27,44,64,56,538,13
Dwight Howard,C,28,HOU,71,71,2396,473,800,.591,2,7,.286,471,793,.594,.593,349,638,.547,231,635,866,131,60,128,229,240,1297,13
Robbie Hummel,SF,24,MIN,53,5,655,67,177,.379,32,89,.360,35,88,.398,.469,15,16,.938,35,97,132,23,16,2,10,57,181,13
Kris Humphries,PF,28,BOS,69,30,1376,231,461,.501,0,2,0,231,459,.503,.501,117,144,.813,127,282,409,67,31,61,64,136,579,13
Serge Ibaka,PF,24,OKC,81,81,2666,524,978,.536,23,60,.383,501,918,.546,.548,156,199,.784,224,485,709,85,39,219,123,233,1227,13
Andre Iguodala,SF,30,GSW,63,63,2040,220,458,.480,62,175,.354,158,283,.558,.548,86,132,.652,53,240,293,263,95,18,100,103,588,13
Ersan İlyasova,PF,26,MIL,55,47,1478,237,579,.409,37,131,.282,200,448,.446,.441,107,130,.823,107,235,342,72,46,8,61,135,618,13
Kyrie Irving,PG,21,CLE,71,71,2496,532,1237,.430,123,344,.358,409,893,.458,.480,291,338,.861,52,207,259,433,108,23,190,163,1478,13
Royal Ivey,SG,32,OKC,2,0,5,0,2,0,0,1,0,0,1,0,0,0,0,0,0,1,1,0,0,0,0,1,0,13
Jarrett Jack,PG,30,CLE,80,31,2252,286,698,.410,63,185,.341,223,513,.435,.455,125,149,.839,22,201,223,324,56,22,133,133,760,13
Reggie Jackson,PG,23,OKC,80,36,2277,403,916,.440,83,245,.339,320,671,.477,.485,158,177,.893,43,270,313,331,85,9,168,142,1047,13
Stephen Jackson,SF,35,LAC,9,0,107,6,26,.231,1,14,.071,5,12,.417,.250,2,4,.500,2,8,10,5,6,1,6,11,15,13
Bernard James,C,28,DAL,30,0,146,11,23,.478,0,1,0,11,22,.500,.478,6,11,.545,15,27,42,3,3,8,10,24,28,13
Damion James,SF,26,SAS,5,1,50,2,9,.222,0,2,0,2,7,.286,.222,2,2,1.000,1,11,12,3,0,1,1,3,6,13
LeBron James,PF,29,MIA,77,77,2902,767,1353,.567,116,306,.379,651,1047,.622,.610,439,585,.750,81,452,533,488,121,26,270,126,2089,13
Mike James,PG,38,CHI,11,0,77,5,21,.238,1,5,.200,4,16,.250,.262,0,2,0,0,7,7,17,2,0,5,11,11,13
Antawn Jamison,PF,37,LAC,22,0,248,29,92,.315,8,41,.195,21,51,.412,.359,18,25,.720,9,46,55,7,9,3,7,29,84,13
Othyus Jeffers,SG,28,TOT,6,1,47,3,6,.500,0,2,0,3,4,.750,.500,3,4,.750,1,8,9,1,0,0,1,3,9,13
Al Jefferson,C,29,CHA,73,73,2553,700,1376,.509,3,15,.200,697,1361,.512,.510,191,277,.690,156,636,792,155,67,79,124,176,1594,13
Richard Jefferson,SF,33,UTA,82,78,2213,294,654,.450,123,301,.409,171,353,.484,.544,120,162,.741,18,201,219,130,56,14,94,168,831,13
John Jenkins,SG,22,ATL,13,0,158,16,42,.381,4,18,.222,12,24,.500,.429,4,4,1.000,3,19,22,11,1,1,11,11,40,13
Brandon Jennings,PG,24,DET,80,79,2728,423,1135,.373,154,457,.337,269,678,.397,.441,241,321,.751,59,185,244,609,101,8,215,157,1241,13
Jonas Jerebko,PF,26,DET,64,0,741,98,208,.471,31,74,.419,67,134,.500,.546,43,59,.729,51,124,175,39,21,6,43,85,270,13
Amir Johnson,PF,26,TOR,77,72,2214,344,612,.562,20,66,.303,324,546,.593,.578,91,143,.636,172,333,505,115,56,88,123,271,799,13
Chris Johnson,SF,23,BOS,40,0,789,85,214,.397,43,127,.339,42,87,.483,.498,37,43,.860,31,66,97,31,27,4,22,63,250,13
James Johnson,SF,26,MEM,52,4,956,143,308,.464,22,87,.253,121,221,.548,.500,76,90,.844,60,106,166,111,42,57,66,102,384,13
Joe Johnson,SG,32,BRK,79,79,2575,462,1018,.454,162,404,.401,300,614,.489,.533,159,195,.815,48,222,270,216,47,10,120,129,1245,13
Orlando Johnson,SG,24,TOT,45,0,392,36,113,.319,9,47,.191,27,66,.409,.358,19,26,.731,9,46,55,20,6,2,15,26,100,13
Wesley Johnson,SF,26,LAL,79,62,2240,277,651,.425,100,271,.369,177,380,.466,.502,61,77,.792,70,278,348,124,86,77,90,207,715,13
Darius Johnson-Odom,SG,24,PHI,3,0,15,0,7,0,0,3,0,0,4,0,0,0,2,0,0,2,2,1,1,0,2,3,0,13
James Jones,SF,33,MIA,20,6,236,31,68,.456,28,54,.519,3,14,.214,.662,7,11,.636,2,21,23,9,3,4,4,6,97,13
Perry Jones,PF,22,OKC,62,7,764,83,181,.459,22,61,.361,61,120,.508,.519,28,42,.667,28,86,114,26,14,19,21,62,216,13
Solomon Jones,PF,29,ORL,11,0,85,6,17,.353,0,0,0,6,17,.353,.353,2,4,.500,8,8,16,2,2,2,2,12,14,13
Terrence Jones,PF,22,HOU,76,71,2078,386,712,.542,31,101,.307,355,611,.581,.564,118,195,.605,162,366,528,87,53,99,71,139,921,13
DeAndre Jordan,C,25,LAC,82,82,2870,348,515,.676,0,0,0,348,515,.676,.676,160,374,.428,331,783,1114,74,80,203,123,264,856,13
Cory Joseph,SG,22,SAS,68,19,936,126,265,.475,12,38,.316,114,227,.502,.498,79,96,.823,32,75,107,114,35,14,43,84,343,13
Chris Kaman,C,31,LAL,39,13,736,176,346,.509,0,3,0,176,343,.513,.509,52,68,.765,54,175,229,58,11,40,74,93,404,13
Sergey Karasev,SF,20,CLE,22,1,156,12,35,.343,4,19,.211,8,16,.500,.400,9,10,.900,0,16,16,6,3,1,11,22,37,13
Ryan Kelly,PF,22,LAL,59,25,1312,157,371,.423,48,142,.338,109,229,.476,.488,110,135,.815,42,177,219,95,32,45,47,147,472,13
Michael Kidd-Gilchrist,SF,20,CHA,62,62,1502,167,353,.473,1,9,.111,166,344,.483,.475,113,184,.614,109,215,324,52,43,39,60,145,448,13
Andrei Kirilenko,PF,32,BRK,45,4,857,82,160,.513,1,5,.200,81,155,.523,.516,61,119,.513,55,91,146,72,40,19,54,65,226,13
Brandon Knight,PG,22,MIL,72,69,2400,461,1092,.422,110,338,.325,351,754,.466,.473,259,323,.802,46,209,255,352,69,17,188,146,1291,13
Kyle Korver,SG,32,ATL,71,71,2408,289,609,.475,185,392,.472,104,217,.479,.626,87,94,.926,22,260,282,208,70,24,102,147,850,13
Kosta Koufos,C,24,MEM,80,22,1349,227,459,.495,0,0,0,227,459,.495,.495,60,93,.645,160,258,418,39,32,71,67,182,514,13
Viacheslav Kravtsov,C,26,PHO,20,0,59,8,15,.533,0,0,0,8,15,.533,.533,4,8,.500,9,8,17,1,0,1,6,7,20,13
Ognjen Kuzmić,C,23,GSW,21,0,92,5,13,.385,0,0,0,5,13,.385,.385,5,11,.455,10,11,21,2,3,4,10,17,15,13
Doron Lamb,SG,22,ORL,53,0,695,63,160,.394,36,90,.400,27,70,.386,.506,29,36,.806,8,41,49,43,11,1,27,54,191,13
Jeremy Lamb,SG,21,OKC,78,0,1538,263,609,.432,88,247,.356,175,362,.483,.504,51,64,.797,27,162,189,115,56,26,61,143,665,13
Carl Landry,PF,30,SAC,18,1,233,31,60,.517,0,0,0,31,60,.517,.517,14,17,.824,15,42,57,5,3,1,9,34,76,13
Shane Larkin,PG,21,DAL,48,0,489,52,137,.380,12,38,.316,40,99,.404,.423,16,25,.640,11,31,42,71,26,1,39,46,132,13
Ty Lawson,PG,26,DEN,62,61,2222,347,806,.431,72,202,.356,275,604,.455,.475,324,406,.798,40,175,215,543,100,10,200,113,1090,13
Ricky Ledo,SG,21,DAL,11,0,33,6,17,.353,3,8,.375,3,9,.333,.441,4,4,1.000,0,2,2,2,1,0,2,2,19,13
Courtney Lee,SG,28,TOT,79,47,1973,295,614,.480,72,194,.371,223,420,.531,.539,99,112,.884,29,158,187,115,65,28,73,127,761,13
David Lee,PF,30,GSW,69,67,2288,513,981,.523,0,1,0,513,980,.523,.523,231,296,.780,182,461,643,147,48,26,152,206,1257,13
Alex Len,C,20,PHO,42,3,362,33,78,.423,0,0,0,33,78,.423,.423,20,31,.645,39,60,99,4,4,18,26,68,86,13
Kawhi Leonard,SF,22,SAS,66,65,1923,337,645,.522,69,182,.379,268,463,.579,.576,101,126,.802,76,336,412,133,114,50,80,127,844,13
Meyers Leonard,C,21,POR,40,0,355,41,91,.451,0,6,0,41,85,.482,.451,16,21,.762,26,85,111,18,7,5,15,76,98,13
Jon Leuer,PF,24,MEM,49,0,642,121,246,.492,23,49,.469,98,197,.497,.539,37,47,.787,37,121,158,20,18,13,27,63,302,13
Rashard Lewis,SF,34,MIA,60,6,971,98,236,.415,46,134,.343,52,102,.510,.513,26,33,.788,24,86,110,57,53,8,35,90,268,13
DeAndre Liggins,SG,25,MIA,1,0,1,1,1,1.000,0,0,0,1,1,1.000,1.000,0,0,0,1,0,1,0,0,0,0,0,2,13
Damian Lillard,PG,23,POR,82,82,2937,553,1304,.424,218,554,.394,335,750,.447,.508,371,426,.871,35,253,288,457,64,22,193,197,1695,13
Jeremy Lin,PG,25,HOU,71,33,2054,295,662,.446,82,229,.358,213,433,.492,.508,218,265,.823,34,153,187,294,68,27,176,166,890,13
Shaun Livingston,PG,28,BRK,76,54,1974,235,487,.483,1,6,.167,234,481,.486,.484,158,191,.827,67,179,246,245,93,31,105,172,629,13
Brook Lopez,C,25,BRK,17,17,533,129,229,.563,0,1,0,129,228,.566,.563,94,115,.817,39,63,102,16,9,30,28,52,352,13
Robin Lopez,C,25,POR,82,82,2603,355,644,.551,0,1,0,355,643,.552,.551,198,242,.818,326,374,700,73,25,139,84,196,908,13
Kevin Love,PF,25,MIN,77,77,2797,650,1421,.457,190,505,.376,460,916,.502,.524,520,633,.821,224,739,963,341,59,35,196,136,2010,13
Kyle Lowry,PG,27,TOR,79,79,2862,457,1080,.423,190,500,.380,267,580,.460,.511,313,385,.813,88,281,369,586,121,15,194,267,1417,13
John Lucas III,PG,31,UTA,42,6,591,62,190,.326,25,84,.298,37,106,.349,.392,10,16,.625,12,27,39,42,14,0,22,41,159,13
Shelvin Mack,PG,23,ATL,73,11,1490,209,501,.417,62,184,.337,147,317,.464,.479,64,74,.865,21,139,160,271,50,2,89,100,544,13
Ian Mahinmi,C,27,IND,77,1,1248,91,189,.481,0,1,0,91,188,.484,.481,90,145,.621,107,150,257,24,41,72,58,207,272,13
Shawn Marion,SF,35,DAL,76,76,2409,341,708,.482,58,162,.358,283,546,.518,.523,51,65,.785,132,365,497,124,90,37,95,125,791,13
Kendall Marshall,PG,22,LAL,54,45,1564,170,419,.406,71,178,.399,99,241,.411,.490,19,36,.528,15,140,155,477,48,4,150,76,430,13
Cartier Martin,SF,29,TOT,59,6,870,111,264,.420,59,151,.391,52,113,.460,.532,48,65,.738,13,97,110,33,27,7,34,71,329,13
Kenyon Martin,PF,36,NYK,32,15,633,63,123,.512,0,1,0,63,122,.516,.512,11,19,.579,36,98,134,50,25,27,26,85,137,13
Kevin Martin,SG,30,MIN,68,68,2177,440,1023,.430,115,297,.387,325,726,.448,.486,303,340,.891,34,169,203,121,66,6,106,123,1298,13
Roger Mason,SG,33,MIA,25,2,260,25,67,.373,17,48,.354,8,19,.421,.500,7,7,1.000,1,21,22,19,6,1,9,26,74,13
Wesley Matthews,SG,27,POR,82,82,2780,445,1009,.441,201,511,.393,244,498,.490,.541,252,301,.837,51,238,289,197,76,14,110,176,1343,13
Jason Maxiell,PF,30,ORL,34,13,488,47,105,.448,0,0,0,47,105,.448,.448,15,31,.484,28,58,86,9,8,20,14,47,109,13
Eric Maynor,PG,26,TOT,31,0,327,32,101,.317,12,37,.324,20,64,.313,.376,6,11,.545,9,30,39,52,9,3,29,17,82,13
O.J. Mayo,SG,26,MIL,52,23,1346,224,550,.407,84,227,.370,140,323,.433,.484,76,88,.864,24,100,124,113,28,13,95,111,608,13
Luc Mbah a Moute,PF-SF,27,TOT,64,7,1003,87,193,.451,4,17,.235,83,176,.472,.461,46,67,.687,56,90,146,36,30,14,40,68,224,13
Ray McCallum,PG,22,SAC,45,10,897,113,300,.377,22,59,.373,91,241,.378,.413,32,43,.744,18,61,79,120,22,9,39,69,280,13
CJ McCollum,SG,22,POR,38,0,476,74,178,.416,30,80,.375,44,98,.449,.500,23,34,.676,7,41,48,27,14,2,35,53,201,13
JaVale McGee,C,26,DEN,5,5,79,17,38,.447,0,0,0,17,38,.447,.447,1,1,1.000,10,7,17,2,1,7,8,16,35,13
Ben McLemore,SG,20,SAC,82,55,2187,255,679,.376,95,297,.320,160,382,.419,.446,115,143,.804,53,182,235,82,45,18,96,201,720,13
Josh McRoberts,PF,26,CHA,78,78,2360,247,566,.436,105,291,.361,142,275,.516,.529,62,85,.729,85,288,373,333,58,46,83,189,661,13
Jodie Meeks,SG,26,LAL,77,70,2556,413,892,.463,162,404,.401,251,488,.514,.554,221,258,.857,30,164,194,138,111,4,111,119,1209,13
Gal Mekel,PG,25,DAL,31,1,292,30,86,.349,5,20,.250,25,66,.379,.378,8,12,.667,5,22,27,63,4,1,31,31,73,13
Khris Middleton,SF,22,MIL,82,64,2460,376,854,.440,120,290,.414,256,564,.454,.511,118,137,.861,60,250,310,169,83,20,123,243,990,13
C.J. Miles,SG,26,CLE,51,34,984,178,409,.435,83,211,.393,95,198,.480,.537,64,75,.853,18,85,103,52,46,15,44,103,503,13
Andre Miller,SG,37,TOT,58,2,982,106,231,.459,11,21,.524,95,210,.452,.483,60,77,.779,28,102,130,197,34,9,61,75,283,13
Darius Miller,SF,23,NOP,45,7,723,73,166,.440,25,77,.325,48,89,.539,.515,29,36,.806,9,43,52,43,24,9,22,88,200,13
Mike Miller,SF,33,MEM,82,4,1707,213,443,.481,107,233,.459,106,210,.505,.602,46,56,.821,30,177,207,130,26,5,77,95,579,13
Quincy Miller,PF,21,DEN,52,16,789,94,256,.367,30,94,.319,64,162,.395,.426,39,55,.709,36,111,147,26,22,32,48,70,257,13
Patty Mills,PG,25,SAS,81,2,1527,309,666,.464,135,318,.425,174,348,.500,.565,73,82,.890,34,135,169,149,68,9,63,114,826,13
Paul Millsap,PF,28,ATL,74,73,2482,483,1047,.461,76,212,.358,407,835,.487,.498,286,391,.731,154,473,627,232,129,78,185,210,1328,13
Tony Mitchell,PF,21,DET,21,0,79,5,12,.417,1,1,1.000,4,11,.364,.458,11,19,.579,15,11,26,2,6,3,4,9,22,13
Tony Mitchell,SF,24,MIL,3,0,10,3,5,.600,0,1,0,3,4,.750,.600,0,0,0,1,0,1,1,1,0,0,0,6,13
Nazr Mohammed,C,36,CHI,80,1,562,54,126,.429,0,0,0,54,126,.429,.429,16,30,.533,66,109,175,20,14,30,37,77,124,13
Greg Monroe,PF,23,DET,82,82,2690,504,1015,.497,0,1,0,504,1014,.497,.497,241,367,.657,256,504,760,171,91,47,166,205,1249,13
E'Twaun Moore,SG,24,ORL,79,3,1506,195,456,.428,57,161,.354,138,295,.468,.490,52,68,.765,29,107,136,112,60,13,55,106,499,13
Darius Morris,PG,23,TOT,27,0,313,39,96,.406,12,38,.316,27,58,.466,.469,17,26,.654,7,19,26,44,13,0,27,33,107,13
Marcus Morris,SF,24,PHO,82,1,1800,288,651,.442,99,260,.381,189,391,.483,.518,121,159,.761,84,235,319,88,72,18,95,157,796,13
Markieff Morris,PF,24,PHO,81,0,2153,411,845,.486,34,108,.315,377,737,.512,.507,259,327,.792,139,346,485,144,68,51,147,232,1115,13
Anthony Morrow,SG,28,NOP,76,9,1426,238,520,.458,88,195,.451,150,325,.462,.542,72,87,.828,29,111,140,59,38,12,51,102,636,13
Donatas Motiejūnas,PF,23,HOU,62,3,952,131,296,.443,21,84,.250,110,212,.519,.478,58,96,.604,60,165,225,34,20,21,49,132,341,13
Arnett Moultrie,PF,23,PHI,12,2,187,16,38,.421,0,0,0,16,38,.421,.421,4,5,.800,11,24,35,2,8,4,7,22,36,13
Timofey Mozgov,C,27,DEN,82,30,1770,285,545,.523,4,24,.167,281,521,.539,.527,196,260,.754,171,357,528,62,27,100,122,213,770,13
Shabazz Muhammad,SG,21,MIN,37,0,290,57,124,.460,3,11,.273,54,113,.478,.472,26,40,.650,24,29,53,6,8,1,16,24,143,13
Byron Mullens,C,24,TOT,45,0,414,73,165,.442,33,89,.371,40,76,.526,.542,10,20,.500,24,68,92,14,15,11,27,64,189,13
Erik Murphy,C,23,CHI,24,0,62,3,13,.231,0,3,0,3,10,.300,.231,0,0,0,2,6,8,2,0,4,2,7,6,13
Toure' Murry,PG,24,NYK,51,0,373,56,129,.434,5,12,.417,51,117,.436,.453,23,39,.590,13,31,44,49,19,1,34,46,140,13
Mike Muscala,PF,22,ATL,20,0,215,31,73,.425,0,3,0,31,70,.443,.425,14,14,1.000,17,35,52,7,3,10,12,29,76,13
Hamady N'Diaye,C,27,SAC,14,0,74,3,9,.333,0,0,0,3,9,.333,.333,0,1,0,5,13,18,3,0,4,3,15,6,13
Steve Nash,PG,39,LAL,15,10,313,36,94,.383,8,24,.333,28,70,.400,.426,22,24,.917,4,25,29,86,7,2,31,18,102,13
Gary Neal,SG,29,TOT,52,3,1114,193,471,.410,68,180,.378,125,291,.430,.482,94,105,.895,10,80,90,83,18,0,64,65,548,13
Nemanja Nedović,SG,22,GSW,24,0,142,8,39,.205,3,18,.167,5,21,.238,.244,7,8,.875,3,12,15,13,0,1,13,13,26,13
Jameer Nelson,PG,31,ORL,68,68,2179,294,747,.394,136,391,.348,158,356,.444,.485,96,112,.857,29,202,231,476,52,5,166,146,820,13
Andrew Nicholson,PF,24,ORL,76,5,1174,180,420,.429,28,89,.315,152,331,.459,.462,47,57,.825,53,202,255,25,18,23,51,150,435,13
Joakim Noah,C,28,CHI,80,80,2820,380,800,.475,0,2,0,380,798,.476,.475,247,335,.737,282,618,900,431,99,121,194,245,1007,13
Steve Novak,PF,30,TOR,54,1,540,60,146,.411,52,122,.426,8,24,.333,.589,6,6,1.000,8,50,58,13,12,4,5,44,178,13
Dirk Nowitzki,PF,35,DAL,80,80,2628,633,1273,.497,131,329,.398,502,944,.532,.549,338,376,.899,40,458,498,216,73,45,117,165,1735,13
James Nunnally,SF,23,TOT,13,0,165,15,46,.326,8,25,.320,7,21,.333,.413,6,9,.667,1,18,19,8,6,2,7,11,44,13
Jermaine O'Neal,PF,35,GSW,44,13,883,125,248,.504,0,0,0,125,248,.504,.504,99,132,.750,85,157,242,25,14,40,52,102,349,13
Kyle O'Quinn,C,23,ORL,69,19,1188,186,371,.501,0,3,0,186,368,.505,.501,57,83,.687,100,264,364,78,39,88,78,165,429,13
Greg Oden,C,26,MIA,23,6,212,27,49,.551,0,0,0,27,49,.551,.551,13,23,.565,23,31,54,1,7,13,12,52,67,13
Victor Oladipo,PG,21,ORL,80,44,2487,392,936,.419,74,226,.327,318,710,.448,.458,248,318,.780,43,286,329,327,129,37,256,210,1106,13
Kelly Olynyk,C,22,BOS,70,9,1400,234,502,.466,40,114,.351,194,388,.500,.506,99,122,.811,140,225,365,109,35,27,106,227,607,13
Arinze Onuaku,PF,26,TOT,5,0,30,1,5,.200,0,0,0,1,5,.200,.200,1,2,.500,2,6,8,3,0,0,1,3,3,13
Daniel Orton,C,23,PHI,22,4,251,21,47,.447,0,0,0,21,47,.447,.447,23,30,.767,16,45,61,15,6,16,18,38,65,13
Travis Outlaw,SF,29,SAC,63,4,1065,130,326,.399,41,117,.350,89,209,.426,.462,42,52,.808,36,132,168,48,20,19,26,94,343,13
Zaza Pachulia,C,29,MIL,53,43,1325,149,349,.427,0,1,0,149,348,.428,.427,110,130,.846,141,192,333,136,45,14,92,124,408,13
Jannero Pargo,PG,34,CHA,29,0,242,52,118,.441,24,60,.400,28,58,.483,.542,8,11,.727,1,19,20,52,14,1,26,17,136,13
Tony Parker,PG,31,SAS,68,68,1997,456,914,.499,25,67,.373,431,847,.509,.513,197,243,.811,17,138,155,388,36,9,151,86,1134,13
Chandler Parsons,SF,25,HOU,74,74,2783,466,987,.472,130,351,.370,336,636,.528,.538,164,221,.742,69,340,409,298,88,29,144,168,1226,13
Patrick Patterson,PF,24,TOT,65,13,1533,225,489,.460,55,151,.364,170,338,.503,.516,50,71,.704,117,225,342,78,55,37,65,159,555,13
Chris Paul,PG,28,LAC,62,62,2171,406,870,.467,78,212,.368,328,658,.498,.511,295,345,.855,38,230,268,663,154,4,145,157,1185,13
Nikola Peković,C,28,MIN,54,54,1663,379,701,.541,0,0,0,379,701,.541,.541,186,249,.747,206,262,468,50,30,23,84,129,944,13
Kendrick Perkins,C,29,OKC,62,62,1207,87,193,.451,0,1,0,87,192,.453,.451,37,67,.552,82,223,305,67,26,32,90,177,211,13
Paul Pierce,SF,36,BRK,75,68,2098,321,712,.451,112,300,.373,209,412,.507,.529,256,310,.826,26,322,348,178,86,31,153,190,1010,13
Dexter Pittman,C,25,ATL,2,0,3,0,1,0,0,0,0,0,1,0,0,0,2,0,3,0,3,0,0,0,0,0,0,13
Mason Plumlee,C,23,BRK,70,22,1275,199,302,.659,0,3,0,199,299,.666,.659,122,195,.626,99,209,308,60,49,55,77,171,520,13
Miles Plumlee,C,25,PHO,80,79,1964,286,553,.517,0,0,0,286,553,.517,.517,74,132,.561,198,428,626,43,50,90,111,185,646,13
Quincy Pondexter,SG,25,MEM,15,2,270,31,79,.392,11,34,.324,20,45,.444,.462,21,26,.808,10,16,26,20,5,1,15,18,94,13
Otto Porter Jr.,SF,20,WAS,37,0,319,33,91,.363,4,21,.190,29,70,.414,.385,8,12,.667,21,36,57,10,8,1,14,26,78,13
Josh Powell,PF,31,HOU,1,0,19,2,6,.333,0,0,0,2,6,.333,.333,0,0,0,0,5,5,0,0,1,1,1,4,13
Phil Pressey,PG,22,BOS,75,11,1132,78,253,.308,28,106,.264,50,147,.340,.364,29,45,.644,20,85,105,241,68,5,87,97,213,13
A.J. Price,SG,27,MIN,28,0,99,19,46,.413,6,22,.273,13,24,.542,.478,0,2,0,1,9,10,13,1,0,7,5,44,13
Ronnie Price,SG,30,ORL,31,2,377,28,92,.304,9,43,.209,19,49,.388,.353,9,13,.692,8,35,43,66,25,2,26,50,74,13
Pablo Prigioni,PG,36,NYK,66,27,1283,88,191,.461,65,140,.464,23,51,.451,.631,11,12,.917,36,93,129,228,67,2,60,132,252,13
Tayshaun Prince,SF,33,MEM,76,76,1948,200,492,.407,20,69,.290,180,423,.426,.427,34,60,.567,32,202,234,119,39,19,41,63,454,13
Miroslav Raduljica,C,26,MIL,48,2,465,68,126,.540,0,0,0,68,126,.540,.540,45,55,.818,54,54,108,23,7,13,28,84,181,13
Anthony Randolph,PF,24,DEN,43,5,527,68,176,.386,18,61,.295,50,115,.435,.438,52,69,.754,20,102,122,32,26,19,39,64,206,13
Shavlik Randolph,PF,30,PHO,14,0,95,7,14,.500,0,0,0,7,14,.500,.500,6,11,.545,7,18,25,1,3,1,5,15,20,13
Zach Randolph,PF,32,MEM,79,79,2705,560,1198,.467,2,20,.100,558,1178,.474,.468,250,337,.742,265,530,795,200,54,23,183,210,1372,13
J.J. Redick,SG,29,LAC,35,34,987,181,398,.455,73,185,.395,108,213,.507,.546,97,106,.915,9,65,74,78,28,3,42,65,532,13
Glen Rice Jr.,SG,23,WAS,11,1,109,11,37,.297,5,17,.294,6,20,.300,.365,5,7,.714,4,16,20,7,6,1,9,7,32,13
Luke Ridnour,PG,32,TOT,61,14,1141,126,327,.385,37,108,.343,89,219,.406,.442,17,26,.654,23,74,97,176,32,8,66,92,306,13
Austin Rivers,PG,21,NOP,69,4,1339,192,474,.405,36,99,.364,156,375,.416,.443,110,173,.636,26,103,129,160,45,9,77,134,530,13
Andre Roberson,SG,22,OKC,40,16,399,33,68,.485,2,13,.154,31,55,.564,.500,7,10,.700,36,58,94,15,19,10,19,74,75,13
Brian Roberts,PG,28,NOP,72,42,1667,244,581,.420,64,178,.360,180,403,.447,.475,125,133,.940,17,119,136,234,43,7,95,132,677,13
Nate Robinson,PG,29,DEN,44,1,866,164,383,.428,58,154,.377,106,229,.463,.504,71,85,.835,21,60,81,112,36,4,58,92,457,13
Thomas Robinson,PF,22,POR,70,0,873,141,293,.481,0,1,0,141,292,.483,.481,57,101,.564,105,202,307,34,23,20,57,131,339,13
Rajon Rondo,PG,27,BOS,30,30,998,141,350,.403,26,90,.289,115,260,.442,.440,42,67,.627,22,142,164,294,40,2,99,65,350,13
Derrick Rose,PG,25,CHI,10,10,311,58,164,.354,16,47,.340,42,117,.359,.402,27,32,.844,9,23,32,43,5,1,34,15,159,13
Terrence Ross,SG,22,TOR,81,62,2159,318,751,.423,161,408,.395,157,343,.458,.531,82,98,.837,43,209,252,79,64,27,88,183,879,13
Ricky Rubio,PG,23,MIN,82,82,2638,255,670,.381,44,133,.331,211,537,.393,.413,227,283,.802,61,281,342,704,191,11,221,218,781,13
Brandon Rush,SG,28,UTA,38,0,418,30,90,.333,16,47,.340,14,43,.326,.422,3,5,.600,5,39,44,24,5,9,20,31,79,13
Robert Sacre,C,24,LAL,65,13,1089,143,300,.477,0,0,0,143,300,.477,.477,64,94,.681,82,172,254,51,24,47,44,134,350,13
John Salmons,SG-SF,34,TOT,78,8,1726,150,413,.363,63,163,.387,87,250,.348,.439,40,52,.769,20,143,163,147,47,19,54,124,403,13
Larry Sanders,C,25,MIL,23,20,584,76,162,.469,0,1,0,76,161,.472,.469,26,55,.473,60,105,165,19,18,40,26,74,178,13
Dennis Schröder,PG,20,ATL,49,0,641,72,188,.383,10,42,.238,62,146,.425,.410,29,43,.674,5,55,60,93,17,0,61,54,183,13
Luis Scola,PF,33,IND,82,2,1399,263,560,.470,1,7,.143,262,553,.474,.471,99,136,.728,86,305,391,81,26,16,108,164,626,13
Mike Scott,PF,25,ATL,80,6,1482,301,628,.479,62,200,.310,239,428,.558,.529,103,132,.780,62,222,284,75,30,7,79,121,767,13
Thabo Sefolosha,SG,29,OKC,61,61,1584,141,340,.415,48,152,.316,93,188,.495,.485,53,69,.768,50,170,220,94,79,17,55,90,383,13
Kevin Séraphin,C,24,WAS,53,1,578,111,220,.505,0,0,0,111,220,.505,.505,27,31,.871,53,75,128,17,3,26,41,103,249,13
Ramon Sessions,PG,27,TOT,83,19,2214,330,769,.429,35,124,.282,295,645,.457,.452,326,404,.807,38,165,203,340,49,9,148,90,1021,13
Mustafa Shakur,PG,29,OKC,3,0,11,0,3,0,0,1,0,0,2,0,0,1,2,.500,0,0,0,4,0,0,2,2,1,13
Tornike Shengelia,SF,22,TOT,26,0,154,13,28,.464,0,6,0,13,22,.591,.464,3,8,.375,4,12,16,14,3,1,12,18,29,13
Iman Shumpert,SG,23,NYK,74,58,1962,183,484,.378,76,228,.333,107,256,.418,.457,53,71,.746,81,227,308,129,92,13,79,209,495,13
Alexey Shved,SG,25,MIN,63,0,664,76,237,.321,30,102,.294,46,135,.341,.384,68,90,.756,21,60,81,68,26,16,48,36,250,13
Henry Sims,C,23,TOT,46,25,875,130,274,.474,0,1,0,130,273,.476,.474,90,121,.744,104,133,237,52,28,20,41,116,350,13
Kyle Singler,SF,25,DET,82,36,2337,269,602,.447,94,246,.382,175,356,.492,.525,152,184,.826,116,187,303,75,61,38,79,211,784,13
Chris Singleton,SF,24,WAS,25,0,250,25,67,.373,7,19,.368,18,48,.375,.425,18,25,.720,18,37,55,6,9,3,17,25,75,13
Peyton Siva,SG,23,DET,24,0,224,18,57,.316,7,25,.280,11,32,.344,.377,11,15,.733,2,12,14,34,9,1,18,27,54,13
Donald Sloan,SG,26,IND,48,1,392,44,117,.376,10,42,.238,34,75,.453,.419,12,20,.600,4,40,44,50,10,1,22,19,110,13
Chris Smith,PG,26,NYK,2,0,2,0,0,0,0,0,0,0,0,0,0,0,0,0,0,0,0,0,0,0,0,0,0,13
Greg Smith,C,23,HOU,11,0,100,18,28,.643,0,0,0,18,28,.643,.643,2,5,.400,11,16,27,0,1,2,5,17,38,13
Ish Smith,PG,25,PHO,70,1,1006,119,281,.423,1,23,.043,118,258,.457,.425,22,39,.564,31,98,129,179,49,13,65,66,261,13
J.R. Smith,SF,28,NYK,74,37,2421,396,955,.415,189,480,.394,207,475,.436,.514,90,138,.652,35,261,296,219,65,20,108,196,1071,13
Jason Smith,PF,27,NOP,31,27,830,131,282,.465,0,0,0,131,282,.465,.465,39,50,.780,51,130,181,29,11,29,28,100,301,13
Josh Smith,SF,28,DET,77,76,2730,517,1233,.419,70,265,.264,447,968,.462,.448,160,301,.532,102,418,520,252,105,110,199,197,1264,13
Tony Snell,SG,22,CHI,77,12,1231,129,336,.384,57,178,.320,72,158,.456,.469,31,41,.756,19,105,124,68,29,15,44,84,346,13
James Southerland,SF,23,TOT,4,0,30,5,15,.333,3,6,.500,2,9,.222,.433,1,2,.500,0,8,8,0,1,2,1,3,14,13
Marreese Speights,C,26,GSW,79,3,982,195,442,.441,8,31,.258,187,411,.455,.450,110,134,.821,101,189,290,32,10,34,66,148,508,13
Tiago Splitter,C,29,SAS,59,50,1271,181,346,.523,0,3,0,181,343,.528,.523,121,173,.699,123,240,363,90,29,31,75,117,483,13
D.J. Stephens,SG,23,MIL,3,0,15,3,7,.429,0,0,0,3,7,.429,.429,1,1,1.000,1,4,5,0,0,0,0,0,7,13
Lance Stephenson,SG,23,IND,78,78,2752,427,870,.491,86,244,.352,341,626,.545,.540,140,197,.711,95,463,558,359,54,7,210,195,1080,13
Greg Stiemsma,C,28,NOP,55,20,1007,70,122,.574,0,1,0,70,121,.579,.574,19,32,.594,72,154,226,36,35,57,44,169,159,13
Julyan Stone,SG,25,TOR,21,0,120,7,17,.412,2,8,.250,5,9,.556,.471,2,3,.667,2,18,20,12,3,0,5,13,18,13
Amar'e Stoudemire,C,31,NYK,65,21,1466,311,558,.557,0,0,0,311,558,.557,.557,150,203,.739,112,208,320,34,23,37,91,159,772,13
Rodney Stuckey,SG,27,DET,73,5,1950,372,853,.436,24,88,.273,348,765,.455,.450,244,292,.836,39,130,169,152,54,10,125,131,1012,13
Jared Sullinger,PF,21,BOS,74,44,2041,384,899,.427,56,208,.269,328,691,.475,.458,158,203,.778,241,360,601,118,35,49,119,251,982,13
Jeff Taylor,SF,24,CHA,26,8,629,82,218,.376,18,67,.269,64,151,.424,.417,26,47,.553,15,45,60,22,13,5,25,62,208,13
Tyshawn Taylor,PG,23,BRK,23,3,270,31,91,.341,3,12,.250,28,79,.354,.357,24,30,.800,3,12,15,36,12,1,31,29,89,13
Jeff Teague,PG,25,ATL,79,79,2542,456,1040,.438,74,225,.329,382,815,.469,.474,318,376,.846,34,174,208,528,89,17,232,158,1304,13
Marquis Teague,SG,20,TOT,40,3,443,38,119,.319,5,18,.278,33,101,.327,.340,26,35,.743,1,39,40,58,10,5,39,46,107,13
Mirza Teletović,SF,28,BRK,72,7,1396,221,529,.418,136,349,.390,85,180,.472,.546,44,62,.710,60,206,266,57,29,23,54,143,622,13
Garrett Temple,SG,27,WAS,75,0,638,51,141,.362,6,29,.207,45,112,.402,.383,30,43,.698,21,47,68,72,35,11,42,72,138,13
Jason Terry,PG,36,BRK,35,0,570,55,152,.362,39,103,.379,16,49,.327,.490,10,15,.667,4,33,37,56,13,0,27,48,159,13
Hasheem Thabeet,C,26,OKC,23,0,192,13,23,.565,0,0,0,13,23,.565,.565,1,5,.200,9,31,40,1,4,9,14,47,27,13
Adonis Thomas,SF,20,TOT,6,1,37,6,14,.429,1,5,.200,5,9,.556,.464,1,1,1.000,0,3,3,3,0,0,1,6,14,13
Isaiah Thomas,PG,24,SAC,72,54,2497,496,1096,.453,127,364,.349,369,732,.504,.510,346,407,.850,47,163,210,454,93,8,213,185,1465,13
Lance Thomas,SF,25,NOP,5,0,42,2,9,.222,0,0,0,2,9,.222,.222,2,4,.500,2,5,7,3,0,0,2,4,6,13
Malcolm Thomas,PF,25,TOT,8,0,63,7,16,.438,1,4,.250,6,12,.500,.469,0,2,0,5,16,21,2,0,3,9,5,15,13
Hollis Thompson,SF,22,PHI,77,41,1742,171,372,.460,67,167,.401,104,205,.507,.550,52,73,.712,73,174,247,73,53,12,60,144,461,13
Jason Thompson,PF,27,SAC,82,61,2007,251,496,.506,0,0,0,251,496,.506,.506,84,145,.579,153,374,527,53,32,56,95,251,586,13
Klay Thompson,SG,23,GSW,81,81,2868,559,1259,.444,223,535,.417,336,724,.464,.533,147,185,.795,38,211,249,181,74,37,135,234,1488,13
Tristan Thompson,PF,22,CLE,82,82,2594,363,761,.477,0,1,0,363,760,.478,.477,235,339,.693,269,485,754,72,42,35,108,188,961,13
Marcus Thornton,SG,26,TOT,72,27,1741,252,639,.394,109,316,.345,143,323,.443,.480,90,112,.804,57,141,198,77,58,11,67,110,703,13
Jamaal Tinsley,PG,35,UTA,8,5,110,4,20,.200,1,15,.067,3,5,.600,.225,0,0,0,2,9,11,23,2,0,9,10,9,13
Anthony Tolliver,PF,28,CHA,64,9,1298,129,307,.420,102,247,.413,27,60,.450,.586,33,41,.805,33,135,168,42,19,15,23,82,393,13
P.J. Tucker,SF,28,PHO,81,81,2490,265,615,.431,74,191,.387,191,424,.450,.491,156,201,.776,161,368,529,141,110,23,102,204,760,13
Ronny Turiaf,C,31,MIN,31,10,606,64,107,.598,0,0,0,64,107,.598,.598,21,50,.420,55,119,174,24,8,50,24,65,149,13
Hedo Türkoğlu,SF,34,LAC,38,0,392,42,109,.385,22,50,.440,20,59,.339,.486,9,18,.500,11,78,89,33,19,10,16,50,115,13
Evan Turner,SF,25,TOT,81,56,2457,434,1021,.425,50,156,.321,384,865,.444,.450,213,262,.813,62,346,408,262,67,7,189,195,1131,13
Jeremy Tyler,C,22,NYK,41,0,398,60,116,.517,0,0,0,60,116,.517,.517,26,48,.542,38,71,109,8,6,20,26,70,146,13
Ekpe Udoh,PF,26,MIL,42,14,804,57,143,.399,0,0,0,57,143,.399,.399,30,47,.638,61,87,148,31,15,44,38,96,144,13
Beno Udrih,SG,31,TOT,41,12,643,78,178,.438,19,42,.452,59,136,.434,.492,25,30,.833,10,49,59,116,23,4,47,50,200,13
Jonas Valančiūnas,C,21,TOR,81,81,2282,359,676,.531,0,1,0,359,675,.532,.531,198,260,.762,226,488,714,57,24,71,136,249,916,13
Anderson Varejão,C,31,CLE,65,29,1800,227,459,.495,0,7,0,227,452,.502,.495,92,135,.681,187,442,629,140,69,39,72,164,546,13
Jarvis Varnado,PF,25,TOT,24,0,339,36,60,.600,0,0,0,36,60,.600,.600,27,52,.519,19,44,63,13,10,29,10,62,99,13
Greivis Vásquez,PG,27,TOT,79,23,1779,277,658,.421,109,289,.377,168,369,.455,.504,95,108,.880,20,153,173,323,31,5,128,143,758,13
Jan Veselý,PF,23,TOT,54,1,776,89,173,.514,0,0,0,89,173,.514,.514,19,56,.339,81,110,191,21,53,35,36,121,197,13
Charlie Villanueva,PF,29,DET,20,0,180,35,92,.380,14,56,.250,21,36,.583,.457,8,14,.571,6,28,34,6,4,5,7,16,92,13
Nikola Vučević,C,23,ORL,57,57,1812,353,696,.507,0,0,0,353,696,.507,.507,105,137,.766,185,441,626,104,60,47,112,169,811,13
Sasha Vujačić,SG,29,LAC,2,0,10,2,5,.400,1,2,.500,1,3,.333,.500,0,0,0,0,3,3,0,1,0,3,1,5,13
Dwyane Wade,SG,32,MIA,54,53,1775,415,761,.545,9,32,.281,406,729,.557,.551,189,258,.733,60,181,241,252,79,29,161,106,1028,13
Dion Waiters,SG,22,CLE,70,24,2072,430,993,.433,92,250,.368,338,743,.455,.479,161,235,.685,32,163,195,209,63,17,154,153,1113,13
Kemba Walker,PG,23,CHA,73,73,2614,449,1143,.393,109,327,.333,340,816,.417,.441,282,337,.837,39,267,306,447,86,32,169,128,1289,13
John Wall,PG,23,WAS,82,82,2980,579,1337,.433,108,308,.351,471,1029,.458,.473,317,394,.805,38,295,333,721,149,40,295,219,1583,13
Gerald Wallace,SF,31,BOS,58,16,1416,116,230,.504,19,64,.297,97,166,.584,.546,47,101,.465,36,176,212,143,73,14,97,79,298,13
Casper Ware,PG,24,PHI,9,0,116,18,42,.429,7,21,.333,11,21,.524,.512,5,6,.833,0,9,9,10,8,0,5,11,48,13
C.J. Watson,PG,29,IND,63,5,1193,146,334,.437,53,145,.366,93,189,.492,.516,69,88,.784,19,82,101,107,60,8,60,66,414,13
Earl Watson,PG,34,POR,24,0,161,3,11,.273,2,7,.286,1,4,.250,.364,4,4,1.000,5,10,15,28,5,1,17,33,12,13
Maalik Wayns,PG,22,LAC,2,0,9,1,2,.500,0,0,0,1,2,.500,.500,0,0,0,0,2,2,2,2,0,0,4,2,13
Martell Webster,SF,27,WAS,78,13,2157,254,587,.433,146,372,.392,108,215,.502,.557,105,125,.840,38,184,222,97,41,15,58,150,759,13
David West,PF,33,IND,80,80,2472,458,939,.488,4,15,.267,454,924,.491,.490,198,251,.789,120,422,542,223,61,74,133,186,1118,13
Russell Westbrook,PG,25,OKC,46,46,1412,346,791,.437,68,214,.318,278,577,.482,.480,242,293,.826,55,208,263,319,88,7,177,104,1002,13
D.J. White,PF,27,CHA,2,0,10,0,1,0,0,0,0,0,1,0,0,0,0,0,0,2,2,0,1,0,0,1,0,13
Royce White,PF,22,SAC,3,0,9,0,1,0,0,0,0,0,1,0,0,0,0,0,0,0,0,0,0,0,0,2,0,13
Deron Williams,PG,29,BRK,64,58,2059,322,716,.450,98,268,.366,224,448,.500,.518,173,216,.801,15,153,168,392,93,13,143,148,915,13
Derrick Williams,SF-PF,22,TOT,78,15,1820,206,482,.427,26,99,.263,180,383,.470,.454,186,259,.718,71,252,323,56,48,20,76,114,624,13
Elliot Williams,SG,24,PHI,67,2,1157,140,337,.415,37,125,.296,103,212,.486,.470,87,119,.731,30,100,130,72,35,3,68,126,404,13
Lou Williams,PG,27,ATL,60,7,1445,197,493,.400,79,231,.342,118,262,.450,.480,152,179,.849,10,114,124,210,45,4,92,65,625,13
Marvin Williams,PF,27,UTA,66,50,1674,231,526,.439,84,234,.359,147,292,.503,.519,57,73,.781,82,252,334,78,54,31,53,151,603,13
Mo Williams,PG,31,POR,74,0,1834,280,672,.417,83,225,.369,197,447,.441,.478,78,89,.876,42,111,153,321,55,10,149,197,721,13
Reggie Williams,SF,27,OKC,3,0,17,5,9,.556,1,3,.333,4,6,.667,.611,0,0,0,0,0,0,1,1,0,2,1,11,13
Shawne Williams,PF,27,LAL,36,13,751,73,192,.380,42,129,.326,31,63,.492,.490,14,20,.700,25,142,167,30,19,30,21,93,202,13
Jeff Withey,C,23,NOP,58,4,684,69,129,.535,0,1,0,69,128,.539,.535,52,73,.712,49,101,150,26,15,50,20,73,190,13
Nate Wolters,PG,22,MIL,58,31,1309,170,389,.437,18,62,.290,152,327,.465,.460,59,90,.656,33,116,149,187,35,15,57,67,417,13
Metta World Peace,SF,34,NYK,29,1,388,56,141,.397,17,54,.315,39,87,.448,.457,10,16,.625,18,41,59,17,24,8,19,44,139,13
Brandan Wright,C,26,DAL,58,0,1077,224,331,.677,0,0,0,224,331,.677,.677,77,106,.726,102,142,244,31,32,55,35,94,525,13
Chris Wright,SF,25,MIL,8,0,126,21,35,.600,0,1,0,21,34,.618,.600,6,15,.400,10,10,20,5,7,5,5,17,48,13
Dorell Wright,SF,28,POR,68,13,984,111,297,.374,69,202,.342,42,95,.442,.490,52,69,.754,29,162,191,64,23,16,39,62,343,13
Tony Wroten,PG,20,PHI,72,16,1765,345,808,.427,40,188,.213,305,620,.492,.452,209,326,.641,69,159,228,217,78,16,204,151,939,13
Nick Young,SG,28,LAL,64,9,1810,387,889,.435,135,350,.386,252,539,.468,.511,235,285,.825,29,137,166,95,46,12,95,156,1144,13
Thaddeus Young,PF,25,PHI,79,78,2718,582,1283,.454,90,292,.308,492,991,.496,.489,163,229,.712,166,310,476,182,167,36,165,213,1417,13
Cody Zeller,C,21,CHA,82,3,1416,172,404,.426,0,1,0,172,403,.427,.426,146,200,.730,118,235,353,92,40,41,87,170,490,13
Tyler Zeller,C,24,CLE,70,9,1049,156,290,.538,0,1,0,156,289,.540,.538,87,121,.719,103,179,282,36,18,38,60,137,399,13
Quincy Acy,PF,24,NYK,68,22,1287,152,331,.459,18,60,.300,134,271,.494,.486,76,97,.784,79,222,301,68,27,22,60,147,398,14
Jordan Adams,SG,20,MEM,30,0,248,35,86,.407,10,25,.400,25,61,.410,.465,14,23,.609,9,19,28,16,16,7,14,24,94,14
Steven Adams,C,21,OKC,70,67,1771,217,399,.544,0,2,0,217,397,.547,.544,103,205,.502,199,324,523,66,38,86,99,222,537,14
Jeff Adrien,PF,28,MIN,17,0,215,19,44,.432,0,0,0,19,44,.432,.432,22,38,.579,23,54,77,15,4,9,9,30,60,14
Arron Afflalo,SG,29,TOT,78,72,2502,375,884,.424,118,333,.354,257,551,.466,.491,167,198,.843,27,220,247,129,41,7,116,167,1035,14
Alexis Ajinça,C,26,NOP,68,8,957,181,329,.550,0,0,0,181,329,.550,.550,81,99,.818,104,211,315,47,21,51,69,151,443,14
Furkan Aldemir,PF,23,PHI,41,9,540,40,78,.513,0,5,0,40,73,.548,.513,13,27,.481,78,98,176,28,17,16,17,96,93,14
Cole Aldrich,C,26,NYK,61,16,976,144,301,.478,0,0,0,144,301,.478,.478,50,64,.781,101,237,338,75,37,65,59,122,338,14
LaMarcus Aldridge,PF,29,POR,71,71,2512,659,1415,.466,37,105,.352,622,1310,.475,.479,306,362,.845,177,549,726,124,48,68,122,125,1661,14
Lavoy Allen,C,25,IND,63,0,1070,141,299,.472,0,0,0,141,299,.472,.472,33,47,.702,123,200,323,73,15,42,40,102,315,14
Tony Allen,SG,33,MEM,63,41,1648,225,455,.495,10,29,.345,215,426,.505,.505,79,126,.627,103,177,280,86,129,30,86,166,539,14
Al-Farouq Aminu,SF,24,DAL,74,3,1366,147,357,.412,34,124,.274,113,233,.485,.459,84,118,.712,114,228,342,59,70,62,55,137,412,14
Lou Amundson,PF,32,TOT,53,35,937,109,255,.427,0,1,0,109,254,.429,.427,41,87,.471,94,174,268,70,22,52,62,126,259,14
Chris Andersen,C,36,MIA,60,20,1132,120,207,.580,4,13,.308,116,194,.598,.589,76,114,.667,76,223,299,43,26,61,40,88,320,14
Alan Anderson,SG,32,BRK,74,19,1744,195,440,.443,73,210,.348,122,230,.530,.526,82,101,.812,31,173,204,83,56,5,60,148,545,14
Kyle Anderson,SF,21,SAS,33,8,358,31,89,.348,3,11,.273,28,78,.359,.365,9,14,.643,5,67,72,28,15,7,10,28,74,14
Ryan Anderson,PF,26,NOP,61,5,1675,291,729,.399,122,359,.340,169,370,.457,.483,129,151,.854,108,187,295,55,33,20,62,113,833,14
Giannis Antetokounmpo,SG,20,MIL,81,71,2541,383,780,.491,7,44,.159,376,736,.511,.496,257,347,.741,100,442,542,207,73,85,173,254,1030,14
Carmelo Anthony,SF,30,NYK,40,40,1428,358,806,.444,61,179,.341,297,627,.474,.482,189,237,.797,72,192,264,122,40,17,89,87,966,14
Joel Anthony,C,32,DET,49,0,406,36,62,.581,0,0,0,36,62,.581,.581,15,22,.682,32,61,93,5,12,49,12,55,87,14
Pero Antić,C,32,ATL,63,3,1037,108,296,.365,52,173,.301,56,123,.455,.453,88,123,.715,58,131,189,49,18,14,49,132,356,14
Trevor Ariza,SF,29,HOU,82,82,2930,366,910,.402,194,555,.350,172,355,.485,.509,122,143,.853,77,382,459,209,152,17,141,186,1048,14
Darrell Arthur,PF,26,DEN,58,4,988,155,384,.404,26,110,.236,129,274,.471,.438,46,59,.780,53,118,171,57,48,26,47,146,382,14
Ömer Aşık,C,28,NOP,76,76,1982,213,412,.517,0,0,0,213,412,.517,.517,131,225,.582,244,504,748,72,29,54,95,144,557,14
D.J. Augustin,PG,27,TOT,82,14,1964,258,647,.399,83,246,.337,175,401,.436,.463,178,205,.868,20,141,161,353,49,3,145,93,777,14
Jeff Ayres,PF,27,SAS,51,0,383,55,95,.579,0,0,0,55,95,.579,.579,27,36,.750,37,80,117,14,8,8,26,60,137,14
Luke Babbitt,SF,25,NOP,63,19,830,92,192,.479,59,115,.513,33,77,.429,.633,13,19,.684,12,99,111,24,17,11,26,63,256,14
Cameron Bairstow,PF,24,CHI,18,1,64,3,14,.214,0,0,0,3,14,.214,.214,4,5,.800,6,2,8,1,2,1,3,8,10,14
Leandro Barbosa,SG,32,GSW,66,1,982,183,386,.474,43,112,.384,140,274,.511,.530,58,74,.784,23,68,91,99,41,8,44,87,467,14
J.J. Barea,PG,30,DAL,77,10,1362,225,536,.420,54,167,.323,171,369,.463,.470,76,94,.809,23,111,134,263,33,1,70,104,580,14
Andrea Bargnani,C,29,NYK,29,22,785,164,361,.454,15,41,.366,149,320,.466,.475,87,107,.813,32,95,127,46,2,27,42,53,430,14
Harrison Barnes,SF,22,GSW,82,82,2318,316,656,.482,87,215,.405,229,441,.519,.548,108,150,.720,117,336,453,116,61,19,71,146,827,14
Matt Barnes,SF,34,LAC,76,74,2271,277,624,.444,136,376,.362,141,248,.569,.553,74,95,.779,51,251,302,114,67,50,87,240,764,14
Earl Barron,C,33,PHO,16,1,143,12,39,.308,2,4,.500,10,35,.286,.333,6,12,.500,14,14,28,5,4,2,5,26,32,14
Will Barton,SG,24,TOT,58,0,983,150,353,.425,23,85,.271,127,268,.474,.458,74,94,.787,26,136,162,81,48,19,61,70,397,14
Brandon Bass,PF,29,BOS,82,43,1929,344,683,.504,9,32,.281,335,651,.515,.510,169,214,.790,139,259,398,104,41,32,83,140,866,14
Nicolas Batum,SF,26,POR,71,71,2380,240,600,.400,100,309,.324,140,291,.481,.483,84,98,.857,62,354,416,341,78,40,132,106,664,14
Jerryd Bayless,PG,26,MIL,77,4,1717,220,516,.426,37,120,.308,183,396,.462,.462,121,137,.883,22,189,211,233,59,12,133,163,598,14
Aron Baynes,C,28,SAS,70,17,1122,185,327,.566,1,4,.250,184,323,.570,.567,90,104,.865,109,209,318,35,16,22,65,162,461,14
Kent Bazemore,SG,25,ATL,75,10,1324,141,331,.426,48,132,.364,93,199,.467,.498,60,100,.600,21,201,222,78,52,33,73,127,390,14
Bradley Beal,SG,21,WAS,63,59,2107,363,851,.427,106,259,.409,257,592,.434,.489,130,166,.783,57,184,241,194,76,18,123,136,962,14
Michael Beasley,PF,26,MIA,24,1,505,92,212,.434,8,34,.235,84,178,.472,.453,20,26,.769,12,77,89,32,15,13,37,66,212,14
Marco Belinelli,SG,28,SAS,62,9,1388,199,470,.423,86,230,.374,113,240,.471,.515,84,99,.848,26,131,157,94,31,3,61,85,568,14
Jerrelle Benimon,PF,23,UTA,2,0,3,0,0,0,0,0,0,0,0,0,0,0,0,0,1,2,3,0,0,0,1,0,0,14
Anthony Bennett,PF,21,MIN,57,3,894,125,297,.421,7,23,.304,118,274,.431,.433,41,64,.641,52,164,216,48,27,16,36,87,298,14
Patrick Beverley,PG,26,HOU,56,55,1727,204,532,.383,115,323,.356,89,209,.426,.492,45,60,.750,67,170,237,192,59,23,83,182,568,14
Sim Bhullar,C,22,SAC,3,0,3,1,2,.500,0,0,0,1,2,.500,.500,0,0,0,0,1,1,1,0,1,0,0,2,14
Bismack Biyombo,C,22,CHO,64,21,1243,101,186,.543,0,0,0,101,186,.543,.543,102,175,.583,159,248,407,16,18,99,52,140,304,14
Tarik Black,C,23,TOT,63,39,1196,157,273,.575,0,1,0,157,272,.577,.575,65,118,.551,142,226,368,42,19,24,48,158,379,14
DeJuan Blair,PF,25,WAS,29,0,180,26,57,.456,0,0,0,26,57,.456,.456,4,6,.667,16,40,56,3,7,1,13,41,56,14
Steve Blake,PG,34,POR,81,0,1529,122,327,.373,77,219,.352,45,108,.417,.491,29,41,.707,16,121,137,288,41,5,104,118,350,14
Eric Bledsoe,PG,25,PHO,81,81,2800,468,1046,.447,88,272,.324,380,774,.491,.489,353,441,.800,72,351,423,493,127,45,274,189,1377,14
Vander Blue,SG,22,LAL,2,1,74,9,30,.300,2,10,.200,7,20,.350,.333,2,5,.400,2,7,9,8,3,0,6,4,22,14
Bojan Bogdanović,SF,25,BRK,78,28,1854,261,576,.453,91,256,.355,170,320,.531,.532,87,106,.821,50,163,213,68,34,9,78,104,700,14
Andrew Bogut,C,30,GSW,67,65,1583,200,355,.563,0,0,0,200,355,.563,.563,22,42,.524,141,402,543,180,39,113,106,188,422,14
Matt Bonner,PF,34,SAS,72,19,935,94,230,.409,46,126,.365,48,104,.462,.509,30,37,.811,29,86,115,47,10,12,11,65,264,14
Trevor Booker,PF,27,UTA,79,5,1564,226,464,.487,29,84,.345,197,380,.518,.518,86,148,.581,139,258,397,83,43,41,88,144,567,14
Carlos Boozer,PF,33,LAL,71,26,1692,371,743,.499,0,0,0,371,743,.499,.499,94,150,.627,111,371,482,95,41,12,92,184,836,14
Chris Bosh,C,30,MIA,44,44,1556,343,745,.460,63,168,.375,280,577,.485,.503,179,232,.772,46,264,310,95,41,25,95,69,928,14
Avery Bradley,SG,24,BOS,77,77,2428,434,1012,.429,124,352,.352,310,660,.470,.490,79,100,.790,46,195,241,135,82,15,109,177,1071,14
Elton Brand,C,35,ATL,36,4,486,42,95,.442,0,1,0,42,94,.447,.442,12,23,.522,28,72,100,22,17,25,18,54,96,14
Corey Brewer,SF,28,TOT,80,17,2087,343,805,.426,63,235,.268,280,570,.491,.465,168,226,.743,80,217,297,173,114,19,131,173,917,14
Aaron Brooks,PG,30,CHI,82,21,1885,344,817,.421,121,313,.387,223,504,.442,.495,145,174,.833,32,134,166,261,54,15,157,189,954,14
Jabari Brown,SG,22,LAL,19,5,568,70,170,.412,23,62,.371,47,108,.435,.479,64,85,.753,3,33,36,40,12,2,32,33,227,14
Lorenzo Brown,PG,24,MIN,29,7,549,52,122,.426,6,28,.214,46,94,.489,.451,12,19,.632,14,56,70,90,28,6,30,49,122,14
Markel Brown,SG,23,BRK,47,29,781,76,210,.362,17,64,.266,59,146,.404,.402,47,57,.825,16,91,107,39,31,12,27,57,216,14
Shannon Brown,SG,29,MIA,5,2,89,7,19,.368,3,7,.429,4,12,.333,.447,3,4,.750,0,1,1,3,4,0,4,8,20,14
Kobe Bryant,SG,36,LAL,35,35,1207,266,713,.373,54,184,.293,212,529,.401,.411,196,241,.813,26,173,199,197,47,7,128,65,782,14
Chase Budinger,SF,26,MIN,67,4,1286,169,390,.433,52,143,.364,117,247,.474,.500,67,81,.827,33,165,198,64,44,10,49,72,457,14
Reggie Bullock,SF,23,TOT,36,2,338,24,70,.343,15,46,.326,9,24,.375,.450,6,9,.667,1,49,50,8,10,4,8,19,69,14
Trey Burke,PG,22,UTA,76,43,2288,370,1005,.368,124,390,.318,246,615,.400,.430,109,145,.752,31,173,204,328,65,15,124,119,973,14
Alec Burks,SG,23,UTA,27,27,899,121,300,.403,26,68,.382,95,232,.409,.447,106,129,.822,19,95,114,82,17,5,52,64,374,14
Caron Butler,SF,34,DET,78,21,1623,161,396,.407,83,219,.379,78,177,.441,.511,55,61,.902,21,175,196,79,43,4,49,120,460,14
Jimmy Butler,SG,25,CHI,65,65,2513,421,912,.462,73,193,.378,348,719,.484,.502,386,463,.834,114,265,379,212,114,36,93,108,1301,14
Rasual Butler,SF,35,WAS,75,1,1505,218,517,.422,91,235,.387,127,282,.450,.510,53,67,.791,27,170,197,63,29,22,48,98,580,14
Dwight Buycks,PG,25,LAL,6,0,123,18,40,.450,7,11,.636,11,29,.379,.538,9,10,.900,2,10,12,14,3,0,12,3,52,14
Will Bynum,SG,32,WAS,7,0,67,10,31,.323,0,9,0,10,22,.455,.323,2,4,.500,2,4,6,18,1,1,8,9,22,14
Bruno Caboclo,SF,19,TOR,8,0,23,4,12,.333,2,3,.667,2,9,.222,.417,0,0,0,1,1,2,0,0,1,4,3,10,14
Nick Calathes,SG,25,MEM,58,0,838,104,247,.421,11,43,.256,93,204,.456,.443,24,45,.533,19,87,106,146,63,5,61,100,243,14
José Calderón,PG,33,NYK,42,42,1270,147,354,.415,59,142,.415,88,212,.415,.499,29,32,.906,19,105,124,198,31,0,75,76,382,14
Kentavious Caldwell-Pope,SG,21,DET,82,82,2587,390,972,.401,153,444,.345,237,528,.449,.480,110,158,.696,46,209,255,109,93,18,94,161,1043,14
Isaiah Canaan,PG,23,TOT,47,21,938,146,378,.386,91,246,.370,55,132,.417,.507,49,60,.817,18,69,87,98,29,3,62,83,432,14
Clint Capela,C,20,HOU,12,0,90,14,29,.483,0,0,0,14,29,.483,.483,4,23,.174,10,26,36,2,1,9,5,14,32,14
DeMarre Carroll,SF,28,ATL,70,69,2189,318,653,.487,120,304,.395,198,349,.567,.579,127,181,.702,99,273,372,118,94,17,75,154,883,14
Vince Carter,SG,38,MEM,66,1,1091,135,406,.333,69,232,.297,66,174,.379,.417,45,57,.789,27,106,133,79,43,14,43,102,384,14
Michael Carter-Williams,PG,23,TOT,66,63,2149,364,919,.396,36,153,.235,328,766,.428,.416,202,291,.694,64,289,353,442,111,30,253,167,966,14
Omri Casspi,SF,26,SAC,67,19,1416,209,427,.489,35,87,.402,174,340,.512,.530,140,191,.733,54,206,260,102,31,9,88,107,593,14
Mario Chalmers,PG,28,MIA,80,37,2368,267,663,.403,73,248,.294,194,415,.467,.458,206,266,.774,24,182,206,307,122,10,173,251,813,14
Tyson Chandler,C,32,DAL,75,75,2286,293,440,.666,0,0,0,293,440,.666,.666,185,257,.720,294,570,864,84,42,91,105,169,771,14
Wilson Chandler,SF,27,DEN,78,75,2471,418,975,.429,139,406,.342,279,569,.490,.500,110,142,.775,96,379,475,134,58,29,110,231,1085,14
Will Cherry,PG,23,CLE,8,0,69,5,19,.263,2,9,.222,3,10,.300,.316,3,6,.500,1,4,5,8,6,1,4,10,15,14
Patrick Christopher,SG,26,UTA,4,1,29,3,12,.250,0,4,0,3,8,.375,.250,0,0,0,2,4,6,0,1,0,1,6,6,14
Earl Clark,PF,27,BRK,10,0,93,11,30,.367,4,14,.286,7,16,.438,.433,1,4,.250,1,22,23,3,3,4,6,12,27,14
Ian Clark,SG,23,TOT,30,0,192,19,55,.345,10,30,.333,9,25,.360,.436,9,9,1.000,4,12,16,12,9,3,9,20,57,14
Jordan Clarkson,PG,22,LAL,59,38,1476,267,596,.448,38,121,.314,229,475,.482,.480,131,158,.829,56,135,191,206,51,12,96,109,703,14
Victor Claver,SF,26,POR,10,0,76,9,20,.450,6,11,.545,3,9,.333,.600,0,0,0,3,17,20,1,1,1,4,12,24,14
Norris Cole,PG,26,TOT,75,25,1831,230,558,.412,55,176,.313,175,382,.458,.461,58,81,.716,13,146,159,255,57,15,99,124,573,14
Darren Collison,PG,27,SAC,45,45,1565,260,550,.473,60,161,.373,200,389,.514,.527,145,184,.788,19,124,143,252,67,14,112,95,725,14
Nick Collison,PF,34,OKC,66,2,1101,106,253,.419,16,60,.267,90,193,.466,.451,45,65,.692,90,160,250,90,35,25,45,156,273,14
Mike Conley,PG,27,MEM,70,70,2225,393,882,.446,107,277,.386,286,605,.473,.506,214,249,.859,29,180,209,375,89,14,156,139,1107,14
Jack Cooley,C,23,UTA,16,0,87,9,22,.409,0,0,0,9,22,.409,.409,9,21,.429,10,15,25,1,6,3,3,23,27,14
Chris Copeland,SF,30,IND,50,12,828,112,310,.361,52,167,.311,60,143,.420,.445,33,45,.733,23,88,111,51,11,11,59,78,309,14
Bryce Cotton,PG,22,UTA,15,0,159,29,69,.420,7,20,.350,22,49,.449,.471,15,18,.833,3,15,18,15,4,0,12,6,80,14
DeMarcus Cousins,C,24,SAC,59,59,2013,498,1066,.467,2,8,.250,496,1058,.469,.468,423,541,.782,185,562,747,210,90,103,254,241,1421,14
Robert Covington,SF,24,PHI,70,49,1956,299,756,.396,167,446,.374,132,310,.426,.506,178,217,.820,65,251,316,105,97,31,128,189,943,14
Allen Crabbe,SG,22,POR,51,9,683,63,153,.412,30,85,.353,33,68,.485,.510,12,16,.750,7,66,73,39,19,15,15,74,168,14
Jamal Crawford,SG,34,LAC,64,4,1703,332,839,.396,119,364,.327,213,475,.448,.467,227,252,.901,18,106,124,158,59,14,92,108,1010,14
Jae Crowder,SF,24,TOT,82,17,1647,229,545,.420,61,208,.293,168,337,.499,.476,109,141,.773,72,221,293,94,72,25,49,137,628,14
Dante Cunningham,PF,27,NOP,66,27,1652,155,339,.457,1,10,.100,154,329,.468,.459,29,47,.617,70,186,256,50,46,37,35,101,340,14
Jared Cunningham,SG,23,LAC,19,0,89,12,33,.364,4,13,.308,8,20,.400,.424,7,13,.538,1,8,9,10,3,0,7,12,35,14
Seth Curry,PG,24,PHO,2,0,8,0,3,0,0,1,0,0,2,0,0,0,0,0,0,2,2,1,0,0,0,2,0,14
Stephen Curry,PG,26,GSW,80,80,2613,653,1341,.487,286,646,.443,367,695,.528,.594,308,337,.914,56,285,341,619,163,16,249,158,1900,14
Samuel Dalembert,C,33,NYK,32,21,544,57,130,.438,0,0,0,57,130,.438,.438,14,20,.700,53,115,168,29,14,41,39,70,128,14
Troy Daniels,SG,23,TOT,47,0,397,61,165,.370,43,118,.364,18,47,.383,.500,11,13,.846,8,25,33,22,6,1,20,40,176,14
Gigi Datome,SF,27,TOT,21,1,209,43,89,.483,18,40,.450,25,49,.510,.584,1,1,1.000,3,26,29,9,2,7,9,15,105,14
Brandon Davies,PF,23,TOT,27,6,423,55,137,.401,8,34,.235,47,103,.456,.431,24,37,.649,38,45,83,30,18,7,29,59,142,14
Anthony Davis,PF,21,NOP,68,68,2455,642,1199,.535,1,12,.083,641,1187,.540,.536,371,461,.805,173,523,696,149,100,200,95,141,1656,14
Ed Davis,PF,25,LAL,79,24,1840,282,469,.601,0,0,0,282,469,.601,.601,92,189,.487,230,370,600,94,49,98,58,202,656,14
Glen Davis,PF,29,LAC,74,0,904,117,255,.459,0,4,0,117,251,.466,.459,60,95,.632,43,126,169,39,41,21,39,132,294,14
Andre Dawkins,SG,23,MIA,4,0,22,1,6,.167,1,6,.167,0,0,0,.250,0,0,0,0,2,2,1,0,0,1,3,3,14
Austin Daye,SF,26,TOT,34,4,344,50,141,.355,24,71,.338,26,70,.371,.440,5,6,.833,10,65,75,17,12,5,23,39,129,14
Dewayne Dedmon,C,25,ORL,59,15,845,91,162,.562,0,1,0,91,161,.565,.562,34,64,.531,118,177,295,9,16,50,51,141,216,14
Matthew Dellavedova,SG,24,CLE,67,13,1380,111,307,.362,68,167,.407,43,140,.307,.472,29,38,.763,37,89,126,204,24,2,61,152,319,14
Luol Deng,SF,29,MIA,72,72,2421,369,787,.469,78,220,.355,291,567,.513,.518,191,251,.761,103,273,376,139,65,22,108,109,1007,14
DeMar DeRozan,SG,25,TOR,60,60,2100,409,990,.413,25,88,.284,384,902,.426,.426,361,434,.832,41,236,277,210,73,11,137,122,1204,14
Boris Diaw,PF,32,SAS,81,15,1984,291,632,.460,54,169,.320,237,463,.512,.503,72,93,.774,78,270,348,233,36,23,126,148,708,14
Gorgui Dieng,C,25,MIN,73,49,2193,259,512,.506,1,6,.167,258,506,.510,.507,191,244,.783,223,386,609,146,71,126,126,188,710,14
Spencer Dinwiddie,PG,21,DET,34,1,455,51,169,.302,12,65,.185,39,104,.375,.337,31,34,.912,4,44,48,104,19,6,33,53,145,14
Joey Dorsey,PF,31,HOU,69,17,854,80,145,.552,0,1,0,80,144,.556,.552,24,83,.289,103,176,279,25,40,25,41,157,184,14
Toney Douglas,SG,28,NOP,12,0,177,19,51,.373,5,18,.278,14,33,.424,.422,8,13,.615,2,20,22,24,11,4,10,20,51,14
Chris Douglas-Roberts,SG,28,LAC,12,0,103,5,21,.238,1,7,.143,4,14,.286,.262,8,8,1.000,1,11,12,4,1,0,0,14,19,14
Goran Dragić,SG-PG,28,TOT,78,78,2640,502,1002,.501,90,259,.347,412,743,.555,.546,181,234,.774,81,193,274,350,78,15,173,195,1275,14
Zoran Dragić,SG,25,TOT,16,1,75,11,30,.367,3,14,.214,8,16,.500,.417,3,5,.600,5,3,8,5,2,0,5,6,28,14
Larry Drew II,PG,24,PHI,12,1,219,20,58,.345,4,26,.154,16,32,.500,.379,2,3,.667,1,14,15,45,6,0,25,13,46,14
Andre Drummond,C,21,DET,82,82,2502,494,961,.514,0,2,0,494,959,.515,.514,142,365,.389,437,667,1104,55,73,153,120,285,1130,14
Jared Dudley,SG,29,MIL,72,22,1717,198,423,.468,74,192,.385,124,231,.537,.556,48,67,.716,45,175,220,130,72,11,62,113,518,14
Tim Duncan,C,38,SAS,77,77,2227,419,819,.512,2,7,.286,417,812,.514,.513,230,311,.740,170,534,704,230,63,151,131,165,1070,14
Mike Dunleavy,SF,34,CHI,63,63,1838,209,481,.435,107,263,.407,102,218,.468,.546,70,87,.805,28,220,248,114,39,21,60,123,595,14
Kevin Durant,SF,26,OKC,27,27,913,238,467,.510,64,159,.403,174,308,.565,.578,146,171,.854,16,162,178,110,24,25,74,40,686,14
Cleanthony Early,SF,23,NYK,39,7,647,76,214,.355,22,84,.262,54,130,.415,.407,36,48,.750,22,75,97,36,24,12,40,57,210,14
Wayne Ellington,SG,27,LAL,65,36,1675,254,617,.412,90,243,.370,164,374,.439,.485,52,64,.813,31,179,210,105,33,2,50,77,650,14
Monta Ellis,SG,29,DAL,80,80,2699,602,1354,.445,81,284,.285,521,1070,.487,.475,228,303,.752,34,156,190,329,148,25,198,197,1513,14
James Ennis III,SF,24,MIA,62,3,1051,101,247,.409,31,95,.326,70,152,.461,.472,79,94,.840,51,125,176,48,25,17,39,89,312,14
Tyler Ennis,PG,20,TOT,33,1,411,52,144,.361,12,43,.279,40,101,.396,.403,5,7,.714,7,28,35,73,18,5,42,36,121,14
Jeremy Evans,SF,27,UTA,38,0,266,32,58,.552,2,5,.400,30,53,.566,.569,24,29,.828,26,45,71,13,11,12,5,29,90,14
Reggie Evans,PF,34,SAC,47,7,764,58,137,.423,0,2,0,58,135,.430,.423,60,97,.619,97,202,299,32,22,5,45,91,176,14
Tyreke Evans,SG,25,NOP,79,76,2690,521,1165,.447,69,227,.304,452,938,.482,.477,202,291,.694,82,334,416,521,100,37,246,198,1313,14
Dante Exum,PG,19,UTA,82,41,1817,145,416,.349,83,264,.314,62,152,.408,.448,20,32,.625,27,104,131,198,41,14,118,147,393,14
Festus Ezeli,C,25,GSW,46,7,504,76,139,.547,0,0,0,76,139,.547,.547,49,78,.628,60,95,155,9,7,42,32,77,201,14
Kenneth Faried,PF,25,DEN,75,71,2086,373,736,.507,1,8,.125,372,728,.511,.507,199,288,.691,242,426,668,89,62,57,118,211,946,14
Jordan Farmar,PG,28,LAC,36,0,529,61,158,.386,35,97,.361,26,61,.426,.497,10,11,.909,8,34,42,67,20,5,32,52,167,14
Derrick Favors,PF,23,UTA,74,74,2280,482,918,.525,1,6,.167,481,912,.527,.526,222,332,.669,196,411,607,112,60,123,121,210,1187,14
Raymond Felton,PG,30,DAL,29,3,281,43,106,.406,10,34,.294,33,72,.458,.453,12,15,.800,2,24,26,41,11,4,18,17,108,14
Landry Fields,SF,26,TOR,26,9,216,20,41,.488,1,2,.500,19,39,.487,.500,5,6,.833,10,16,26,15,11,0,8,9,46,14
Evan Fournier,SG,22,ORL,58,32,1661,253,575,.440,85,225,.378,168,350,.480,.514,107,147,.728,28,125,153,120,40,2,82,116,698,14
Randy Foye,SG,31,DEN,50,21,1087,148,402,.368,94,263,.357,54,139,.388,.485,45,55,.818,9,76,85,119,34,11,60,97,435,14
Jamaal Franklin,SG,23,DEN,3,0,13,1,2,.500,1,2,.500,0,0,0,.750,0,0,0,1,1,2,3,0,1,3,4,3,14
Tim Frazier,PG,24,TOT,11,3,239,21,61,.344,5,17,.294,16,44,.364,.385,10,21,.476,6,22,28,60,8,0,25,26,57,14
Jimmer Fredette,PG,25,NOP,50,0,509,63,166,.380,9,48,.188,54,118,.458,.407,43,45,.956,8,32,40,58,15,2,33,43,178,14
Enes Freedom,C,22,TOT,75,74,2135,482,928,.519,16,45,.356,466,883,.528,.528,183,234,.782,277,394,671,55,36,29,145,189,1163,14
Joel Freeland,C,27,POR,48,8,617,74,151,.490,0,0,0,74,151,.490,.490,21,25,.840,62,129,191,16,9,23,23,93,169,14
Channing Frye,PF,31,ORL,75,51,1870,191,487,.392,136,346,.393,55,141,.390,.532,31,35,.886,27,266,293,94,47,39,78,191,549,14
Danilo Gallinari,SF,26,DEN,59,27,1426,228,568,.401,107,301,.355,121,267,.453,.496,171,191,.895,31,187,218,83,47,20,57,94,734,14
Langston Galloway,PG,23,NYK,45,41,1457,204,511,.399,62,176,.352,142,335,.424,.460,63,78,.808,37,153,190,150,52,12,61,129,533,14
Francisco García,SF,33,HOU,14,0,200,17,63,.270,10,45,.222,7,18,.389,.349,1,4,.250,3,14,17,15,9,5,10,20,45,14
Kevin Garnett,PF,38,TOT,47,47,952,143,306,.467,1,7,.143,142,299,.475,.469,36,45,.800,48,263,311,77,46,17,46,109,323,14
Marc Gasol,C,30,MEM,81,81,2687,530,1072,.494,3,17,.176,527,1055,.500,.496,350,440,.795,115,515,630,307,70,131,176,208,1413,14
Pau Gasol,PF,34,CHI,78,78,2681,570,1153,.494,12,26,.462,558,1127,.495,.500,294,366,.803,220,699,919,210,25,147,158,147,1446,14
Rudy Gay,SF,28,SAC,68,67,2408,508,1116,.455,79,220,.359,429,896,.479,.491,337,393,.858,98,301,399,250,71,41,183,157,1432,14
Alonzo Gee,SF,27,TOT,54,2,662,87,186,.468,13,35,.371,74,151,.490,.503,54,77,.701,37,57,94,25,35,7,33,58,241,14
Paul George,SF,24,IND,6,0,91,18,49,.367,9,22,.409,9,27,.333,.459,8,11,.727,4,18,22,6,5,1,12,11,53,14
Taj Gibson,PF,29,CHI,62,17,1692,254,506,.502,0,0,0,254,506,.502,.502,132,184,.717,162,234,396,71,36,75,77,162,640,14
Manu Ginóbili,SG,37,SAS,70,0,1587,251,589,.426,89,258,.345,162,331,.489,.502,147,204,.721,28,183,211,293,67,20,154,138,738,14
Rudy Gobert,C,22,UTA,82,37,2158,258,427,.604,0,2,0,258,425,.607,.604,170,273,.623,265,510,775,109,64,189,111,175,686,14
Drew Gooden,PF,33,WAS,51,7,864,110,276,.399,23,59,.390,87,217,.401,.440,34,44,.773,72,151,223,49,21,9,28,91,277,14
Archie Goodwin,SG,20,PHO,41,2,535,79,201,.393,12,41,.293,67,160,.419,.423,61,83,.735,27,47,74,44,18,9,48,55,231,14
Aaron Gordon,PF,19,ORL,47,8,797,93,208,.447,13,48,.271,80,160,.500,.478,44,61,.721,46,123,169,33,21,22,38,83,243,14
Ben Gordon,SG,31,ORL,56,0,790,129,295,.437,35,97,.361,94,198,.475,.497,56,67,.836,6,57,63,50,14,1,55,60,349,14
Drew Gordon,PF,24,PHI,9,0,71,8,19,.421,0,3,0,8,16,.500,.421,1,2,.500,7,11,18,2,1,0,8,7,17,14
Eric Gordon,SG,26,NOP,61,60,2018,285,694,.411,141,315,.448,144,379,.380,.512,107,133,.805,28,131,159,229,50,14,122,145,818,14
Marcin Gortat,C,30,WAS,82,82,2453,439,775,.566,0,3,0,439,772,.569,.566,123,175,.703,180,537,717,97,49,110,100,191,1001,14
Danny Granger,SF,31,MIA,30,6,613,65,162,.401,30,84,.357,35,78,.449,.494,28,37,.757,20,60,80,17,13,6,24,67,188,14
Jerami Grant,SF,20,PHI,65,11,1377,124,352,.352,49,156,.314,75,196,.383,.422,114,193,.591,49,149,198,79,40,68,85,144,411,14
Danny Green,SG,27,SAS,81,80,2312,322,738,.436,191,457,.418,131,281,.466,.566,111,127,.874,54,289,343,158,101,87,93,163,946,14
Draymond Green,PF,24,GSW,79,79,2490,339,765,.443,111,329,.337,228,436,.523,.516,132,200,.660,114,533,647,291,123,99,133,253,921,14
Erick Green,PG,23,DEN,43,1,410,61,162,.377,14,47,.298,47,115,.409,.420,10,12,.833,7,24,31,39,12,0,14,26,146,14
Gerald Green,SG,29,PHO,74,4,1446,324,778,.416,137,387,.354,187,391,.478,.504,99,120,.825,33,153,186,91,42,12,104,145,884,14
JaMychal Green,PF,24,TOT,24,1,164,27,47,.574,0,6,0,27,41,.659,.574,8,10,.800,19,26,45,4,5,5,14,25,62,14
Jeff Green,SF,28,TOT,78,70,2454,416,967,.430,97,292,.332,319,675,.473,.480,239,287,.833,64,264,328,134,53,34,108,147,1168,14
Willie Green,SG,33,ORL,52,2,951,118,306,.386,42,121,.347,76,185,.411,.454,28,34,.824,14,65,79,68,26,5,48,81,306,14
Blake Griffin,PF,25,LAC,67,67,2356,574,1144,.502,10,25,.400,564,1119,.504,.506,311,427,.728,126,382,508,354,63,35,152,196,1469,14
Jorge Gutiérrez,PG,26,TOT,20,1,175,22,41,.537,0,3,0,22,38,.579,.537,9,13,.692,5,20,25,22,6,0,12,25,53,14
P.J. Hairston,SG,22,CHO,45,2,687,87,269,.323,49,163,.301,38,106,.358,.414,31,36,.861,22,70,92,21,21,13,22,61,254,14
Jordan Hamilton,SF,24,LAC,14,2,122,14,35,.400,10,21,.476,4,14,.286,.543,0,0,0,2,14,16,7,2,0,4,14,38,14
Justin Hamilton,C,24,TOT,41,14,712,85,178,.478,10,31,.323,75,147,.510,.506,39,47,.830,57,77,134,36,27,30,26,70,219,14
Tyler Hansbrough,PF,29,TOR,74,8,1058,86,165,.521,1,7,.143,85,158,.538,.524,97,139,.698,106,159,265,21,30,15,20,141,270,14
Tim Hardaway Jr.,SG,22,NYK,70,30,1681,279,717,.389,121,354,.342,158,363,.435,.474,125,156,.801,12,144,156,127,20,14,82,119,804,14
James Harden,SG,25,HOU,81,81,2981,647,1470,.440,208,555,.375,439,915,.480,.511,715,824,.868,75,384,459,565,154,60,321,208,2217,14
Maurice Harkless,SF,21,ORL,45,4,674,63,158,.399,10,56,.179,53,102,.520,.430,22,41,.537,38,68,106,25,32,9,27,66,158,14
Devin Harris,PG,31,DAL,76,3,1685,219,524,.418,95,266,.357,124,258,.481,.509,132,162,.815,13,122,135,237,78,14,85,147,665,14
Gary Harris,SG,20,DEN,55,6,719,66,217,.304,21,103,.204,45,114,.395,.353,35,47,.745,21,43,64,29,39,7,38,71,188,14
Joe Harris,SG,23,CLE,51,1,493,48,120,.400,31,84,.369,17,36,.472,.529,9,15,.600,7,34,41,26,7,2,27,62,136,14
Tobias Harris,SF,22,ORL,68,63,2369,442,949,.466,87,239,.364,355,710,.500,.512,193,245,.788,73,357,430,124,69,36,115,134,1164,14
Udonis Haslem,PF,34,MIA,62,25,995,107,239,.448,2,10,.200,105,229,.459,.452,45,64,.703,71,187,258,46,21,13,41,113,261,14
Spencer Hawes,PF,26,LAC,73,15,1274,163,415,.393,55,176,.313,108,239,.452,.459,44,68,.647,30,228,258,88,24,53,61,173,425,14
Chuck Hayes,C,31,TOR,29,0,255,22,46,.478,0,0,0,22,46,.478,.478,6,11,.545,18,33,51,20,10,4,8,37,50,14
Gordon Hayward,SF,24,UTA,76,76,2618,484,1087,.445,120,330,.364,364,757,.481,.500,375,462,.812,54,319,373,313,108,30,206,131,1463,14
Brendan Haywood,C,35,CLE,22,1,119,14,30,.467,0,0,0,14,30,.467,.467,7,13,.538,6,23,29,2,2,10,10,17,35,14
Gerald Henderson,SG,27,CHO,80,72,2315,370,847,.437,45,136,.331,325,711,.457,.463,184,217,.848,36,237,273,206,51,22,110,135,969,14
Xavier Henry,SF,23,LAL,9,0,86,3,13,.231,0,0,0,3,13,.231,.231,14,24,.583,2,2,4,3,3,0,3,6,20,14
John Henson,C,24,MIL,67,11,1228,196,346,.566,0,0,0,196,346,.566,.566,78,137,.569,124,188,312,59,28,135,87,152,470,14
Roy Hibbert,C,28,IND,76,76,1926,317,710,.446,0,2,0,317,708,.448,.446,168,204,.824,156,384,540,84,18,125,107,216,802,14
J.J. Hickson,C,26,DEN,73,8,1411,218,459,.475,0,2,0,218,457,.477,.475,116,201,.577,150,302,452,57,36,35,96,136,552,14
Nenê,PF,32,WAS,67,58,1693,307,601,.511,1,5,.200,306,596,.513,.512,122,202,.604,84,261,345,123,66,22,124,180,737,14
George Hill,PG,28,IND,43,36,1267,255,535,.477,69,193,.358,186,342,.544,.541,113,143,.790,25,154,179,220,44,14,69,111,692,14
Jordan Hill,C,27,LAL,70,57,1874,357,777,.459,3,11,.273,354,766,.462,.461,124,168,.738,174,382,556,103,34,52,106,164,841,14
Solomon Hill,SF,23,IND,82,78,2381,251,634,.396,68,208,.327,183,426,.430,.450,159,193,.824,70,244,314,184,66,18,115,177,729,14
Kirk Hinrich,SG,34,CHI,66,22,1610,142,381,.373,58,168,.345,84,213,.394,.449,35,50,.700,20,101,121,148,46,14,73,144,377,14
Jrue Holiday,PG,24,NOP,40,37,1303,238,534,.446,51,135,.378,187,399,.469,.493,65,76,.855,32,103,135,274,63,23,91,110,592,14
Justin Holiday,SG,25,GSW,59,4,657,91,235,.387,35,109,.321,56,126,.444,.462,37,45,.822,12,61,73,48,40,12,29,54,254,14
Ryan Hollins,C,30,SAC,46,9,441,53,82,.646,0,0,0,53,82,.646,.646,31,54,.574,36,67,103,14,6,19,25,65,137,14
Rodney Hood,SG,22,UTA,50,21,1064,155,374,.414,62,170,.365,93,204,.456,.497,61,80,.763,9,108,117,83,30,12,45,119,433,14
Al Horford,C,28,ATL,76,76,2318,519,965,.538,11,36,.306,508,929,.547,.544,107,141,.759,131,413,544,244,68,98,100,121,1156,14
Dwight Howard,C,29,HOU,41,41,1223,251,423,.593,1,2,.500,250,421,.594,.595,143,271,.528,110,321,431,50,28,53,115,137,646,14
Lester Hudson,SG,30,LAC,5,0,56,6,14,.429,3,6,.500,3,8,.375,.536,3,4,.750,1,7,8,5,6,1,3,4,18,14
Robbie Hummel,SF,25,MIN,45,4,742,79,172,.459,16,51,.314,63,121,.521,.506,24,29,.828,31,103,134,27,16,9,18,86,198,14
Kris Humphries,PF,29,WAS,64,17,1345,211,446,.473,0,7,0,211,439,.481,.473,87,117,.744,118,298,416,57,34,25,46,130,509,14
Serge Ibaka,PF,25,OKC,64,64,2116,374,786,.476,77,205,.376,297,581,.511,.525,92,110,.836,135,364,499,55,30,155,97,194,917,14
Andre Iguodala,SF,31,GSW,77,0,2069,231,496,.466,74,212,.349,157,284,.553,.540,68,114,.596,44,213,257,228,89,25,88,100,604,14
Ersan İlyasova,PF,27,MIL,58,36,1319,263,557,.472,74,190,.389,189,367,.515,.539,69,107,.645,80,197,277,56,36,19,45,149,669,14
Joe Ingles,SF,27,UTA,79,32,1673,147,354,.415,72,202,.356,75,152,.493,.517,30,40,.750,22,153,175,182,72,10,98,124,396,14
Kyrie Irving,PG,22,CLE,75,75,2730,578,1235,.468,157,378,.415,421,857,.491,.532,315,365,.863,55,182,237,389,114,20,186,146,1628,14
Jarrett Jack,PG,31,BRK,80,27,2241,359,817,.439,39,146,.267,320,671,.477,.463,200,227,.881,19,226,245,373,75,13,191,143,957,14
Reggie Jackson,PG,24,TOT,77,40,2268,432,996,.434,72,241,.299,360,755,.477,.470,181,218,.830,56,271,327,462,62,9,186,167,1117,14
Bernard James,C,29,DAL,16,2,158,12,27,.444,0,0,0,12,27,.444,.444,20,23,.870,18,21,39,4,2,15,6,17,44,14
LeBron James,SF,30,CLE,69,69,2493,624,1279,.488,120,339,.354,504,940,.536,.535,375,528,.710,51,365,416,511,109,49,272,135,1743,14
Al Jefferson,C,30,CHO,65,61,1992,486,1010,.481,2,5,.400,484,1005,.482,.482,108,165,.655,99,449,548,113,47,84,68,139,1082,14
Cory Jefferson,PF,24,BRK,50,1,531,75,167,.449,2,15,.133,73,152,.480,.455,31,54,.574,47,98,145,16,10,21,20,61,183,14
Richard Jefferson,SF,34,DAL,74,18,1244,144,324,.444,66,155,.426,78,169,.462,.546,78,114,.684,25,158,183,61,32,11,52,115,432,14
John Jenkins,SG,23,ATL,24,3,297,49,99,.495,21,52,.404,28,47,.596,.601,16,19,.842,2,37,39,13,10,0,8,15,135,14
Brandon Jennings,PG,25,DET,41,41,1173,218,543,.401,76,211,.360,142,332,.428,.471,120,143,.839,21,83,104,272,44,4,90,64,632,14
Jonas Jerebko,PF,27,TOT,75,0,1230,169,379,.446,54,140,.386,115,239,.481,.517,56,66,.848,93,189,282,71,46,18,44,135,448,14
Grant Jerrett,PF,21,TOT,8,0,51,7,26,.269,1,15,.067,6,11,.545,.288,1,1,1.000,2,7,9,3,2,2,3,11,16,14
Amir Johnson,PF,27,TOR,75,72,1979,298,519,.574,19,46,.413,279,473,.590,.592,79,129,.612,159,297,456,117,44,59,110,225,694,14
Chris Johnson,SF,24,TOT,29,2,526,62,154,.403,28,95,.295,34,59,.576,.494,14,16,.875,8,47,55,15,26,7,15,44,166,14
James Johnson,PF,27,TOR,70,17,1370,238,404,.589,11,51,.216,227,353,.643,.603,67,102,.657,61,196,257,95,54,70,79,155,554,14
Joe Johnson,SG,33,BRK,80,80,2791,446,1025,.435,121,337,.359,325,688,.472,.494,141,176,.801,53,331,384,292,59,14,137,120,1154,14
Nick Johnson,SG,22,HOU,28,0,262,26,75,.347,5,21,.238,21,54,.389,.380,17,25,.680,13,26,39,11,7,3,19,34,74,14
Tyler Johnson,SG,22,MIA,32,2,603,70,167,.419,18,48,.375,52,119,.437,.473,32,47,.681,14,67,81,42,33,9,30,42,190,14
Wesley Johnson,SF,27,LAL,76,59,2245,286,691,.414,91,259,.351,195,432,.451,.480,90,112,.804,67,252,319,124,59,45,87,162,753,14
Dahntay Jones,SF,34,LAC,33,0,123,6,21,.286,0,4,0,6,17,.353,.286,9,11,.818,1,10,11,2,3,0,1,23,21,14
James Jones,SF,34,CLE,57,2,669,74,201,.368,63,175,.360,11,26,.423,.525,39,46,.848,9,53,62,24,13,8,13,67,250,14
Perry Jones,SF,23,OKC,43,13,631,73,184,.397,14,60,.233,59,124,.476,.435,24,37,.649,6,70,76,18,17,8,24,50,184,14
Terrence Jones,PF,23,HOU,33,24,889,158,299,.528,13,37,.351,145,262,.553,.550,57,94,.606,78,142,220,36,18,59,37,78,386,14
DeAndre Jordan,C,26,LAC,82,82,2820,379,534,.710,1,4,.250,378,530,.713,.711,187,471,.397,397,829,1226,61,81,183,109,245,946,14
Jerome Jordan,C,28,BRK,44,0,383,50,94,.532,0,0,0,50,94,.532,.532,38,44,.864,52,53,105,13,8,15,22,58,138,14
Cory Joseph,PG,23,SAS,79,14,1444,207,411,.504,16,44,.364,191,367,.520,.523,105,143,.734,44,148,192,188,46,17,67,105,535,14
Chris Kaman,C,32,POR,74,13,1398,283,549,.515,0,0,0,283,549,.515,.515,72,102,.706,149,335,484,65,18,54,108,140,638,14
Sergey Karasev,SG,21,BRK,33,16,555,54,134,.403,16,54,.296,38,80,.475,.463,29,38,.763,22,44,66,46,23,1,24,45,153,14
Ryan Kelly,PF,23,LAL,52,34,1233,104,309,.337,45,134,.336,59,175,.337,.409,79,95,.832,13,133,146,92,30,24,37,118,332,14
Michael Kidd-Gilchrist,SF,21,CHO,55,52,1587,224,482,.465,0,0,0,224,482,.465,.465,150,214,.701,109,307,416,77,30,38,63,115,598,14
Sean Kilpatrick,SG,25,MIN,4,0,72,7,20,.350,4,13,.308,3,7,.429,.450,4,4,1.000,1,5,6,4,3,0,2,3,22,14
Andrei Kirilenko,SF,33,BRK,7,0,36,0,5,0,0,0,0,0,5,0,0,3,4,.750,2,6,8,1,1,0,1,1,3,14
Alex Kirk,C,23,CLE,5,0,14,1,4,.250,0,0,0,1,4,.250,.250,2,2,1.000,1,0,1,1,0,0,0,1,4,14
Brandon Knight,PG-SG,23,TOT,63,61,2035,375,888,.422,125,321,.389,250,567,.441,.493,195,223,.874,28,216,244,330,90,10,189,114,1070,14
Kyle Korver,SG,33,ATL,75,75,2418,292,600,.487,221,449,.492,71,151,.470,.671,106,118,.898,15,289,304,196,52,42,107,140,911,14
Kosta Koufos,C,25,MEM,81,3,1348,182,358,.508,0,0,0,182,358,.508,.508,55,85,.647,121,305,426,37,29,63,69,148,419,14
Ognjen Kuzmić,C,24,GSW,16,0,72,8,12,.667,0,0,0,8,12,.667,.667,4,4,1.000,7,10,17,6,2,1,5,13,20,14
Jeremy Lamb,SG,22,OKC,47,8,633,104,250,.416,38,111,.342,66,139,.475,.492,49,55,.891,8,99,107,44,21,6,27,52,295,14
Carl Landry,PF,31,SAC,70,15,1192,190,369,.515,0,0,0,190,369,.515,.515,123,150,.820,99,169,268,26,15,17,54,132,503,14
Shane Larkin,PG,22,NYK,76,22,1865,187,432,.433,35,116,.302,152,316,.481,.473,61,78,.782,29,147,176,226,93,9,83,150,470,14
Joffrey Lauvergne,C,23,DEN,24,1,268,36,89,.404,3,16,.188,33,73,.452,.421,18,28,.643,27,50,77,13,8,10,22,43,93,14
Zach LaVine,PG,19,MIN,77,40,1902,286,677,.422,57,167,.341,229,510,.449,.465,149,177,.842,27,187,214,276,54,10,193,158,778,14
Ty Lawson,PG,27,DEN,75,75,2665,404,926,.436,70,205,.341,334,721,.463,.474,265,363,.730,42,192,234,720,92,9,185,128,1143,14
Ricky Ledo,SG,22,TOT,17,0,244,32,96,.333,10,27,.370,22,69,.319,.385,16,22,.727,16,20,36,19,6,1,26,21,90,14
Courtney Lee,SG,29,MEM,77,74,2354,288,643,.448,90,224,.402,198,419,.473,.518,111,129,.860,21,157,178,151,75,12,78,129,777,14
David Lee,PF,31,GSW,49,4,904,160,313,.511,0,2,0,160,311,.514,.511,68,104,.654,81,176,257,85,31,26,49,83,388,14
Malcolm Lee,SG,24,PHI,1,0,2,0,1,0,0,0,0,0,1,0,0,0,0,0,0,0,0,0,0,0,0,0,0,14
Alex Len,C,21,PHO,69,44,1518,179,353,.507,1,3,.333,178,350,.509,.508,73,104,.702,142,312,454,32,34,105,74,213,432,14
Kawhi Leonard,SF,23,SAS,64,64,2033,394,822,.479,67,192,.349,327,630,.519,.520,202,252,.802,85,376,461,161,148,48,97,128,1057,14
Meyers Leonard,C,22,POR,55,7,847,125,245,.510,47,112,.420,78,133,.586,.606,30,32,.938,46,204,250,32,10,14,39,113,327,14
Jon Leuer,PF,25,MEM,63,6,824,121,273,.443,7,29,.241,114,244,.467,.456,37,59,.627,50,157,207,46,17,9,35,86,286,14
Damian Lillard,PG,24,POR,82,82,2925,590,1360,.434,196,572,.343,394,788,.500,.506,344,398,.864,49,329,378,507,97,21,222,164,1720,14
Jeremy Lin,PG,26,LAL,74,30,1907,277,654,.424,65,176,.369,212,478,.444,.473,213,268,.795,26,170,196,339,82,32,166,189,832,14
Shaun Livingston,PG,29,GSW,78,2,1468,198,396,.500,0,2,0,198,394,.503,.500,65,91,.714,43,140,183,259,49,20,102,110,461,14
Brook Lopez,C,26,BRK,72,44,2100,506,987,.513,1,10,.100,505,977,.517,.513,223,274,.814,214,321,535,50,43,126,104,206,1236,14
Robin Lopez,C,26,POR,59,59,1638,234,437,.535,0,1,0,234,436,.537,.535,98,127,.772,190,204,394,55,16,84,73,122,566,14
Kevin Love,PF,26,CLE,75,75,2532,413,952,.434,144,392,.367,269,560,.480,.509,258,321,.804,142,589,731,168,51,39,122,140,1228,14
Kyle Lowry,PG,28,TOR,70,70,2414,430,1043,.412,132,391,.338,298,652,.457,.476,252,312,.808,54,274,328,473,109,13,173,212,1244,14
Kalin Lucas,PG,25,MEM,1,0,6,0,1,0,0,0,0,0,1,0,0,0,0,0,0,0,0,0,1,0,0,1,0,14
John Lucas III,PG,32,DET,21,0,272,42,104,.404,9,29,.310,33,75,.440,.447,5,5,1.000,4,12,16,60,8,0,16,18,98,14
Shelvin Mack,PG,24,ATL,55,0,833,117,292,.401,40,127,.315,77,165,.467,.469,25,31,.806,8,71,79,155,30,2,49,32,299,14
Ian Mahinmi,C,28,IND,61,6,1146,117,212,.552,0,0,0,117,212,.552,.552,31,102,.304,105,251,356,33,30,46,59,172,265,14
Devyn Marble,SG,22,ORL,16,7,208,14,44,.318,4,22,.182,10,22,.455,.364,5,16,.313,5,26,31,17,9,2,9,14,37,14
Shawn Marion,SF,36,CLE,57,24,1101,119,267,.446,12,46,.261,107,221,.484,.468,26,34,.765,64,138,202,51,27,27,33,58,276,14
Kendall Marshall,PG,23,MIL,28,3,417,46,101,.455,18,46,.391,28,55,.509,.545,8,9,.889,2,26,28,86,21,0,35,26,118,14
Cartier Martin,SF,30,DET,23,0,198,15,53,.283,6,33,.182,9,20,.450,.340,0,0,0,0,20,20,11,3,1,5,20,36,14
Kenyon Martin,PF,37,MIL,11,0,104,9,22,.409,0,0,0,9,22,.409,.409,2,2,1.000,6,13,19,5,5,6,3,13,20,14
Kevin Martin,SG,31,MIN,39,36,1302,267,625,.427,75,191,.393,192,434,.442,.487,170,193,.881,19,123,142,89,33,1,76,76,779,14
Wesley Matthews,SG,28,POR,60,60,2024,337,752,.448,173,445,.389,164,307,.534,.563,109,145,.752,38,184,222,139,77,10,81,132,956,14
Jason Maxiell,PF,31,CHO,61,0,878,81,192,.422,0,0,0,81,192,.422,.422,41,71,.577,86,117,203,19,18,44,29,96,203,14
O.J. Mayo,SG,27,MIL,71,15,1697,296,701,.422,99,277,.357,197,424,.465,.493,115,139,.827,30,157,187,197,57,18,128,165,806,14
Luc Mbah a Moute,PF,28,PHI,67,61,1916,251,636,.395,62,202,.307,189,434,.435,.443,96,163,.589,82,246,328,106,81,21,99,104,660,14
James Michael McAdoo,PF,22,GSW,15,0,137,24,44,.545,0,0,0,24,44,.545,.545,14,25,.560,15,22,37,2,5,9,6,21,62,14
Ray McCallum,PG,23,SAC,68,30,1436,206,470,.438,34,111,.306,172,359,.479,.474,57,84,.679,52,128,180,188,45,11,85,92,503,14
CJ McCollum,SG,23,POR,62,3,973,159,365,.436,55,139,.396,104,226,.460,.511,51,73,.699,14,77,91,64,43,8,48,81,424,14
K.J. McDaniels,SG,21,TOT,62,15,1352,172,434,.396,43,150,.287,129,284,.454,.446,100,133,.752,65,135,200,72,44,70,105,126,487,14
Doug McDermott,SF,23,CHI,36,0,321,43,107,.402,13,41,.317,30,66,.455,.463,10,15,.667,6,37,43,6,4,1,17,29,109,14
Mitch McGary,PF,22,OKC,32,2,485,88,165,.533,0,2,0,88,163,.540,.533,25,40,.625,53,112,165,14,16,16,31,72,201,14
JaVale McGee,C,27,TOT,23,0,256,42,79,.532,0,0,0,42,79,.532,.532,22,33,.667,18,43,61,3,2,20,18,30,106,14
Ben McLemore,SG,21,SAC,82,82,2670,363,831,.437,140,391,.358,223,440,.507,.521,130,160,.813,31,210,241,140,77,19,138,219,996,14
Jerel McNeal,PG,27,PHO,6,0,36,3,11,.273,1,2,.500,2,9,.222,.318,2,2,1.000,0,3,3,2,3,1,5,5,9,14
Josh McRoberts,PF,27,MIA,17,4,296,28,53,.528,8,19,.421,20,34,.588,.604,8,13,.615,7,38,45,33,12,3,22,41,72,14
Jodie Meeks,SG,27,DET,60,0,1462,222,534,.416,74,212,.349,148,322,.460,.485,145,160,.906,12,92,104,79,59,6,57,76,663,14
Gal Mekel,PG,26,NOP,4,0,43,3,20,.150,0,3,0,3,17,.176,.150,0,0,0,0,1,1,13,2,0,2,1,6,14
Khris Middleton,SF,23,MIL,79,58,2378,406,869,.467,109,268,.407,297,601,.494,.530,134,156,.859,48,299,347,182,122,11,113,183,1055,14
C.J. Miles,SG,27,IND,70,40,1841,329,827,.398,154,446,.345,175,381,.459,.491,130,161,.807,18,196,214,75,60,26,73,132,942,14
Andre Miller,PG,38,TOT,81,0,1253,145,290,.500,7,34,.206,138,256,.539,.512,58,77,.753,37,116,153,284,32,6,104,103,355,14
Darius Miller,SF,24,NOP,5,1,43,1,7,.143,0,1,0,1,6,.167,.143,0,0,0,0,1,1,2,1,0,1,8,2,14
Mike Miller,SF,34,CLE,52,15,701,37,114,.325,32,98,.327,5,16,.313,.465,3,4,.750,4,87,91,46,14,4,23,74,109,14
Quincy Miller,PF,22,TOT,10,0,119,9,38,.237,3,18,.167,6,20,.300,.276,8,11,.727,4,16,20,8,7,5,5,9,29,14
Patty Mills,PG,26,SAS,51,0,801,128,336,.381,62,182,.341,66,154,.429,.473,33,40,.825,21,54,75,87,28,2,35,58,351,14
Elijah Millsap,SG,27,UTA,47,5,924,81,238,.340,28,90,.311,53,148,.358,.399,58,86,.674,28,122,150,58,56,16,67,124,248,14
Paul Millsap,PF,29,ATL,73,73,2390,443,930,.476,77,216,.356,366,714,.513,.518,255,337,.757,139,431,570,223,130,69,166,201,1218,14
Nikola Mirotić,PF,23,CHI,82,3,1654,253,624,.405,99,313,.316,154,311,.495,.485,228,284,.803,63,341,404,97,54,54,89,172,833,14
Nazr Mohammed,C,37,CHI,23,0,128,13,30,.433,0,0,0,13,30,.433,.433,1,3,.333,11,27,38,3,4,5,7,16,27,14
Greg Monroe,PF,24,DET,69,57,2137,423,853,.496,0,0,0,423,853,.496,.496,252,336,.750,229,475,704,142,78,34,149,148,1098,14
E'Twaun Moore,SG,25,CHI,56,0,504,62,139,.446,13,38,.342,49,101,.485,.493,12,20,.600,12,34,46,33,20,6,14,45,149,14
Eric Moreland,PF,23,SAC,3,0,2,1,1,1.000,0,0,0,1,1,1.000,1.000,0,0,0,0,1,1,0,0,0,0,1,2,14
Darius Morris,PG,24,BRK,38,0,299,36,106,.340,7,33,.212,29,73,.397,.373,4,9,.444,7,20,27,48,9,0,21,20,83,14
Marcus Morris,PF,25,PHO,81,35,2045,331,763,.434,112,313,.358,219,450,.487,.507,71,113,.628,73,312,385,133,63,16,73,188,845,14
Markieff Morris,PF,25,PHO,82,82,2581,512,1100,.465,57,179,.318,455,921,.494,.491,177,232,.763,110,396,506,192,101,39,170,245,1258,14
Anthony Morrow,SG,29,OKC,74,0,1806,285,615,.463,141,325,.434,144,290,.497,.578,79,89,.888,40,155,195,60,54,11,38,135,790,14
Donatas Motiejūnas,PF,24,HOU,71,62,2037,353,700,.504,49,133,.368,304,567,.536,.539,100,166,.602,137,284,421,130,56,34,123,203,855,14
Timofey Mozgov,C,28,TOT,81,80,2045,314,566,.555,2,6,.333,312,560,.557,.557,155,216,.718,203,388,591,55,33,97,116,227,785,14
Shabazz Muhammad,SG,22,MIN,38,13,866,194,397,.489,20,51,.392,174,346,.503,.514,104,145,.717,63,91,154,44,18,7,35,49,512,14
Toure' Murry,SG-PG,25,TOT,5,0,18,2,5,.400,0,0,0,2,5,.400,.400,2,2,1.000,1,0,1,1,1,0,4,2,6,14
Mike Muscala,PF,23,ATL,40,8,502,83,151,.550,9,22,.409,74,129,.574,.579,22,25,.880,52,67,119,25,16,19,21,52,197,14
Shabazz Napier,PG,23,MIA,51,10,1012,87,228,.382,43,118,.364,44,110,.400,.476,44,56,.786,17,96,113,130,40,4,81,76,261,14
Gary Neal,SG,30,TOT,54,1,1193,188,503,.374,50,164,.305,138,339,.407,.423,117,135,.867,14,115,129,100,23,1,65,88,543,14
Jameer Nelson,PG,32,TOT,63,29,1407,205,504,.407,89,258,.345,116,246,.472,.495,24,36,.667,33,113,146,253,47,6,109,136,523,14
Andrew Nicholson,PF,25,ORL,40,3,492,83,190,.437,13,41,.317,70,149,.470,.471,15,25,.600,17,65,82,22,6,12,24,51,194,14
Joakim Noah,C,29,CHI,67,67,2049,190,427,.445,0,2,0,190,425,.447,.445,105,174,.603,219,427,646,312,48,74,123,203,485,14
Nerlens Noel,C,20,PHI,75,71,2311,302,653,.462,0,0,0,302,653,.462,.462,140,230,.609,185,426,611,128,133,142,146,208,744,14
Lucas Nogueira,C,22,TOR,6,0,23,2,8,.250,0,0,0,2,8,.250,.250,2,4,.500,2,9,11,1,2,0,2,6,6,14
Steve Novak,SF-PF,31,TOT,35,0,197,22,56,.393,19,48,.396,3,8,.375,.563,0,2,0,2,20,22,11,0,2,5,23,63,14
Dirk Nowitzki,PF,36,DAL,77,77,2282,487,1062,.459,104,274,.380,383,788,.486,.508,255,289,.882,44,413,457,143,39,33,82,160,1333,14
Jusuf Nurkić,C,20,DEN,62,27,1103,171,383,.446,0,2,0,171,381,.449,.446,84,132,.636,125,257,382,50,52,68,86,207,426,14
Johnny O'Bryant,PF,21,MIL,34,15,368,44,120,.367,0,0,0,44,120,.367,.367,12,27,.444,26,38,64,17,5,4,25,44,100,14
Kyle O'Quinn,PF,24,ORL,51,17,824,119,242,.492,12,43,.279,107,199,.538,.517,44,57,.772,46,153,199,59,31,39,55,110,294,14
Victor Oladipo,SG,22,ORL,72,71,2573,473,1086,.436,84,248,.339,389,838,.464,.474,262,320,.819,51,251,302,295,120,19,204,187,1292,14
Kelly Olynyk,C,23,BOS,64,13,1423,251,528,.475,61,175,.349,190,353,.538,.533,93,136,.684,92,211,303,109,64,39,98,213,656,14
Arinze Onuaku,C,27,MIN,6,1,68,12,14,.857,0,0,0,12,14,.857,.857,3,8,.375,7,14,21,4,1,3,2,6,27,14
Zaza Pachulia,C,30,MIL,73,45,1730,240,529,.454,0,3,0,240,526,.456,.454,126,160,.788,197,303,500,178,80,21,133,170,606,14
Kostas Papanikolaou,SF,24,HOU,43,1,795,69,197,.350,31,106,.292,38,91,.418,.429,13,18,.722,39,79,118,85,29,13,55,71,182,14
Jannero Pargo,PG,35,CHO,9,0,73,15,35,.429,9,22,.409,6,13,.462,.557,2,2,1.000,0,3,3,8,0,0,3,8,41,14
Jabari Parker,PF,19,MIL,25,25,738,129,263,.490,4,16,.250,125,247,.506,.498,46,66,.697,50,88,138,42,31,5,47,42,308,14
Tony Parker,PG,32,SAS,68,68,1953,404,832,.486,38,89,.427,366,743,.493,.508,130,166,.783,15,114,129,335,44,2,146,108,976,14
Chandler Parsons,SF,26,DAL,66,66,2186,383,829,.462,132,347,.380,251,482,.521,.542,139,193,.720,64,259,323,161,69,19,96,140,1037,14
Patrick Patterson,PF,25,TOR,81,4,2156,240,535,.449,105,283,.371,135,252,.536,.547,63,80,.788,127,306,433,155,60,44,54,149,648,14
Chris Paul,PG,29,LAC,82,82,2857,568,1170,.485,139,349,.398,429,821,.523,.545,289,321,.900,52,324,376,838,156,15,190,203,1564,14
Adreian Payne,PF,23,TOT,32,22,739,91,220,.414,1,9,.111,90,211,.427,.416,30,46,.652,48,114,162,30,19,9,44,88,213,14
Elfrid Payton,PG,20,ORL,82,63,2489,301,708,.425,11,42,.262,290,666,.435,.433,118,214,.551,107,242,349,533,142,20,203,193,731,14
Nikola Peković,C,29,MIN,31,29,815,139,328,.424,0,0,0,139,328,.424,.424,108,129,.837,89,145,234,27,19,12,42,59,386,14
Kendrick Perkins,C,30,TOT,68,3,1148,102,227,.449,0,1,0,102,226,.451,.449,42,83,.506,91,229,320,51,16,42,95,162,246,14
Paul Pierce,SF,37,WAS,73,73,1914,293,656,.447,118,303,.389,175,353,.496,.537,164,210,.781,45,249,294,144,46,24,92,160,868,14
Mason Plumlee,C,24,BRK,82,45,1743,280,489,.573,0,3,0,280,486,.576,.573,157,317,.495,175,337,512,74,65,63,106,207,717,14
Miles Plumlee,C,26,TOT,73,28,1194,136,254,.535,0,0,0,136,254,.535,.535,22,46,.478,112,208,320,34,41,66,51,111,294,14
Quincy Pondexter,SF-SG,26,TOT,75,30,1793,188,447,.421,91,244,.373,97,203,.478,.522,71,96,.740,53,142,195,94,19,24,51,150,538,14
Otto Porter Jr.,SF,21,WAS,74,13,1432,176,391,.450,35,104,.337,141,287,.491,.495,58,79,.734,70,151,221,65,44,30,52,97,445,14
Dwight Powell,PF,23,TOT,29,0,236,31,67,.463,3,11,.273,28,56,.500,.485,25,33,.758,18,32,50,9,9,6,11,40,90,14
Phil Pressey,PG,23,BOS,50,0,600,64,174,.368,16,65,.246,48,109,.440,.414,33,49,.673,13,67,80,117,30,6,41,54,177,14
A.J. Price,PG,28,TOT,26,0,324,51,137,.372,15,57,.263,36,80,.450,.427,16,24,.667,6,26,32,46,7,0,14,15,133,14
Ronnie Price,PG,31,LAL,43,20,982,77,223,.345,31,109,.284,46,114,.404,.415,36,45,.800,19,50,69,165,67,4,52,118,221,14
Pablo Prigioni,PG,37,TOT,67,3,1197,91,228,.399,57,166,.343,34,62,.548,.524,35,41,.854,30,89,119,171,79,1,62,88,274,14
Tayshaun Prince,SF,34,TOT,58,16,1397,177,402,.440,31,67,.463,146,335,.436,.479,49,65,.754,52,158,210,93,29,16,35,55,434,14
Miroslav Raduljica,C,27,MIN,5,0,23,3,8,.375,0,0,0,3,8,.375,.375,2,2,1.000,2,3,5,0,1,0,2,8,8,14
Julius Randle,PF,20,LAL,1,0,14,1,3,.333,0,0,0,1,3,.333,.333,0,2,0,0,0,0,0,0,0,1,1,2,14
Shavlik Randolph,PF,31,TOT,21,0,126,9,35,.257,0,5,0,9,30,.300,.257,6,12,.500,16,22,38,4,5,3,3,16,24,14
Zach Randolph,PF,33,MEM,71,71,2304,454,932,.487,7,20,.350,447,912,.490,.491,228,298,.765,225,522,747,153,69,14,156,175,1143,14
J.J. Redick,SG,30,LAC,78,78,2409,447,938,.477,200,458,.437,247,480,.515,.583,183,203,.901,22,145,167,137,39,8,95,134,1277,14
Glen Rice Jr.,SG,24,WAS,5,0,43,3,15,.200,1,7,.143,2,8,.250,.233,4,6,.667,2,2,4,2,0,0,2,11,11,14
Jason Richardson,SG,34,PHI,19,15,416,62,178,.348,31,96,.323,31,82,.378,.435,17,22,.773,13,53,66,38,13,3,16,28,172,14
Luke Ridnour,PG,33,ORL,47,0,683,75,176,.426,20,63,.317,55,113,.487,.483,18,21,.857,8,60,68,96,20,4,38,67,188,14
Austin Rivers,PG-SG,22,TOT,76,5,1563,203,496,.409,39,131,.298,164,365,.449,.449,85,126,.675,27,125,152,155,48,14,65,146,530,14
Andre Roberson,SG,23,OKC,67,65,1286,92,201,.458,21,85,.247,71,116,.612,.510,23,48,.479,60,195,255,70,53,29,46,141,228,14
Brian Roberts,PG,29,CHO,72,10,1330,176,452,.389,62,193,.321,114,259,.440,.458,66,74,.892,13,96,109,162,33,6,57,75,480,14
Glenn Robinson III,SG-SF,21,TOT,35,1,261,26,67,.388,5,19,.263,21,48,.438,.425,16,24,.667,15,24,39,11,6,1,11,15,73,14
Nate Robinson,PG,30,TOT,42,1,591,88,255,.345,31,112,.277,57,143,.399,.406,31,46,.674,17,33,50,97,20,3,30,76,238,14
Thomas Robinson,PF,23,TOT,54,4,798,126,260,.485,0,2,0,126,258,.488,.485,56,106,.528,95,208,303,33,32,20,59,104,308,14
Rajon Rondo,PG,28,TOT,68,68,2018,275,645,.426,27,86,.314,248,559,.444,.447,31,78,.397,73,300,373,538,91,7,210,153,608,14
Derrick Rose,PG,26,CHI,51,51,1530,338,835,.405,76,271,.280,262,564,.465,.450,152,187,.813,35,126,161,251,36,16,161,63,904,14
Terrence Ross,SF,23,TOR,82,61,2092,309,753,.410,145,390,.372,164,363,.452,.507,44,56,.786,32,194,226,86,53,25,69,136,807,14
Ricky Rubio,PG,24,MIN,22,22,692,78,219,.356,13,51,.255,65,168,.387,.386,57,71,.803,19,106,125,193,38,1,64,59,226,14
Damjan Rudež,SF,28,IND,68,2,1047,119,263,.452,69,170,.406,50,93,.538,.584,16,23,.696,8,39,47,53,16,5,47,79,323,14
Brandon Rush,SG,29,GSW,33,0,271,11,54,.204,3,27,.111,8,27,.296,.231,5,11,.455,4,37,41,12,5,12,11,27,30,14
Robert Sacre,C,25,LAL,67,18,1133,126,306,.412,0,1,0,126,305,.413,.412,55,82,.671,89,144,233,55,28,43,36,121,307,14
John Salmons,SF,35,NOP,21,0,270,16,48,.333,8,26,.308,8,22,.364,.417,2,4,.500,4,17,21,13,9,4,5,25,42,14
JaKarr Sampson,SF,21,PHI,74,32,1131,146,346,.422,31,127,.244,115,219,.525,.467,63,94,.670,35,128,163,77,38,26,76,135,386,14
Larry Sanders,C,26,MIL,27,26,586,86,172,.500,0,0,0,86,172,.500,.500,24,48,.500,67,99,166,23,26,39,28,104,196,14
Dennis Schröder,PG,21,ATL,77,10,1516,284,665,.427,52,148,.351,232,517,.449,.466,148,179,.827,29,135,164,317,49,4,150,127,768,14
Luis Scola,PF,34,IND,81,16,1659,300,642,.467,5,20,.250,295,622,.474,.471,158,226,.699,138,388,526,105,47,18,94,192,763,14
Mike Scott,PF,26,ATL,68,0,1123,201,453,.444,66,192,.344,135,261,.517,.517,61,77,.792,45,154,199,75,25,3,39,83,529,14
Thabo Sefolosha,SF,30,ATL,52,7,976,104,249,.418,25,78,.321,79,171,.462,.468,45,58,.776,53,170,223,75,53,21,38,67,278,14
Kevin Séraphin,C,25,WAS,79,0,1235,231,450,.513,0,2,0,231,448,.516,.513,58,82,.707,87,201,288,59,10,59,98,197,520,14
Ramon Sessions,PG,28,TOT,64,10,1188,125,334,.374,19,60,.317,106,274,.387,.403,133,173,.769,23,121,144,182,29,0,86,73,402,14
Iman Shumpert,SG,24,TOT,62,25,1545,193,471,.410,67,196,.342,126,275,.458,.481,43,64,.672,55,169,224,135,81,16,91,138,496,14
Alexey Shved,SG,26,TOT,42,9,767,133,335,.397,47,139,.338,86,196,.439,.467,121,150,.807,23,76,99,106,30,6,48,48,434,14
Henry Sims,C,24,PHI,73,32,1399,238,502,.474,4,22,.182,234,480,.488,.478,106,137,.774,121,238,359,79,39,30,99,135,586,14
Kyle Singler,SF,26,TOT,80,58,1743,172,446,.386,96,241,.398,76,205,.371,.493,40,52,.769,33,161,194,85,47,21,55,153,480,14
Donald Sloan,PG,27,IND,53,21,1107,145,355,.408,41,131,.313,104,224,.464,.466,60,77,.779,12,131,143,190,23,0,65,47,391,14
Marcus Smart,PG,20,BOS,67,38,1808,175,477,.367,91,272,.335,84,205,.410,.462,82,127,.646,61,161,222,208,99,18,90,176,523,14
Greg Smith,PF,24,DAL,42,2,363,30,49,.612,0,0,0,30,49,.612,.612,20,39,.513,26,53,79,9,7,11,11,53,80,14
Ish Smith,PG,26,TOT,55,14,832,143,367,.390,18,60,.300,125,307,.407,.414,34,57,.596,15,85,100,180,36,6,78,50,338,14
J.R. Smith,SG,29,TOT,70,51,2080,315,755,.417,163,426,.383,152,329,.462,.525,54,72,.750,30,188,218,195,82,22,97,163,847,14
Jason Smith,C,28,NYK,82,31,1785,257,592,.434,15,42,.357,242,550,.440,.447,127,153,.830,98,226,324,140,32,44,104,205,656,14
Josh Smith,PF,29,TOT,83,35,2300,414,987,.419,72,228,.316,342,759,.451,.456,127,255,.498,152,378,530,277,87,116,206,228,1027,14
Russ Smith,PG,23,TOT,12,0,65,8,25,.320,2,11,.182,6,14,.429,.360,12,13,.923,1,5,6,8,3,0,12,13,30,14
Tony Snell,SF,23,CHI,72,22,1412,159,371,.429,73,197,.371,86,174,.494,.527,44,55,.800,31,145,176,62,32,11,48,86,435,14
Marreese Speights,C,27,GSW,76,9,1207,318,646,.492,5,18,.278,313,628,.498,.496,150,178,.843,109,216,325,72,20,34,82,189,791,14
Tiago Splitter,C,30,SAS,52,35,1030,169,303,.558,0,0,0,169,303,.558,.558,90,120,.750,91,161,252,78,35,37,60,103,428,14
Nik Stauskas,SG,21,SAC,73,1,1127,108,296,.365,48,149,.322,60,147,.408,.446,55,64,.859,11,77,88,67,20,17,40,92,319,14
Lance Stephenson,SG,24,CHO,61,25,1573,207,550,.376,18,105,.171,189,445,.425,.393,69,110,.627,39,238,277,240,38,8,128,134,501,14
Greg Stiemsma,C,29,TOR,17,0,66,6,8,.750,0,0,0,6,8,.750,.750,2,4,.500,9,6,15,3,2,0,7,15,14,14
David Stockton,PG,23,SAC,3,0,33,2,6,.333,1,2,.500,1,4,.250,.417,3,6,.500,0,2,2,9,2,0,4,1,8,14
Jarnell Stokes,PF,21,MEM,19,2,126,21,37,.568,0,0,0,21,37,.568,.568,15,28,.536,16,18,34,4,5,5,7,25,57,14
Amar'e Stoudemire,PF,32,TOT,59,15,1245,273,490,.557,0,4,0,273,486,.562,.557,134,186,.720,110,219,329,45,29,38,78,161,680,14
Rodney Stuckey,PG,28,IND,71,36,1874,332,754,.440,55,141,.390,277,613,.452,.477,177,216,.819,36,212,248,219,56,10,118,131,896,14
Jared Sullinger,PF,22,BOS,58,49,1566,311,708,.439,52,184,.283,259,524,.494,.476,96,129,.744,147,294,441,134,44,42,78,153,770,14
Jeff Taylor,SF,25,CHO,29,13,430,45,114,.395,11,36,.306,34,78,.436,.443,26,41,.634,14,39,53,22,12,1,19,36,127,14
Jeff Teague,PG,26,ATL,73,72,2228,408,887,.460,71,207,.343,337,680,.496,.500,275,319,.862,30,154,184,513,125,31,205,139,1162,14
Mirza Teletović,PF,29,BRK,40,4,892,122,319,.382,62,193,.321,60,126,.476,.480,33,46,.717,27,167,194,46,14,16,53,74,339,14
Sebastian Telfair,PG,29,OKC,16,1,327,46,125,.368,18,60,.300,28,65,.431,.440,24,34,.706,2,28,30,45,10,0,18,29,134,14
Garrett Temple,SG,28,WAS,52,18,735,68,170,.400,33,88,.375,35,82,.427,.497,35,48,.729,24,66,90,56,42,9,34,76,204,14
Jason Terry,SG,37,HOU,77,18,1641,188,446,.422,126,323,.390,62,123,.504,.563,39,48,.813,15,106,121,147,66,19,74,116,541,14
Isaiah Thomas,PG,25,TOT,67,1,1726,335,797,.420,129,346,.373,206,451,.457,.501,302,348,.868,33,120,153,284,57,5,143,150,1101,14
Lance Thomas,PF-SF,26,TOT,62,37,1490,182,442,.412,7,22,.318,175,420,.417,.420,72,99,.727,65,130,195,69,37,8,74,101,443,14
Malcolm Thomas,PF,26,PHI,17,0,194,18,40,.450,0,7,0,18,33,.545,.450,9,13,.692,16,40,56,7,3,1,13,17,45,14
Tyrus Thomas,PF,28,MEM,2,0,7,1,1,1.000,0,0,0,1,1,1.000,1.000,2,2,1.000,0,0,0,1,0,0,0,0,4,14
Hollis Thompson,SG,23,PHI,71,23,1776,224,543,.413,115,287,.401,109,256,.426,.518,63,89,.708,53,145,198,85,57,26,66,141,626,14
Jason Thompson,PF,28,SAC,81,63,1991,201,428,.470,0,1,0,201,427,.471,.470,89,143,.622,139,391,530,85,33,57,84,239,491,14
Klay Thompson,SG,24,GSW,77,77,2455,602,1299,.463,239,545,.439,363,754,.481,.555,225,256,.879,27,220,247,222,87,60,149,122,1668,14
Tristan Thompson,PF,23,CLE,82,15,2194,267,488,.547,0,0,0,267,488,.547,.547,159,248,.641,274,383,657,39,34,61,83,189,693,14
Marcus Thornton,SG,27,TOT,48,0,721,140,345,.406,54,143,.378,86,202,.426,.484,46,56,.821,23,63,86,36,27,7,27,38,380,14
Anthony Tolliver,PF,29,TOT,76,11,1432,161,393,.410,106,290,.366,55,103,.534,.545,54,69,.783,51,185,236,59,24,16,51,137,482,14
P.J. Tucker,SF,29,PHO,78,63,2383,261,596,.438,87,252,.345,174,344,.506,.511,104,143,.727,114,388,502,122,107,23,96,179,713,14
Ronny Turiaf,C,32,MIN,2,0,19,0,0,0,0,0,0,0,0,0,0,0,0,0,0,1,1,2,0,0,0,0,0,14
Hedo Türkoğlu,SF,35,LAC,62,2,705,83,188,.441,60,139,.432,23,49,.469,.601,6,11,.545,5,94,99,37,19,7,29,66,232,14
Evan Turner,SG,26,BOS,82,57,2260,320,746,.429,33,119,.277,287,627,.458,.451,106,141,.752,40,377,417,449,83,19,198,180,779,14
Ekpe Udoh,PF,27,LAC,33,0,128,11,24,.458,0,0,0,11,24,.458,.458,7,9,.778,7,19,26,8,8,7,7,20,29,14
Beno Udrih,PG,32,MEM,79,12,1494,246,505,.487,26,97,.268,220,408,.539,.513,87,102,.853,20,123,143,220,46,8,89,88,605,14
Jonas Valančiūnas,C,22,TOR,80,80,2096,373,652,.572,0,1,0,373,651,.573,.572,217,276,.786,215,478,693,39,33,95,109,222,963,14
Anderson Varejão,C,32,CLE,26,26,636,111,200,.555,0,2,0,111,198,.561,.555,33,45,.733,57,113,170,35,19,16,35,58,255,14
Greivis Vásquez,PG,28,TOR,82,29,1991,296,725,.408,133,351,.379,163,374,.436,.500,50,66,.758,22,194,216,302,46,10,119,177,775,14
Charlie Villanueva,PF,30,DAL,64,1,678,150,362,.414,83,221,.376,67,141,.475,.529,20,35,.571,30,119,149,19,15,22,28,64,403,14
Noah Vonleh,PF,19,CHO,25,0,259,30,76,.395,5,13,.385,25,63,.397,.428,18,26,.692,28,58,86,4,4,9,11,20,83,14
Nikola Vučević,C,24,ORL,74,74,2529,631,1206,.523,2,6,.333,629,1200,.524,.524,164,218,.752,238,572,810,147,54,54,148,220,1428,14
Dwyane Wade,SG,33,MIA,62,62,1971,509,1084,.470,29,102,.284,480,982,.489,.483,284,370,.768,58,161,219,299,73,21,209,105,1331,14
Dion Waiters,SG,23,TOT,80,23,2208,375,946,.396,73,246,.297,302,700,.431,.435,117,172,.680,41,151,192,163,90,21,113,155,940,14
Henry Walker,SF,27,MIA,24,13,628,58,168,.345,45,132,.341,13,36,.361,.479,14,18,.778,7,75,82,29,24,9,24,76,175,14
Kemba Walker,PG,24,CHO,62,58,2119,378,981,.385,85,280,.304,293,701,.418,.429,234,283,.827,35,185,220,318,89,31,100,92,1075,14
John Wall,PG,24,WAS,79,79,2837,519,1166,.445,65,217,.300,454,949,.478,.473,284,362,.785,36,330,366,792,138,45,304,180,1387,14
Gerald Wallace,SF,32,BOS,32,0,286,14,34,.412,1,3,.333,13,31,.419,.426,6,15,.400,17,40,57,11,15,4,18,19,35,14
T.J. Warren,SF,21,PHO,40,1,614,113,214,.528,5,21,.238,108,193,.560,.540,14,19,.737,41,44,85,25,18,9,27,51,245,14
C.J. Watson,PG,30,IND,57,21,1422,181,417,.434,70,175,.400,111,242,.459,.518,138,167,.826,18,145,163,208,57,9,100,107,570,14
David Wear,PF,24,SAC,2,0,7,0,2,0,0,1,0,0,1,0,0,0,0,0,2,0,2,1,0,0,0,1,0,14
Travis Wear,SF,24,NYK,51,1,672,84,209,.402,11,30,.367,73,179,.408,.428,20,26,.769,31,75,106,40,15,11,35,55,199,14
Martell Webster,SF,28,WAS,32,0,352,24,91,.264,10,43,.233,14,48,.292,.319,48,64,.750,10,36,46,17,7,1,22,24,106,14
David West,PF,34,IND,66,66,1895,323,686,.471,4,20,.200,319,666,.479,.474,119,161,.739,108,341,449,223,48,48,120,160,769,14
Russell Westbrook,PG,26,OKC,67,67,2302,627,1471,.426,86,288,.299,541,1183,.457,.455,546,654,.835,124,364,488,574,140,14,293,184,1886,14
Hassan Whiteside,C,25,MIA,48,32,1142,243,387,.628,0,0,0,243,387,.628,.628,78,156,.500,145,337,482,6,27,123,58,129,564,14
Shayne Whittington,PF,23,IND,20,0,108,19,42,.452,1,6,.167,18,36,.500,.464,18,23,.783,10,19,29,6,5,2,5,18,57,14
Andrew Wiggins,SF,19,MIN,82,82,2969,497,1137,.437,39,126,.310,458,1011,.453,.454,354,466,.760,134,240,374,170,86,50,177,190,1387,14
C.J. Wilcox,SG,24,LAC,21,0,101,16,38,.421,7,19,.368,9,19,.474,.513,2,2,1.000,1,6,7,8,3,1,10,7,41,14
Deron Williams,PG,30,BRK,68,55,2114,298,771,.387,87,237,.367,211,534,.395,.443,201,241,.834,29,208,237,448,64,17,154,157,884,14
Derrick Williams,PF,23,SAC,74,6,1462,217,485,.447,49,156,.314,168,329,.511,.498,134,196,.684,41,161,202,50,34,4,56,67,617,14
Elliot Williams,SG,25,TOT,13,0,119,14,37,.378,8,18,.444,6,19,.316,.486,1,4,.250,0,8,8,12,4,0,4,12,37,14
Lou Williams,SG,28,TOR,80,0,2016,375,928,.404,152,447,.340,223,481,.464,.486,340,395,.861,24,127,151,164,88,10,101,103,1242,14
Marvin Williams,PF,28,CHO,78,37,2035,210,495,.424,95,265,.358,115,230,.500,.520,62,87,.713,58,328,386,100,69,36,60,146,577,14
Mo Williams,PG,32,TOT,68,33,1980,341,860,.397,119,348,.342,222,512,.434,.466,163,187,.872,22,152,174,424,46,14,172,162,964,14
Reggie Williams,SF,28,SAS,20,0,105,15,39,.385,3,19,.158,12,20,.600,.423,4,4,1.000,5,12,17,10,1,0,2,12,37,14
Shawne Williams,SF,28,TOT,63,22,1087,121,300,.403,64,178,.360,57,122,.467,.510,35,40,.875,36,130,166,44,25,21,30,135,341,14
Jeff Withey,C,24,NOP,37,0,259,32,64,.500,0,0,0,32,64,.500,.500,34,50,.680,23,41,64,11,4,18,12,26,98,14
Nate Wolters,PG,23,TOT,21,0,247,20,57,.351,0,7,0,20,50,.400,.351,2,6,.333,8,26,34,21,8,2,13,18,42,14
Brandan Wright,PF,27,TOT,75,7,1449,233,363,.642,0,3,0,233,360,.647,.642,78,112,.696,128,193,321,41,50,94,34,102,544,14
Dorell Wright,SF,29,POR,48,2,592,72,190,.379,41,108,.380,31,82,.378,.487,34,42,.810,14,97,111,41,20,11,18,55,219,14
Tony Wroten,PG,21,PHI,30,15,895,175,434,.403,37,142,.261,138,292,.473,.446,120,180,.667,22,64,86,157,48,8,113,72,507,14
James Young,SG,19,BOS,31,0,332,36,102,.353,17,66,.258,19,36,.528,.436,16,29,.552,9,33,42,13,8,2,5,22,105,14
Nick Young,SG,29,LAL,42,0,1000,174,476,.366,83,225,.369,91,251,.363,.453,132,148,.892,17,79,96,41,23,11,44,83,563,14
Thaddeus Young,PF,26,TOT,76,68,2434,451,968,.466,38,115,.330,413,853,.484,.486,131,200,.655,127,284,411,173,124,25,117,171,1071,14
Cody Zeller,C,22,CHO,62,45,1487,172,373,.461,1,1,1.000,171,372,.460,.462,127,164,.774,97,265,362,100,34,49,62,156,472,14
Tyler Zeller,C,25,BOS,82,59,1731,340,619,.549,0,0,0,340,619,.549,.549,153,186,.823,146,319,465,113,18,52,76,205,833,14
Quincy Acy,PF,25,SAC,59,29,876,119,214,.556,19,49,.388,100,165,.606,.600,50,68,.735,65,123,188,27,29,24,27,103,307,15
Jordan Adams,SG,21,MEM,2,0,15,2,6,.333,0,1,0,2,5,.400,.333,3,5,.600,0,2,2,3,3,0,2,2,7,15
Steven Adams,C,22,OKC,80,80,2014,261,426,.613,0,0,0,261,426,.613,.613,114,196,.582,219,314,533,62,42,89,84,223,636,15
Arron Afflalo,SG,30,NYK,71,57,2371,354,799,.443,91,238,.382,263,561,.469,.500,110,131,.840,23,243,266,144,25,10,82,142,909,15
Alexis Ajinça,C,27,NOP,59,17,861,150,315,.476,0,1,0,150,314,.478,.476,52,62,.839,75,194,269,31,19,36,54,134,352,15
Cole Aldrich,C,27,LAC,60,5,800,134,225,.596,0,0,0,134,225,.596,.596,60,84,.714,86,202,288,50,47,68,64,139,328,15
LaMarcus Aldridge,PF,30,SAS,74,74,2261,536,1045,.513,0,16,0,536,1029,.521,.513,259,302,.858,176,456,632,110,38,81,99,151,1331,15
Cliff Alexander,PF,20,POR,8,0,36,5,10,.500,0,0,0,5,10,.500,.500,0,0,0,2,4,6,0,1,2,1,1,10,15
Lavoy Allen,PF,26,IND,79,28,1599,191,370,.516,0,0,0,191,370,.516,.516,46,73,.630,162,262,424,76,26,42,69,147,428,15
Tony Allen,SG,34,MEM,64,57,1620,215,469,.458,15,42,.357,200,427,.468,.474,90,138,.652,104,192,296,70,110,18,78,175,535,15
Al-Farouq Aminu,SF,25,POR,82,82,2341,299,719,.416,126,349,.361,173,370,.468,.503,115,156,.737,98,401,499,138,72,53,120,171,839,15
Lou Amundson,PF,33,NYK,29,0,204,19,53,.358,0,0,0,19,53,.358,.358,14,27,.519,23,26,49,12,6,7,15,44,52,15
Chris Andersen,C,37,TOT,27,15,402,38,72,.528,4,14,.286,34,58,.586,.556,25,36,.694,36,62,98,12,15,13,9,29,105,15
Alan Anderson,SG,33,WAS,13,0,192,21,59,.356,12,37,.324,9,22,.409,.458,11,15,.733,1,26,27,14,4,1,2,25,65,15
James Anderson,SG,26,SAC,51,15,721,67,178,.376,23,86,.267,44,92,.478,.441,22,29,.759,13,73,86,41,21,14,42,54,179,15
Justin Anderson,SF,22,DAL,55,9,647,71,175,.406,22,83,.265,49,92,.533,.469,44,55,.800,18,114,132,29,19,25,24,45,208,15
Kyle Anderson,SF,22,SAS,78,11,1245,138,295,.468,12,37,.324,126,258,.488,.488,62,83,.747,25,219,244,123,60,29,59,97,350,15
Ryan Anderson,PF,27,NOP,66,7,2008,397,929,.427,131,358,.366,266,571,.466,.498,199,228,.873,131,265,396,73,38,25,90,109,1124,15
Giannis Antetokounmpo,PG,21,MIL,80,79,2823,513,1013,.506,28,109,.257,485,904,.537,.520,296,409,.724,113,499,612,345,94,113,208,258,1350,15
Thanasis Antetokounmpo,SF,23,NYK,2,0,6,3,4,.750,0,1,0,3,3,1.000,.750,0,0,0,0,1,1,0,0,0,0,2,6,15
Carmelo Anthony,SF,31,NYK,72,72,2530,567,1307,.434,105,310,.339,462,997,.463,.474,334,403,.829,98,458,556,299,62,38,176,180,1573,15
Joel Anthony,C,33,DET,19,0,96,6,10,.600,0,0,0,6,10,.600,.600,6,8,.750,8,13,21,1,2,12,2,15,18,15
Keith Appling,PG,23,ORL,5,0,27,2,8,.250,0,3,0,2,5,.400,.250,2,2,1.000,0,1,1,1,1,0,3,5,6,15
Trevor Ariza,SF,30,HOU,81,81,2859,357,859,.416,185,499,.371,172,360,.478,.523,126,161,.783,67,299,366,188,160,26,113,177,1025,15
Darrell Arthur,PF,27,DEN,70,16,1516,221,489,.452,45,117,.385,176,372,.473,.498,40,53,.755,86,207,293,96,53,48,66,185,527,15
Ömer Aşık,C,29,NOP,68,64,1178,104,195,.533,0,0,0,104,195,.533,.533,61,112,.545,120,294,414,26,21,23,60,124,269,15
D.J. Augustin,PG,28,TOT,62,0,1178,148,350,.423,68,168,.405,80,182,.440,.520,103,128,.805,8,87,95,198,38,4,84,85,467,15
Jeff Ayres,C,28,LAC,17,0,107,12,23,.522,0,1,0,12,22,.545,.522,6,6,1.000,4,18,22,5,0,3,6,18,30,15
Luke Babbitt,SF,26,NOP,47,13,845,122,289,.422,44,109,.404,78,180,.433,.498,39,50,.780,25,123,148,53,11,7,23,90,327,15
Cameron Bairstow,C,25,CHI,18,2,103,13,40,.325,1,5,.200,12,35,.343,.338,7,8,.875,4,24,28,6,2,3,4,19,34,15
Leandro Barbosa,SG,33,GSW,68,0,1079,171,370,.462,39,110,.355,132,260,.508,.515,52,62,.839,28,89,117,82,44,10,53,107,433,15
J.J. Barea,PG,31,DAL,74,16,1667,317,711,.446,100,260,.385,217,451,.481,.516,74,96,.771,26,126,152,302,26,2,113,110,808,15
Andrea Bargnani,C,30,BRK,46,0,634,127,279,.455,3,16,.188,124,263,.471,.461,47,57,.825,28,69,97,18,4,9,26,61,304,15
Harrison Barnes,SF,23,GSW,66,59,2042,295,633,.466,82,214,.383,213,419,.508,.531,102,134,.761,77,248,325,117,41,10,57,136,774,15
Matt Barnes,SF,35,MEM,76,45,2190,264,693,.381,119,370,.322,145,323,.449,.467,111,138,.804,84,336,420,163,78,57,121,234,758,15
Will Barton,SG,25,DEN,82,1,2353,425,983,.432,112,325,.345,313,658,.476,.489,216,268,.806,59,417,476,203,71,39,139,147,1178,15
Brandon Bass,PF,30,LAL,66,0,1342,174,317,.549,0,2,0,174,315,.552,.549,125,148,.845,104,181,285,74,33,55,42,125,473,15
Nicolas Batum,SF,27,CHO,70,70,2448,372,873,.426,139,399,.348,233,474,.492,.506,163,192,.849,55,373,428,403,65,43,205,114,1046,15
Jerryd Bayless,SG,27,MIL,52,18,1505,185,437,.423,101,231,.437,84,206,.408,.539,70,90,.778,21,120,141,163,47,11,73,111,541,15
Aron Baynes,C,29,DET,81,1,1233,194,384,.505,0,2,0,194,382,.508,.505,126,165,.764,140,244,384,51,21,52,67,151,514,15
Kent Bazemore,SF,26,ATL,75,68,2083,320,725,.441,109,305,.357,211,420,.502,.517,123,151,.815,28,351,379,171,98,38,138,176,872,15
Bradley Beal,SG,22,WAS,55,35,1708,359,799,.449,105,271,.387,254,528,.481,.515,135,176,.767,41,147,188,162,54,11,112,117,958,15
Michael Beasley,PF,27,HOU,20,0,363,107,205,.522,3,9,.333,104,196,.531,.529,38,49,.776,29,69,98,16,11,9,24,39,255,15
Marco Belinelli,SG,29,SAC,68,7,1672,245,635,.386,91,297,.306,154,338,.456,.457,115,138,.833,10,107,117,127,37,2,80,91,696,15
Anthony Bennett,PF,22,TOR,19,0,84,8,27,.296,3,14,.214,5,13,.385,.352,9,10,.900,6,17,23,0,5,0,4,8,28,15
Patrick Beverley,PG,27,HOU,71,63,2041,258,594,.434,124,310,.400,134,284,.472,.539,60,88,.682,73,177,250,239,94,26,91,234,700,15
Bismack Biyombo,C,23,TOR,82,22,1808,156,288,.542,0,1,0,156,287,.544,.542,142,226,.628,182,473,655,29,19,133,71,225,454,15
Nemanja Bjelica,PF,27,MIN,60,0,1075,110,235,.468,48,125,.384,62,110,.564,.570,40,55,.727,49,161,210,83,26,21,47,154,308,15
Tarik Black,C,24,LAL,39,0,496,57,104,.548,0,0,0,57,104,.548,.548,19,45,.422,44,113,157,16,14,18,22,78,133,15
DeJuan Blair,C,26,WAS,29,0,218,28,68,.412,0,1,0,28,67,.418,.412,5,13,.385,20,37,57,11,8,2,15,53,61,15
Steve Blake,PG,35,DET,58,2,986,93,240,.388,52,151,.344,41,89,.461,.496,16,20,.800,9,80,89,200,24,5,81,70,254,15
Eric Bledsoe,PG,26,PHO,31,31,1059,223,492,.453,48,129,.372,175,363,.482,.502,138,172,.802,18,107,125,190,63,19,110,75,632,15
Bojan Bogdanović,SF,26,BRK,79,39,2115,324,749,.433,129,338,.382,195,411,.474,.519,110,132,.833,36,219,255,99,29,5,115,119,887,15
Andrew Bogut,C,31,GSW,70,66,1451,175,279,.627,1,1,1.000,174,278,.626,.629,24,50,.480,121,371,492,162,33,114,83,221,375,15
Matt Bonner,C,35,SAS,30,2,206,29,57,.509,15,34,.441,14,23,.609,.640,3,4,.750,3,24,27,9,6,1,3,16,76,15
Devin Booker,SG,19,PHO,76,51,2108,367,867,.423,99,289,.343,268,578,.464,.480,215,256,.840,27,160,187,200,44,20,160,225,1048,15
Trevor Booker,PF,28,UTA,79,2,1632,190,388,.490,12,41,.293,178,347,.513,.505,71,106,.670,166,286,452,84,59,41,81,169,463,15
Chris Bosh,PF,31,MIA,53,53,1778,358,767,.467,81,222,.365,277,545,.508,.520,213,268,.795,48,342,390,128,36,34,78,101,1010,15
Avery Bradley,SG,25,BOS,76,72,2536,456,1019,.447,147,407,.361,309,612,.505,.520,96,123,.780,48,172,220,158,117,19,109,164,1155,15
Elton Brand,C,36,PHI,17,1,225,31,72,.431,0,1,0,31,71,.437,.431,8,9,.889,9,54,63,18,9,8,11,32,70,15
Corey Brewer,SF,29,HOU,82,12,1669,212,552,.384,61,224,.272,151,328,.460,.439,105,140,.750,42,157,199,109,84,19,78,168,590,15
Aaron Brooks,PG,31,CHI,69,0,1108,188,469,.401,66,185,.357,122,284,.430,.471,49,64,.766,21,80,101,180,30,10,82,132,491,15
Anthony Brown,SF,23,LAL,29,11,599,39,126,.310,20,70,.286,19,56,.339,.389,17,20,.850,9,61,70,19,14,5,15,34,115,15
Lorenzo Brown,PG,25,PHO,8,0,61,8,25,.320,1,8,.125,7,17,.412,.340,3,4,.750,0,7,7,11,3,1,9,4,20,15
Markel Brown,SG,24,BRK,62,6,982,127,322,.394,38,121,.314,89,201,.443,.453,71,94,.755,23,99,122,91,38,15,54,94,363,15
Kobe Bryant,SF,37,LAL,66,66,1863,398,1113,.358,133,467,.285,265,646,.410,.417,232,281,.826,41,206,247,184,62,13,129,115,1161,15
Chase Budinger,SF,27,TOT,66,2,929,104,239,.435,24,86,.279,80,153,.523,.485,39,56,.696,43,107,150,64,32,10,44,62,271,15
Reggie Bullock,SF,24,DET,37,0,429,43,98,.439,22,53,.415,21,45,.467,.551,14,15,.933,14,54,68,27,10,2,8,29,122,15
Trey Burke,PG,23,UTA,64,0,1366,262,634,.413,88,256,.344,174,378,.460,.483,67,82,.817,18,94,112,148,35,6,80,86,679,15
Alec Burks,SG,24,UTA,31,3,797,137,334,.410,32,79,.405,105,255,.412,.458,106,141,.752,16,93,109,63,18,4,51,71,412,15
Caron Butler,SF,35,SAC,17,1,176,25,59,.424,3,18,.167,22,41,.537,.449,10,12,.833,5,17,22,10,9,1,3,19,63,15
Jimmy Butler,SG,26,CHI,67,67,2474,470,1035,.454,64,205,.312,406,830,.489,.485,395,475,.832,79,279,358,321,110,43,132,124,1399,15
Rasual Butler,SF,36,SAS,46,0,432,49,104,.471,15,49,.306,34,55,.618,.543,11,16,.688,3,53,56,24,13,23,8,11,124,15
Bruno Caboclo,SF,20,TOR,6,1,43,1,12,.083,1,7,.143,0,5,0,.125,0,0,0,1,1,2,1,2,1,4,2,3,15
José Calderón,PG,34,NYK,72,72,2024,209,455,.459,84,203,.414,125,252,.496,.552,42,48,.875,22,207,229,298,63,7,87,135,544,15
Kentavious Caldwell-Pope,SG,22,DET,76,76,2789,403,960,.420,114,369,.309,289,591,.489,.479,185,228,.811,70,212,282,138,110,17,105,167,1105,15
Isaiah Canaan,SG,24,PHI,77,39,1966,260,722,.360,176,485,.363,84,237,.354,.482,150,180,.833,20,154,174,137,56,12,91,133,846,15
Clint Capela,C,21,HOU,77,35,1471,231,397,.582,0,1,0,231,396,.583,.582,80,211,.379,194,300,494,47,59,92,60,190,542,15
DeMarre Carroll,SF,29,TOR,26,22,786,105,270,.389,46,118,.390,59,152,.388,.474,30,50,.600,31,91,122,27,44,6,28,63,286,15
Vince Carter,SG,39,MEM,60,3,1005,133,343,.388,59,169,.349,74,174,.425,.474,70,84,.833,31,115,146,56,38,16,35,101,395,15
Michael Carter-Williams,PG,24,MIL,54,37,1649,251,555,.452,15,55,.273,236,500,.472,.466,106,162,.654,48,228,276,281,80,41,153,162,623,15
Omri Casspi,PF,27,SAC,69,21,1880,299,622,.481,112,274,.409,187,348,.537,.571,103,159,.648,58,352,410,95,56,17,94,154,813,15
Willie Cauley-Stein,C,22,SAC,66,39,1412,191,339,.563,0,2,0,191,337,.567,.563,81,125,.648,134,218,352,37,48,66,46,146,463,15
Mario Chalmers,PG,29,TOT,61,7,1373,182,444,.410,46,149,.309,136,295,.461,.462,218,262,.832,24,133,157,230,88,13,110,181,628,15
Tyson Chandler,C,33,PHO,66,60,1618,183,314,.583,0,1,0,183,313,.585,.583,106,171,.620,175,401,576,64,36,44,93,145,472,15
Rakeem Christmas,PF,24,IND,1,0,6,2,2,1.000,0,0,0,2,2,1.000,1.000,0,0,0,1,0,1,0,0,0,0,1,4,15
Ian Clark,SG,24,GSW,66,1,578,89,202,.441,30,84,.357,59,118,.500,.515,28,34,.824,13,55,68,64,17,13,43,58,236,15
Coty Clarke,SF,23,BOS,3,0,6,2,4,.500,2,2,1.000,0,2,0,.750,0,0,0,0,1,1,0,0,0,1,0,6,15
Jordan Clarkson,SG,23,LAL,79,79,2552,475,1098,.433,111,320,.347,364,778,.468,.483,164,204,.804,93,220,313,192,88,7,135,168,1225,15
Norris Cole,PG,27,NOP,45,23,1198,196,484,.405,33,102,.324,163,382,.427,.439,52,65,.800,10,141,151,167,37,5,75,102,477,15
Darren Collison,PG,28,SAC,74,15,2219,377,776,.486,87,217,.401,290,559,.519,.542,194,226,.858,28,141,169,318,76,4,130,142,1035,15
Nick Collison,PF,35,OKC,59,4,699,50,109,.459,0,2,0,50,107,.467,.459,23,33,.697,68,103,171,52,15,16,50,107,123,15
Mike Conley,PG,28,MEM,56,56,1761,294,696,.422,78,215,.363,216,481,.449,.478,191,229,.834,26,138,164,342,67,16,84,100,857,15
Pat Connaughton,SG,23,POR,34,0,143,13,49,.265,5,21,.238,8,28,.286,.316,5,5,1.000,11,21,32,10,2,0,10,6,36,15
Chris Copeland,PF,31,MIL,24,1,156,17,51,.333,10,36,.278,7,15,.467,.431,6,7,.857,1,9,10,11,2,0,6,17,50,15
Bryce Cotton,PG,23,TOT,8,0,39,4,10,.400,0,3,0,4,7,.571,.400,0,0,0,0,0,0,3,3,0,5,2,8,15
DeMarcus Cousins,C,25,SAC,65,65,2246,601,1332,.451,70,210,.333,531,1122,.473,.477,476,663,.718,158,589,747,214,101,92,249,236,1748,15
Robert Covington,SF,25,PHI,67,49,1903,274,712,.385,170,482,.353,104,230,.452,.504,140,177,.791,65,354,419,97,105,40,143,232,858,15
Allen Crabbe,SG,23,POR,81,8,2105,311,678,.459,112,285,.393,199,393,.506,.541,98,113,.867,27,189,216,99,63,16,64,192,832,15
Jamal Crawford,SG,35,LAC,79,5,2126,379,939,.404,117,344,.340,262,595,.440,.466,245,271,.904,20,125,145,183,52,12,113,122,1120,15
Jae Crowder,SF,25,BOS,73,73,2308,360,813,.443,122,363,.336,238,450,.529,.518,196,239,.820,70,303,373,135,126,35,83,198,1038,15
Dante Cunningham,SF,28,NOP,80,46,1971,186,412,.451,55,174,.316,131,238,.550,.518,57,82,.695,57,179,236,77,42,33,41,173,484,15
Jared Cunningham,SG,24,TOT,44,3,410,36,105,.343,12,39,.308,24,66,.364,.400,36,55,.655,3,35,38,20,14,2,21,41,120,15
Seth Curry,PG,25,SAC,44,9,692,102,224,.455,50,111,.450,52,113,.460,.567,45,54,.833,9,51,60,67,22,3,36,41,299,15
Stephen Curry,PG,27,GSW,79,79,2700,805,1598,.504,402,886,.454,403,712,.566,.630,363,400,.908,68,362,430,527,169,15,262,161,2375,15
Troy Daniels,SG,24,CHO,43,0,476,89,187,.476,59,122,.484,30,65,.462,.634,5,9,.556,7,50,57,21,11,3,24,40,242,15
Anthony Davis,C,22,NOP,61,61,2164,560,1136,.493,35,108,.324,525,1028,.511,.508,326,430,.758,130,497,627,116,78,125,121,148,1481,15
Ed Davis,PF,26,POR,81,0,1684,206,337,.611,0,0,0,206,337,.611,.611,114,204,.559,224,375,599,88,57,72,64,202,526,15
Branden Dawson,PF,22,LAC,6,0,29,2,5,.400,0,0,0,2,5,.400,.400,1,1,1.000,2,2,4,0,0,1,0,2,5,15
Dewayne Dedmon,C,26,ORL,58,20,705,99,177,.559,0,0,0,99,177,.559,.559,57,76,.750,67,161,228,13,22,46,32,109,255,15
Bryce Dejean-Jones,SG,23,NOP,14,11,279,28,69,.406,12,32,.375,16,37,.432,.493,11,21,.524,8,40,48,15,10,2,11,17,79,15
Sam Dekker,PF,21,HOU,3,0,6,0,0,0,0,0,0,0,0,0,0,0,0,0,0,1,1,0,1,0,0,0,0,15
Matthew Dellavedova,PG,25,CLE,76,14,1867,207,511,.405,98,239,.410,109,272,.401,.501,57,66,.864,33,129,162,337,44,9,116,178,569,15
Luol Deng,PF,30,MIA,74,73,2394,339,745,.455,88,256,.344,251,489,.513,.514,145,192,.755,108,335,443,140,74,29,81,122,911,15
DeMar DeRozan,SG,26,TOR,78,78,2804,614,1377,.446,47,139,.338,567,1238,.458,.463,555,653,.850,64,285,349,315,81,21,175,167,1830,15
Boris Diaw,PF,33,SAS,76,4,1386,202,383,.527,25,69,.362,177,314,.564,.560,56,76,.737,58,175,233,176,26,21,97,102,485,15
Gorgui Dieng,C,26,MIN,82,39,2220,308,579,.532,6,20,.300,302,559,.540,.537,205,248,.827,157,428,585,143,94,96,140,219,827,15
Spencer Dinwiddie,PG,22,DET,12,0,159,19,54,.352,1,10,.100,18,44,.409,.361,19,33,.576,4,13,17,22,3,0,7,20,58,15
Toney Douglas,PG,29,NOP,61,18,1262,183,445,.411,81,203,.399,102,242,.421,.502,84,99,.848,25,118,143,157,70,5,64,131,531,15
Goran Dragić,PG,29,MIA,72,72,2363,417,875,.477,64,205,.312,353,670,.527,.513,120,165,.727,54,223,277,419,71,17,185,188,1018,15
Andre Drummond,C,22,DET,81,81,2666,552,1060,.521,2,6,.333,550,1054,.522,.522,208,586,.355,395,803,1198,67,119,112,155,245,1314,15
Jared Dudley,PF,30,WAS,81,41,2098,233,487,.478,100,238,.420,133,249,.534,.581,72,98,.735,54,232,286,170,75,18,80,190,638,15
Duje Dukan,SF,24,SAC,1,0,24,2,10,.200,2,5,.400,0,5,0,.300,0,0,0,2,2,4,1,1,0,0,2,6,15
Tim Duncan,C,39,SAS,61,60,1536,215,441,.488,0,2,0,215,439,.490,.488,92,131,.702,115,332,447,163,47,78,90,125,522,15
Mike Dunleavy,SF,35,CHI,31,30,703,77,188,.410,39,99,.394,38,89,.427,.513,29,37,.784,8,75,83,39,14,10,26,66,222,15
Kevin Durant,SF,27,OKC,72,72,2578,698,1381,.505,186,481,.387,512,900,.569,.573,447,498,.898,45,544,589,361,69,85,250,137,2029,15
Cleanthony Early,SF,24,NYK,17,2,154,12,40,.300,4,15,.267,8,25,.320,.350,3,4,.750,4,22,26,6,2,3,9,16,31,15
Jarell Eddie,SF,24,WAS,26,0,147,20,65,.308,15,47,.319,5,18,.278,.423,8,8,1.000,2,21,23,5,5,1,1,5,63,15
Wayne Ellington,SG,28,BRK,76,41,1615,218,561,.389,96,268,.358,122,293,.416,.474,54,63,.857,20,154,174,83,48,5,45,82,586,15
Monta Ellis,SG,30,IND,81,81,2734,436,1021,.427,87,282,.309,349,739,.472,.470,162,206,.786,42,229,271,383,150,37,203,174,1121,15
James Ennis III,SF,25,TOT,22,5,329,54,113,.478,26,58,.448,28,55,.509,.593,25,34,.735,21,21,42,21,16,5,19,28,159,15
Tyler Ennis,PG,21,MIL,46,7,654,84,187,.449,13,39,.333,71,148,.480,.484,25,34,.735,13,62,75,95,25,1,46,64,206,15
Jeremy Evans,SF,28,DAL,30,2,251,26,48,.542,4,16,.250,22,32,.688,.583,15,21,.714,11,43,54,2,6,9,7,19,71,15
Tyreke Evans,SG,26,NOP,25,25,765,136,314,.433,33,85,.388,103,229,.450,.486,74,93,.796,20,109,129,164,32,8,73,66,379,15
Festus Ezeli,C,26,GSW,46,13,770,125,228,.548,0,0,0,125,228,.548,.548,70,132,.530,91,166,257,32,18,50,38,94,320,15
Kenneth Faried,PF,26,DEN,67,64,1694,349,626,.558,1,2,.500,348,624,.558,.558,136,222,.613,235,346,581,79,32,60,91,169,835,15
Jordan Farmar,PG,29,MEM,12,10,291,42,100,.420,16,45,.356,26,55,.473,.500,10,10,1.000,4,21,25,37,15,2,18,22,110,15
Derrick Favors,PF,24,UTA,62,59,1983,418,811,.515,0,4,0,418,807,.518,.515,180,254,.709,169,334,503,94,74,91,104,150,1016,15
Cristiano Felício,C,23,CHI,31,4,321,40,72,.556,0,4,0,40,68,.588,.556,25,35,.714,30,72,102,26,6,13,13,31,105,15
Raymond Felton,PG,31,DAL,80,31,2192,277,682,.406,60,213,.282,217,469,.463,.450,149,176,.847,36,222,258,284,68,15,121,141,763,15
Evan Fournier,SF,23,ORL,79,71,2566,429,929,.462,156,390,.400,273,539,.506,.546,199,238,.836,33,192,225,213,96,2,133,214,1213,15
Randy Foye,SG,32,TOT,81,8,1642,169,482,.351,75,250,.300,94,232,.405,.428,61,74,.824,24,132,156,161,39,29,86,131,474,15
Tim Frazier,PG,25,TOT,51,2,741,96,229,.419,16,48,.333,80,181,.442,.454,53,74,.716,26,84,110,162,33,2,65,73,261,15
Jimmer Fredette,SG,26,TOT,6,0,18,2,5,.400,1,2,.500,1,3,.333,.500,4,5,.800,0,0,0,1,1,0,2,2,9,15
Enes Freedom,C,23,OKC,82,1,1721,414,719,.576,10,21,.476,404,698,.579,.583,200,251,.797,249,415,664,33,26,33,115,166,1038,15
Channing Frye,PF-C,32,TOT,70,32,1200,152,347,.438,91,235,.387,61,112,.545,.569,30,35,.857,35,199,234,71,29,28,43,127,425,15
Danilo Gallinari,SF,27,DEN,53,53,1839,287,700,.410,87,239,.364,200,461,.434,.472,375,432,.868,52,229,281,135,42,19,77,87,1036,15
Langston Galloway,PG,24,NYK,82,7,2033,231,588,.393,77,224,.344,154,364,.423,.458,86,114,.754,43,245,288,207,77,22,61,177,625,15
Kevin Garnett,PF,39,MIN,38,38,556,54,115,.470,0,1,0,54,114,.474,.470,14,21,.667,15,135,150,62,28,10,16,70,122,15
Marc Gasol,C,31,MEM,52,52,1791,328,707,.464,2,3,.667,326,704,.463,.465,203,245,.829,58,304,362,196,50,70,118,141,861,15
Pau Gasol,C,35,CHI,72,72,2291,467,995,.469,24,69,.348,443,926,.478,.481,229,289,.792,155,638,793,294,42,146,164,148,1187,15
Rudy Gay,SF,29,SAC,70,70,2379,466,1007,.463,74,215,.344,392,792,.495,.500,198,254,.780,103,353,456,120,100,51,139,184,1204,15
Alonzo Gee,SF,28,NOP,73,38,1632,132,255,.518,17,60,.283,115,195,.590,.551,44,66,.667,60,185,245,72,63,13,55,169,325,15
Paul George,SF,25,IND,81,81,2819,605,1449,.418,210,566,.371,395,883,.447,.490,454,528,.860,79,484,563,329,152,29,265,230,1874,15
Taj Gibson,PF,30,CHI,73,55,1936,263,500,.526,0,3,0,263,497,.529,.526,101,146,.692,206,298,504,106,47,77,78,180,627,15
Manu Ginóbili,SG,38,SAS,58,0,1134,197,435,.453,70,179,.391,127,256,.496,.533,91,112,.813,26,120,146,177,66,11,99,99,555,15
Rudy Gobert,C,23,UTA,61,60,1932,198,354,.559,0,0,0,198,354,.559,.559,161,283,.569,208,460,668,91,45,135,114,163,557,15
Drew Gooden,PF,34,WAS,30,0,305,33,103,.320,7,41,.171,26,62,.419,.354,9,14,.643,28,57,85,13,8,11,13,40,82,15
Archie Goodwin,PG,21,PHO,57,13,1114,176,422,.417,23,99,.232,153,323,.474,.444,130,193,.674,27,115,142,118,27,13,100,84,505,15
Aaron Gordon,PF,20,ORL,78,37,1863,274,579,.473,42,142,.296,232,437,.531,.509,129,193,.668,154,353,507,128,59,55,66,153,719,15
Eric Gordon,SG,27,NOP,45,44,1481,231,552,.418,113,294,.384,118,258,.457,.521,111,125,.888,10,89,99,121,43,14,73,98,686,15
Marcin Gortat,C,31,WAS,75,74,2256,433,764,.567,0,1,0,433,763,.567,.567,146,207,.705,222,519,741,106,47,96,121,193,1012,15
Andrew Goudelock,PG,27,HOU,8,0,50,9,20,.450,1,9,.111,8,11,.727,.475,3,4,.750,1,1,2,4,6,2,7,4,22,15
Jerami Grant,PF,21,PHI,77,52,2066,251,599,.419,35,146,.240,216,453,.477,.448,212,322,.658,99,262,361,135,54,127,110,215,749,15
Jerian Grant,PG,23,NYK,76,6,1265,154,391,.394,22,100,.220,132,291,.454,.422,96,123,.780,23,120,143,177,50,10,87,97,426,15
Danny Green,SG,28,SAS,79,79,2062,211,561,.376,116,349,.332,95,212,.448,.480,34,46,.739,48,255,303,141,79,64,75,141,572,15
Draymond Green,PF,25,GSW,81,81,2808,401,819,.490,100,258,.388,301,561,.537,.551,229,329,.696,134,635,769,598,119,113,259,240,1131,15
Erick Green,PG,24,TOT,9,0,42,5,13,.385,1,5,.200,4,8,.500,.423,2,2,1.000,3,3,6,3,1,0,0,4,13,15
Gerald Green,SG,30,MIA,69,14,1557,230,587,.392,84,260,.323,146,327,.446,.463,72,92,.783,25,138,163,56,38,19,46,123,616,15
JaMychal Green,PF,25,MEM,78,15,1446,230,495,.465,15,45,.333,215,450,.478,.480,103,137,.752,139,234,373,67,46,33,83,189,578,15
Jeff Green,SF,29,TOT,80,41,2253,354,824,.430,67,213,.315,287,611,.470,.470,164,220,.745,74,258,332,138,58,40,93,164,939,15
Blake Griffin,PF,26,LAC,35,35,1170,301,603,.499,6,18,.333,295,585,.504,.504,141,194,.727,51,243,294,170,28,17,83,95,749,15
Jorge Gutiérrez,PG,27,CHO,12,0,63,6,11,.545,0,2,0,6,9,.667,.545,10,11,.909,0,7,7,17,3,0,6,3,22,15
P.J. Hairston,SF,23,TOT,66,52,1313,145,408,.355,70,241,.290,75,167,.449,.441,50,64,.781,25,149,174,38,32,11,41,137,410,15
Jordan Hamilton,SF,25,NOP,11,4,304,49,116,.422,13,45,.289,36,71,.507,.478,14,21,.667,12,50,62,25,8,3,17,24,125,15
Tyler Hansbrough,PF,30,CHO,44,0,343,32,71,.451,2,3,.667,30,68,.441,.465,38,65,.585,40,49,89,8,12,7,12,55,104,15
Tim Hardaway Jr.,SG,23,ATL,51,1,864,114,265,.430,48,142,.338,66,123,.537,.521,50,56,.893,7,79,86,51,21,7,23,48,326,15
James Harden,SG,26,HOU,82,82,3125,710,1617,.439,236,657,.359,474,960,.494,.512,720,837,.860,63,438,501,612,139,51,374,229,2376,15
Maurice Harkless,SF,22,POR,78,14,1457,195,411,.474,39,140,.279,156,271,.576,.522,69,111,.622,101,179,280,67,49,35,62,124,498,15
Justin Harper,PF,26,DET,5,0,35,4,10,.400,4,9,.444,0,1,0,.600,1,2,.500,0,1,1,0,1,0,2,3,13,15
Montrezl Harrell,PF,22,HOU,39,1,379,58,90,.644,0,1,0,58,89,.652,.644,24,46,.522,25,40,65,17,11,11,17,48,140,15
Devin Harris,PG,32,DAL,64,0,1280,167,374,.447,52,158,.329,115,216,.532,.516,101,140,.721,18,120,138,118,60,13,66,124,487,15
Gary Harris,SG,21,DEN,76,76,2439,359,765,.469,105,297,.354,254,468,.543,.538,109,133,.820,54,166,220,147,97,18,98,143,932,15
Joe Harris,SG,24,CLE,5,0,15,1,4,.250,1,4,.250,0,0,0,.375,0,0,0,0,3,3,2,0,0,1,1,3,15
Tobias Harris,PF,23,TOT,76,74,2513,417,889,.469,80,239,.335,337,650,.518,.514,202,243,.831,96,414,510,169,65,40,108,153,1116,15
Aaron Harrison,SG,21,CHO,21,0,93,5,19,.263,3,10,.300,2,9,.222,.342,5,12,.417,4,11,15,2,6,0,4,10,18,15
Udonis Haslem,PF,35,MIA,37,0,260,23,61,.377,1,9,.111,22,52,.423,.385,12,16,.750,10,65,75,14,5,2,5,25,59,15
Spencer Hawes,PF,27,CHO,57,6,1035,124,306,.405,38,102,.373,86,204,.422,.467,54,65,.831,51,193,244,109,22,27,58,111,340,15
Chuck Hayes,C,32,HOU,2,0,24,1,2,.500,0,0,0,1,2,.500,.500,2,2,1.000,0,8,8,2,0,0,3,6,4,15
Gordon Hayward,SF,25,UTA,80,80,2893,521,1202,.433,143,410,.349,378,792,.477,.493,393,477,.824,61,336,397,296,95,27,202,183,1578,15
Gerald Henderson,SG,28,POR,72,0,1431,232,529,.439,48,136,.353,184,393,.468,.484,112,146,.767,30,181,211,75,39,19,68,87,624,15
John Henson,C,25,MIL,57,1,960,164,291,.564,0,1,0,164,290,.566,.564,69,117,.590,87,134,221,54,18,109,64,131,397,15
Mario Hezonja,SF,20,ORL,79,9,1413,181,418,.433,67,192,.349,114,226,.504,.513,49,54,.907,28,148,176,109,39,17,97,124,478,15
Roy Hibbert,C,29,LAL,81,81,1878,182,411,.443,0,2,0,182,409,.445,.443,117,145,.807,132,266,398,95,32,110,76,252,481,15
J.J. Hickson,C,27,TOT,35,9,436,80,155,.516,0,1,0,80,154,.519,.516,46,103,.447,39,93,132,23,15,14,25,47,206,15
Nenê,PF,33,WAS,57,11,1094,209,384,.544,0,3,0,209,381,.549,.544,107,185,.578,52,207,259,97,54,26,76,156,525,15
George Hill,PG,29,IND,74,73,2524,326,739,.441,128,314,.408,198,425,.466,.528,114,150,.760,58,240,298,259,83,17,101,149,894,15
Jordan Hill,C,28,IND,73,11,1513,278,549,.506,0,1,0,278,548,.507,.506,89,125,.712,156,295,451,87,36,37,92,155,645,15
Solomon Hill,SF,24,IND,59,3,866,93,208,.447,24,74,.324,69,134,.515,.505,36,42,.857,39,127,166,57,37,11,33,68,246,15
Darrun Hilliard,SG,22,DET,38,2,383,52,131,.397,19,50,.380,33,81,.407,.469,29,40,.725,5,40,45,27,9,1,19,28,152,15
Kirk Hinrich,PG,35,TOT,46,7,631,49,129,.380,24,62,.387,25,67,.373,.473,15,16,.938,8,62,70,73,15,2,30,64,137,15
Jrue Holiday,PG,25,NOP,65,23,1831,410,935,.439,87,259,.336,323,676,.478,.485,182,216,.843,27,168,195,391,88,22,167,148,1089,15
Justin Holiday,SG,26,TOT,53,5,773,88,228,.386,36,105,.343,52,123,.423,.465,27,37,.730,12,78,90,56,32,19,39,61,239,15
Ryan Hollins,C,31,TOT,37,12,460,49,79,.620,0,0,0,49,79,.620,.620,26,42,.619,47,51,98,10,6,21,24,62,124,15
Rondae Hollis-Jefferson,SF,21,BRK,29,17,615,63,138,.457,4,14,.286,59,124,.476,.471,37,52,.712,39,115,154,43,39,16,26,61,167,15
Richaun Holmes,PF,22,PHI,51,1,702,114,222,.514,8,44,.182,106,178,.596,.532,51,74,.689,62,73,135,33,19,40,32,92,287,15
Rodney Hood,SG,23,UTA,79,79,2541,408,972,.420,161,449,.359,247,523,.472,.503,172,200,.860,38,229,267,213,73,16,125,202,1149,15
Al Horford,C,29,ATL,82,82,2631,529,1048,.505,88,256,.344,441,792,.557,.547,103,129,.798,148,448,596,263,68,121,107,163,1249,15
Dwight Howard,C,30,HOU,71,71,2280,372,600,.620,0,6,0,372,594,.626,.620,232,474,.489,238,597,835,98,69,113,166,219,976,15
Marcelo Huertas,PG,32,LAL,53,0,869,97,230,.422,16,61,.262,81,169,.479,.457,27,29,.931,18,72,90,182,26,7,80,76,237,15
Josh Huestis,PF,24,OKC,5,0,55,5,12,.417,4,6,.667,1,6,.167,.583,0,4,0,2,8,10,0,1,2,3,3,14,15
Kris Humphries,PF,30,TOT,53,17,835,121,295,.410,34,108,.315,87,187,.465,.468,67,84,.798,57,161,218,36,16,23,38,94,343,15
R.J. Hunter,SG,22,BOS,36,0,315,36,98,.367,19,63,.302,17,35,.486,.464,6,7,.857,2,35,37,13,14,4,11,29,97,15
Serge Ibaka,PF,26,OKC,78,78,2500,416,869,.479,60,184,.326,356,685,.520,.513,91,121,.752,141,392,533,66,38,148,108,211,983,15
Andre Iguodala,SF,32,GSW,65,1,1732,176,368,.478,54,154,.351,122,214,.570,.552,51,83,.614,52,211,263,219,73,19,79,102,457,15
Ersan İlyasova,PF,28,TOT,74,56,1881,280,661,.424,96,259,.371,184,402,.458,.496,111,154,.721,144,259,403,67,52,33,71,171,767,15
Joe Ingles,SF,28,UTA,81,2,1241,124,291,.426,81,210,.386,43,81,.531,.565,13,18,.722,19,132,151,96,55,4,65,98,342,15
Damien Inglis,SF,20,MIL,20,1,156,13,37,.351,3,13,.231,10,24,.417,.392,7,8,.875,2,29,31,10,6,3,11,11,36,15
Kyrie Irving,PG,23,CLE,53,53,1667,394,879,.448,84,262,.321,310,617,.502,.496,169,191,.885,44,113,157,249,56,18,124,107,1041,15
Jarrett Jack,PG,32,BRK,32,32,1027,140,358,.391,31,102,.304,109,256,.426,.434,100,112,.893,9,127,136,236,34,7,94,77,411,15
Reggie Jackson,PG,25,DET,79,79,2424,540,1244,.434,118,334,.353,422,910,.464,.482,291,337,.864,58,195,253,492,59,11,223,187,1489,15
LeBron James,SF,31,CLE,76,76,2709,737,1416,.520,87,282,.309,650,1134,.573,.551,359,491,.731,111,454,565,514,104,49,249,143,1920,15
Al Jefferson,C,31,CHO,47,18,1096,245,505,.485,0,0,0,245,505,.485,.485,72,111,.649,57,244,301,70,30,41,34,117,562,15
Cory Jefferson,PF,25,PHO,8,0,50,9,22,.409,0,1,0,9,21,.429,.409,4,6,.667,6,10,16,0,0,1,0,8,22,15
Richard Jefferson,SF,35,CLE,74,5,1326,143,312,.458,66,173,.382,77,139,.554,.564,58,87,.667,15,113,128,59,33,14,43,129,410,15
John Jenkins,SG,24,TOT,43,3,480,71,160,.444,16,51,.314,55,109,.505,.494,20,24,.833,8,49,57,35,8,1,27,22,178,15
Brandon Jennings,PG,26,TOT,48,7,868,112,304,.368,51,155,.329,61,149,.409,.452,57,78,.731,16,80,96,170,29,7,57,57,332,15
Jonas Jerebko,PF,28,BOS,78,0,1176,118,286,.413,43,108,.398,75,178,.421,.488,61,78,.782,77,211,288,62,20,24,52,137,340,15
Amir Johnson,PF,28,BOS,79,76,1800,249,426,.585,10,43,.233,239,383,.624,.596,69,121,.570,178,327,505,138,52,83,94,214,577,15
Chris Johnson,SF,25,UTA,70,2,857,72,194,.371,27,99,.273,45,95,.474,.441,34,42,.810,27,105,132,45,32,20,40,100,205,15
James Johnson,PF,28,TOR,57,32,926,114,240,.475,20,66,.303,94,174,.540,.517,39,68,.574,28,98,126,67,29,33,54,84,287,15
Joe Johnson,SF,34,TOT,81,81,2703,377,859,.439,120,313,.383,257,546,.471,.509,118,142,.831,49,243,292,318,61,4,159,146,992,15
Orlando Johnson,SG,26,TOT,7,1,101,9,34,.265,2,10,.200,7,24,.292,.294,6,8,.750,4,11,15,2,3,3,4,9,26,15
Stanley Johnson,SF,19,DET,73,6,1687,225,600,.375,63,205,.307,162,395,.410,.428,80,102,.784,58,248,306,118,55,12,114,178,593,15
Tyler Johnson,SG,23,MIA,36,5,863,118,243,.486,27,71,.380,91,172,.529,.541,51,64,.797,28,81,109,79,24,14,47,66,314,15
Wesley Johnson,SF,28,LAC,80,9,1666,208,515,.404,103,309,.333,105,206,.510,.504,30,46,.652,37,211,248,49,89,56,54,173,549,15
Nikola Jokić,C,20,DEN,80,55,1733,307,600,.512,28,84,.333,279,516,.541,.535,154,190,.811,181,379,560,189,79,50,104,208,796,15
Dahntay Jones,SF,35,CLE,1,0,42,6,14,.429,1,2,.500,5,12,.417,.464,0,0,0,1,4,5,2,1,2,0,6,13,15
James Jones,SF,35,CLE,48,0,463,58,142,.408,41,104,.394,17,38,.447,.553,21,26,.808,8,42,50,14,11,10,13,50,178,15
Terrence Jones,PF,24,HOU,50,11,1044,166,367,.452,25,79,.316,141,288,.490,.486,77,116,.664,62,149,211,41,23,39,49,86,434,15
Tyus Jones,PG,19,MIN,37,0,573,56,156,.359,16,53,.302,40,103,.388,.410,28,39,.718,7,40,47,108,31,3,33,33,156,15
DeAndre Jordan,C,27,LAC,77,77,2598,357,508,.703,0,1,0,357,507,.704,.703,266,619,.430,267,792,1059,90,51,177,107,207,980,15
Cory Joseph,SG,24,TOR,80,4,2046,257,585,.439,30,110,.273,227,475,.478,.465,133,174,.764,39,171,210,250,63,20,102,131,677,15
Chris Kaman,C,33,POR,16,2,112,20,43,.465,1,4,.250,19,39,.487,.477,3,3,1.000,7,17,24,11,1,1,8,15,44,15
Frank Kaminsky,C,22,CHO,81,3,1708,215,525,.410,68,202,.337,147,323,.455,.474,108,148,.730,69,266,335,98,38,43,58,126,606,15
Sergey Karasev,SF,22,BRK,40,5,399,30,74,.405,11,37,.297,19,37,.514,.480,26,28,.929,8,50,58,35,6,2,22,27,97,15
Sasha Kaun,C,30,CLE,25,0,95,9,17,.529,0,0,0,9,17,.529,.529,5,11,.455,12,14,26,3,4,5,7,11,23,15
Ryan Kelly,PF,24,LAL,36,0,470,55,149,.369,5,37,.135,50,112,.446,.386,37,54,.685,21,100,121,20,13,10,18,39,152,15
Michael Kidd-Gilchrist,SF,22,CHO,7,7,205,33,61,.541,3,7,.429,30,54,.556,.566,20,29,.690,12,33,45,9,3,3,8,9,89,15
Sean Kilpatrick,SG,26,TOT,31,0,616,123,270,.456,39,114,.342,84,156,.538,.528,60,67,.896,12,44,56,29,12,2,31,37,345,15
Brandon Knight,SG,24,PHO,52,50,1870,371,895,.415,120,351,.342,251,544,.461,.482,156,183,.852,36,166,202,263,61,20,177,124,1018,15
Kyle Korver,SG,34,ATL,80,80,2401,268,616,.435,158,397,.398,110,219,.502,.563,45,54,.833,14,246,260,164,60,35,98,161,739,15
Kosta Koufos,C,26,SAC,78,14,1482,236,444,.532,0,0,0,236,444,.532,.532,57,104,.548,169,254,423,33,40,70,48,185,529,15
Jeremy Lamb,SG,23,CHO,66,0,1227,230,510,.451,56,181,.309,174,329,.529,.506,64,88,.727,44,208,252,77,42,30,50,105,580,15
Carl Landry,PF,32,PHI,36,12,569,139,250,.556,6,13,.462,133,237,.561,.568,67,91,.736,49,97,146,32,12,9,22,69,351,15
Shane Larkin,PG,23,BRK,78,17,1751,222,502,.442,39,108,.361,183,394,.464,.481,83,107,.776,28,152,180,342,95,12,146,121,566,15
Joffrey Lauvergne,C,24,DEN,59,15,1041,195,380,.513,13,53,.245,182,327,.557,.530,62,69,.899,77,213,290,56,13,15,54,115,465,15
Zach LaVine,SG,20,MIN,82,33,2294,433,959,.452,123,316,.389,310,643,.482,.516,161,203,.793,27,201,228,251,69,17,155,193,1150,15
Ty Lawson,PG,28,TOT,66,13,1411,139,354,.393,36,108,.333,103,246,.419,.444,59,86,.686,26,94,120,237,53,7,95,87,373,15
Courtney Lee,SG,30,TOT,79,65,2334,290,639,.454,82,217,.378,208,422,.493,.518,99,118,.839,29,176,205,136,85,28,72,134,761,15
David Lee,PF,32,TOT,55,5,903,178,335,.531,0,1,0,178,334,.533,.531,71,93,.763,101,204,305,84,22,28,66,114,427,15
Alex Len,C,22,PHO,78,46,1821,264,624,.423,1,7,.143,263,617,.426,.424,174,239,.728,178,416,594,97,38,62,145,230,703,15
Kawhi Leonard,SF,24,SAS,72,72,2380,551,1090,.506,129,291,.443,422,799,.528,.565,292,334,.874,95,398,493,186,128,71,105,133,1523,15
Meyers Leonard,PF,23,POR,61,10,1333,195,435,.448,86,228,.377,109,207,.527,.547,35,46,.761,51,263,314,92,8,18,77,183,511,15
Jon Leuer,PF,26,PHO,67,27,1255,224,466,.481,42,110,.382,182,356,.511,.526,77,101,.762,76,297,373,72,38,30,75,125,567,15
Damian Lillard,PG,25,POR,75,75,2676,618,1474,.419,229,610,.375,389,864,.450,.497,414,464,.892,45,257,302,512,65,28,242,165,1879,15
Jeremy Lin,SG,27,CHO,78,13,2048,300,728,.412,76,226,.336,224,502,.446,.464,238,292,.815,42,211,253,235,58,42,150,165,914,15
Shaun Livingston,PG,30,GSW,78,3,1520,203,379,.536,2,12,.167,201,367,.548,.538,80,93,.860,42,127,169,237,57,27,78,140,488,15
Kevon Looney,PF,19,GSW,5,0,21,4,7,.571,1,2,.500,3,5,.600,.643,0,0,0,4,6,10,0,0,0,1,2,9,15
Brook Lopez,C,27,BRK,73,73,2457,591,1157,.511,2,14,.143,589,1143,.515,.512,317,403,.787,204,369,573,147,58,124,175,215,1501,15
Robin Lopez,C,27,NYK,82,82,2219,357,662,.539,0,1,0,357,661,.540,.539,128,161,.795,268,334,602,114,16,129,133,182,842,15
Kevin Love,PF,27,CLE,77,77,2424,409,977,.419,158,439,.360,251,538,.467,.499,258,314,.822,149,613,762,186,58,41,142,159,1234,15
Kyle Lowry,PG,29,TOR,77,77,2851,512,1198,.427,212,547,.388,300,651,.461,.516,398,491,.811,55,310,365,494,158,34,225,211,1634,15
Trey Lyles,PF,20,UTA,80,33,1382,191,436,.438,49,128,.383,142,308,.461,.494,57,82,.695,59,240,299,59,26,18,65,114,488,15
Shelvin Mack,PG,25,TOT,52,27,1058,182,415,.439,39,125,.312,143,290,.493,.486,45,61,.738,13,115,128,187,34,3,95,72,448,15
Ian Mahinmi,C,29,IND,71,71,1816,264,448,.589,0,0,0,264,448,.589,.589,132,225,.587,138,369,507,104,65,75,100,220,660,15
Devyn Marble,SG,23,ORL,28,0,249,21,71,.296,8,32,.250,13,39,.333,.352,10,24,.417,6,32,38,12,13,1,7,25,60,15
Boban Marjanović,C,27,SAS,54,4,508,105,174,.603,0,0,0,105,174,.603,.603,87,114,.763,73,121,194,21,12,23,29,54,297,15
Kendall Marshall,PG,24,PHI,30,6,400,43,118,.364,16,49,.327,27,69,.391,.432,9,13,.692,2,26,28,73,16,2,43,30,111,15
Jarell Martin,PF,21,MEM,27,0,380,54,116,.466,0,2,0,54,114,.474,.466,45,62,.726,39,47,86,15,8,7,19,58,153,15
Kevin Martin,SG,32,TOT,55,13,1095,156,419,.372,49,136,.360,107,283,.378,.431,153,172,.890,14,96,110,58,26,3,54,83,514,15
Wesley Matthews,SF,29,DAL,78,78,2644,331,854,.388,189,525,.360,142,329,.432,.498,126,146,.863,27,211,238,151,78,17,78,179,977,15
O.J. Mayo,SG,28,MIL,41,24,1090,119,321,.371,52,162,.321,67,159,.421,.452,31,40,.775,13,92,105,118,48,8,72,126,321,15
Luc Mbah a Moute,PF,29,LAC,75,61,1274,94,207,.454,13,40,.325,81,167,.485,.486,30,57,.526,60,111,171,30,44,19,34,100,231,15
James Michael McAdoo,PF,23,GSW,41,1,262,45,84,.536,1,2,.500,44,82,.537,.542,26,49,.531,30,28,58,17,10,8,16,39,117,15
Ray McCallum,PG,24,TOT,41,6,475,55,146,.377,15,42,.357,40,104,.385,.428,12,15,.800,8,39,47,60,12,7,24,29,137,15
CJ McCollum,SG,24,POR,80,80,2780,641,1431,.448,197,472,.417,444,959,.463,.517,187,226,.827,47,212,259,341,97,23,196,187,1666,15
T.J. McConnell,PG,23,PHI,81,17,1606,218,464,.470,31,89,.348,187,375,.499,.503,26,41,.634,43,207,250,367,95,10,140,114,493,15
Chris McCullough,PF,20,BRK,24,4,362,44,109,.404,13,34,.382,31,75,.413,.463,11,23,.478,25,43,68,9,28,12,15,39,112,15
K.J. McDaniels,SF,22,HOU,37,1,235,29,72,.403,7,25,.280,22,47,.468,.451,24,30,.800,16,26,42,10,7,6,17,30,89,15
Doug McDermott,SF,24,CHI,81,4,1861,291,644,.452,110,259,.425,181,385,.470,.537,72,84,.857,37,158,195,59,14,6,53,127,764,15
Mitch McGary,PF,23,OKC,20,0,72,11,23,.478,0,4,0,11,19,.579,.478,4,10,.400,4,14,18,3,1,2,7,10,26,15
JaVale McGee,C,28,DAL,34,2,370,77,134,.575,0,1,0,77,133,.579,.575,18,36,.500,53,80,133,3,5,26,21,49,172,15
Ben McLemore,SG,22,SAC,68,53,1443,195,455,.429,67,185,.362,128,270,.474,.502,74,103,.718,34,114,148,79,52,10,99,140,531,15
Jordan McRae,PG,24,TOT,22,1,195,34,78,.436,10,22,.455,24,56,.429,.500,21,28,.750,4,16,20,25,3,1,15,17,99,15
Josh McRoberts,PF,28,MIA,42,1,595,55,148,.372,12,49,.245,43,99,.434,.412,28,40,.700,22,83,105,81,18,7,30,68,150,15
Jodie Meeks,SG,28,DET,3,0,43,7,20,.350,4,9,.444,3,11,.273,.450,4,4,1.000,1,4,5,3,0,0,1,2,22,15
Salah Mejri,C,29,DAL,34,6,397,49,78,.628,0,1,0,49,77,.636,.628,27,46,.587,41,82,123,10,8,36,23,54,125,15
Jordan Mickey,PF,21,BOS,16,0,57,8,22,.364,0,0,0,8,22,.364,.364,5,10,.500,6,7,13,1,0,11,1,5,21,15
Khris Middleton,SG,24,MIL,79,79,2852,507,1142,.444,143,361,.396,364,781,.466,.507,277,312,.888,44,258,302,331,131,19,180,204,1434,15
C.J. Miles,SF,28,IND,64,24,1464,259,634,.409,142,387,.367,117,247,.474,.521,93,124,.750,25,150,175,63,53,29,70,142,753,15
Andre Miller,PG,39,TOT,39,4,461,59,106,.557,2,8,.250,57,98,.582,.566,24,32,.750,12,39,51,87,16,0,37,46,144,15
Mike Miller,SF,35,DEN,47,2,373,22,62,.355,19,52,.365,3,10,.300,.508,0,0,0,6,47,53,40,13,4,17,53,63,15
Patty Mills,PG,27,SAS,81,3,1662,260,612,.425,123,320,.384,137,292,.469,.525,47,58,.810,27,131,158,226,59,6,76,102,690,15
Elijah Millsap,SG,28,UTA,20,0,173,11,39,.282,1,12,.083,10,27,.370,.295,13,18,.722,6,29,35,19,7,3,9,33,36,15
Paul Millsap,PF,30,ATL,81,81,2647,501,1066,.470,74,232,.319,427,834,.512,.505,309,408,.757,198,534,732,265,147,139,191,237,1385,15
Nikola Mirotić,PF,24,CHI,66,38,1646,248,609,.407,135,346,.390,113,263,.430,.518,146,181,.807,58,304,362,100,58,46,102,151,777,15
Nazr Mohammed,C,38,OKC,5,0,19,3,5,.600,0,0,0,3,5,.600,.600,2,2,1.000,1,3,4,0,0,0,3,4,8,15
Greg Monroe,C,25,MIL,79,67,2314,491,941,.522,0,1,0,491,940,.522,.522,228,308,.740,218,478,696,178,72,67,129,163,1210,15
Luis Montero,SG,22,POR,12,0,42,5,19,.263,1,9,.111,4,10,.400,.289,3,4,.750,0,4,4,1,0,0,4,1,14,15
E'Twaun Moore,SG,26,CHI,59,22,1263,187,389,.481,47,104,.452,140,285,.491,.541,22,35,.629,19,114,133,99,37,18,53,103,443,15
Eric Moreland,PF,24,SAC,8,0,48,3,6,.500,0,0,0,3,6,.500,.500,2,4,.500,3,8,11,1,0,4,3,4,8,15
Marcus Morris,SF,26,DET,80,80,2856,410,945,.434,108,298,.362,302,647,.467,.491,203,271,.749,91,313,404,201,67,23,140,170,1131,15
Markieff Morris,PF,26,TOT,64,45,1629,305,718,.425,47,155,.303,258,563,.458,.458,108,147,.735,73,279,352,124,58,34,135,184,765,15
Anthony Morrow,SG,30,OKC,68,6,926,136,333,.408,79,204,.387,57,129,.442,.527,29,39,.744,10,52,62,24,22,5,17,64,380,15
Donatas Motiejūnas,PF,25,HOU,37,22,547,90,205,.439,16,57,.281,74,148,.500,.478,34,53,.642,37,72,109,41,17,5,44,69,230,15
Timofey Mozgov,C,29,CLE,76,48,1326,203,359,.565,1,7,.143,202,352,.574,.567,68,95,.716,110,227,337,33,22,57,71,159,475,15
Emmanuel Mudiay,PG,19,DEN,68,66,2068,329,905,.364,74,232,.319,255,673,.379,.404,140,209,.670,32,200,232,372,65,35,217,141,872,15
Shabazz Muhammad,SF,23,MIN,82,0,1682,317,681,.465,44,152,.289,273,529,.516,.498,185,242,.764,100,167,267,52,24,7,70,94,863,15
Xavier Munford,SG,23,MEM,14,0,244,32,77,.416,9,23,.391,23,54,.426,.474,7,14,.500,3,28,31,22,13,3,15,25,80,15
Mike Muscala,C,24,ATL,60,0,565,76,152,.500,12,39,.308,64,113,.566,.539,31,39,.795,38,79,117,34,13,27,27,72,195,15
Larry Nance Jr.,PF,23,LAL,63,22,1266,158,300,.527,1,10,.100,157,290,.541,.528,32,47,.681,101,211,312,44,54,23,41,124,349,15
Shabazz Napier,PG,24,ORL,55,0,600,68,201,.338,34,104,.327,34,97,.351,.423,33,45,.733,9,46,55,97,23,1,46,38,203,15
Gary Neal,SG,31,WAS,40,2,807,151,325,.465,41,100,.410,110,225,.489,.528,47,55,.855,11,72,83,47,20,1,29,55,390,15
Jameer Nelson,PG,33,DEN,39,15,1036,113,307,.368,43,144,.299,70,163,.429,.438,30,35,.857,19,96,115,190,25,5,66,100,299,15
Raul Neto,PG,23,UTA,81,53,1499,180,418,.431,64,162,.395,116,256,.453,.507,52,70,.743,17,103,120,174,62,2,109,122,476,15
Andrew Nicholson,PF,26,ORL,56,0,823,146,310,.471,41,114,.360,105,196,.536,.537,51,65,.785,34,167,201,25,10,22,41,69,384,15
Joakim Noah,C,30,CHI,29,2,635,51,133,.383,0,1,0,51,132,.386,.383,22,45,.489,87,168,255,110,18,29,52,77,124,15
Nerlens Noel,C,21,PHI,67,62,1965,306,587,.521,1,2,.500,305,585,.521,.522,134,227,.590,154,388,542,122,118,100,158,192,747,15
Lucas Nogueira,C,23,TOR,29,1,225,28,44,.636,1,3,.333,27,41,.659,.648,8,15,.533,18,28,46,7,12,12,11,29,65,15
Steve Novak,PF,32,TOT,10,0,44,8,18,.444,7,15,.467,1,3,.333,.639,1,1,1.000,0,5,5,0,0,0,1,3,24,15
Dirk Nowitzki,PF,37,DAL,75,75,2364,498,1112,.448,126,342,.368,372,770,.483,.504,250,280,.893,52,437,489,132,52,52,84,161,1372,15
Jusuf Nurkić,C,21,DEN,32,3,547,101,242,.417,0,3,0,101,239,.423,.417,61,99,.616,65,110,175,40,24,44,55,91,263,15
J.J. O'Brien,SF,23,UTA,2,0,6,0,1,0,0,0,0,0,1,0,0,0,0,0,0,1,1,0,1,0,0,1,0,15
Johnny O'Bryant,PF,22,MIL,66,4,857,86,209,.411,1,1,1.000,85,208,.409,.414,27,40,.675,65,111,176,32,18,8,31,100,200,15
Kyle O'Quinn,PF,25,NYK,65,1,764,129,271,.476,5,22,.227,124,249,.498,.485,46,60,.767,76,174,250,72,20,49,61,107,309,15
Jahlil Okafor,C,20,PHI,53,48,1591,397,781,.508,1,6,.167,396,775,.511,.509,133,194,.686,122,251,373,65,22,61,124,140,928,15
Victor Oladipo,SG,23,ORL,72,52,2379,425,970,.438,98,282,.348,327,688,.475,.489,205,247,.830,48,297,345,282,116,54,153,174,1153,15
Kelly Olynyk,C,24,BOS,69,8,1395,253,556,.455,85,210,.405,168,346,.486,.531,96,128,.750,72,209,281,105,52,33,74,163,687,15
Kelly Oubre Jr.,SF,20,WAS,63,9,671,90,211,.427,25,79,.316,65,132,.492,.486,31,49,.633,25,108,133,13,22,7,34,100,236,15
Zaza Pachulia,C,31,DAL,76,69,2004,219,470,.466,0,3,0,219,467,.469,.466,212,276,.768,249,469,718,128,64,22,119,181,650,15
Kostas Papanikolaou,SF,25,DEN,26,6,294,24,66,.364,10,32,.313,14,34,.412,.439,9,14,.643,8,32,40,16,13,5,21,24,67,15
Jabari Parker,PF,20,MIL,76,72,2408,443,899,.493,9,35,.257,434,864,.502,.498,175,228,.768,123,272,395,130,69,29,116,154,1070,15
Tony Parker,PG,33,SAS,72,72,1980,350,710,.493,27,65,.415,323,645,.501,.512,130,171,.760,17,159,176,379,54,11,131,114,857,15
Chandler Parsons,SF,27,DAL,61,51,1799,320,651,.492,104,251,.414,216,400,.540,.571,93,136,.684,29,256,285,169,46,21,95,114,837,15
Lamar Patterson,SG,24,ATL,35,0,395,28,80,.350,12,49,.245,16,31,.516,.425,16,22,.727,4,46,50,39,9,2,23,45,84,15
Patrick Patterson,PF,26,TOR,79,0,2020,204,493,.414,106,293,.362,98,200,.490,.521,29,34,.853,77,265,342,94,53,32,65,128,543,15
Chris Paul,PG,30,LAC,74,74,2420,515,1114,.462,122,329,.371,393,785,.501,.517,294,328,.896,39,271,310,738,152,13,194,185,1446,15
Adreian Payne,PF,24,MIN,52,2,486,53,145,.366,9,32,.281,44,113,.389,.397,17,26,.654,20,91,111,29,16,11,36,77,132,15
Cameron Payne,PG,21,OKC,57,1,698,114,278,.410,36,111,.324,78,167,.467,.475,19,24,.792,9,76,85,108,36,6,44,80,283,15
Elfrid Payton,PG,21,ORL,73,69,2145,318,730,.436,30,92,.326,288,638,.451,.456,112,190,.589,77,184,261,468,89,20,177,159,778,15
Nikola Peković,C,30,MIN,12,3,156,19,50,.380,0,0,0,19,50,.380,.380,16,20,.800,7,14,21,11,1,0,9,22,54,15
Kendrick Perkins,C,31,NOP,37,5,542,40,75,.533,0,0,0,40,75,.533,.533,11,25,.440,25,103,128,31,11,11,41,64,91,15
Paul Pierce,SF,38,LAC,68,38,1231,144,397,.363,75,242,.310,69,155,.445,.457,54,66,.818,12,174,186,71,33,17,58,129,417,15
Tibor Pleiß,C,26,UTA,12,0,82,11,25,.440,0,2,0,11,23,.478,.440,2,2,1.000,6,9,15,2,1,2,8,19,24,15
Mason Plumlee,C,25,POR,82,82,2084,267,517,.516,0,4,0,267,513,.520,.516,215,335,.642,201,427,628,226,68,85,154,253,749,15
Miles Plumlee,C,27,MIL,61,14,870,140,233,.601,0,0,0,140,233,.601,.601,34,59,.576,94,138,232,16,21,50,40,73,314,15
Otto Porter Jr.,SF,22,WAS,75,73,2276,339,717,.473,98,267,.367,241,450,.536,.541,95,126,.754,97,294,391,120,105,32,70,163,871,15
Bobby Portis,PF,20,CHI,62,4,1102,186,436,.427,16,52,.308,170,384,.443,.445,48,66,.727,123,214,337,52,25,22,54,100,436,15
Kristaps Porziņģis,PF,20,NYK,72,72,2047,373,886,.421,81,243,.333,292,643,.454,.467,201,240,.838,132,394,526,94,53,134,121,205,1028,15
Dwight Powell,PF,24,DAL,69,2,992,146,296,.493,2,16,.125,144,280,.514,.497,105,142,.739,84,189,273,44,36,24,40,118,399,15
Norman Powell,SG,22,TOR,49,24,725,97,229,.424,36,89,.404,61,140,.436,.502,43,53,.811,16,95,111,47,29,10,32,59,273,15
Phil Pressey,PG,24,TOT,23,0,283,30,78,.385,4,18,.222,26,60,.433,.410,13,25,.520,3,28,31,75,18,4,33,28,77,15
Ronnie Price,PG,32,PHO,62,18,1211,116,302,.384,68,196,.347,48,106,.453,.497,31,41,.756,25,74,99,147,74,13,70,161,331,15
Pablo Prigioni,PG,38,LAC,59,3,823,55,147,.374,28,95,.295,27,52,.519,.469,7,8,.875,38,76,114,130,53,1,49,82,145,15
Tayshaun Prince,SF,35,MIN,77,44,1462,102,229,.445,4,23,.174,98,206,.476,.454,13,19,.684,32,115,147,73,36,13,27,62,221,15
Julius Randle,PF,21,LAL,81,60,2286,358,835,.429,10,36,.278,348,799,.436,.435,193,270,.715,172,657,829,144,53,29,149,242,919,15
Zach Randolph,PF,34,MEM,68,53,2016,431,907,.475,6,26,.231,425,881,.482,.479,172,216,.796,179,350,529,142,43,13,105,146,1040,15
J.J. Redick,SG,31,LAC,75,75,2097,422,880,.480,200,421,.475,222,459,.484,.593,182,205,.888,10,129,139,106,42,5,78,135,1226,15
Willie Reed,C,25,BRK,39,2,426,76,133,.571,0,0,0,76,133,.571,.571,30,55,.545,49,73,122,10,6,30,16,47,182,15
Josh Richardson,SG,22,MIA,52,2,1107,123,272,.452,53,115,.461,70,157,.446,.550,42,63,.667,21,86,107,73,36,25,35,107,341,15
Austin Rivers,SG,23,LAC,67,7,1464,226,516,.438,62,185,.335,164,331,.495,.498,79,116,.681,22,108,130,99,48,9,61,137,593,15
Andre Roberson,SG,24,OKC,70,70,1553,136,274,.496,32,103,.311,104,171,.608,.555,33,54,.611,79,172,251,47,53,42,35,133,337,15
Brian Roberts,PG,30,TOT,51,0,470,74,165,.448,15,42,.357,59,123,.480,.494,42,47,.894,6,35,41,54,10,2,23,35,205,15
Glenn Robinson III,SF,22,IND,45,4,508,65,151,.430,14,37,.378,51,114,.447,.477,27,39,.692,12,56,68,26,17,9,18,21,171,15
Nate Robinson,PG,31,NOP,2,1,23,0,1,0,0,1,0,0,0,0,0,0,0,0,0,0,0,4,1,0,0,5,0,15
Thomas Robinson,PF,24,BRK,71,7,917,130,291,.447,0,1,0,130,290,.448,.447,47,109,.431,136,223,359,46,39,36,69,111,307,15
Rajon Rondo,PG,29,SAC,72,72,2537,355,782,.454,62,170,.365,293,612,.479,.494,87,150,.580,77,358,435,839,141,10,278,175,859,15
Derrick Rose,PG,27,CHI,66,66,2097,447,1048,.427,44,150,.293,403,898,.449,.448,142,179,.793,46,179,225,311,44,14,175,84,1080,15
Terrence Ross,SF,24,TOR,73,7,1747,270,626,.431,131,339,.386,139,287,.484,.536,49,62,.790,21,164,185,56,54,25,46,120,720,15
Terry Rozier,PG,21,BOS,39,0,311,29,106,.274,6,27,.222,23,79,.291,.302,8,10,.800,24,39,63,37,6,1,19,23,72,15
Ricky Rubio,PG,25,MIN,76,76,2323,219,586,.374,62,190,.326,157,396,.396,.427,266,314,.847,40,286,326,658,162,10,193,201,766,15
Damjan Rudež,SF,29,MIN,33,0,277,25,62,.403,17,50,.340,8,12,.667,.540,8,8,1.000,5,15,20,11,3,1,13,33,75,15
Brandon Rush,SG,30,GSW,72,25,1055,111,260,.427,65,157,.414,46,103,.447,.552,18,28,.643,21,160,181,57,20,23,33,57,305,15
D'Angelo Russell,PG,19,LAL,80,48,2259,392,956,.410,130,370,.351,262,586,.447,.478,140,190,.737,47,227,274,266,93,13,196,142,1054,15
Robert Sacre,C,26,LAL,25,1,320,31,75,.413,0,0,0,31,75,.413,.413,25,38,.658,32,40,72,14,4,10,12,43,87,15
JaKarr Sampson,SF,22,TOT,73,40,1160,140,317,.442,14,63,.222,126,254,.496,.464,80,122,.656,46,144,190,46,23,33,70,142,374,15
Dennis Schröder,PG,22,ATL,80,6,1621,329,781,.421,77,239,.322,252,542,.465,.471,144,182,.791,25,179,204,349,70,9,183,138,879,15
Luis Scola,PF,35,TOR,76,76,1636,269,598,.450,65,161,.404,204,437,.467,.504,61,84,.726,84,276,360,66,46,27,68,178,664,15
Mike Scott,PF,27,ATL,75,0,1146,176,376,.468,62,158,.392,114,218,.523,.551,50,63,.794,53,153,206,78,25,17,42,102,464,15
Thabo Sefolosha,SF,31,ATL,75,11,1758,188,372,.505,42,124,.339,146,248,.589,.562,62,99,.626,52,282,334,107,85,37,68,109,480,15
Kevin Séraphin,C,26,NYK,48,0,526,84,205,.410,0,2,0,84,203,.414,.410,19,23,.826,31,95,126,47,8,36,43,67,187,15
Ramon Sessions,PG,29,WAS,82,5,1667,280,592,.473,36,111,.324,244,481,.507,.503,214,283,.756,25,178,203,239,46,5,115,102,810,15
Iman Shumpert,SG,25,CLE,54,5,1316,114,305,.374,43,146,.295,71,159,.447,.444,40,51,.784,32,171,203,92,54,19,57,119,311,15
Jonathon Simmons,SG,26,SAS,55,2,813,122,242,.504,18,47,.383,104,195,.533,.541,69,92,.750,16,80,96,58,24,5,53,103,331,15
Henry Sims,C,25,BRK,14,4,263,33,77,.429,0,0,0,33,77,.429,.429,25,30,.833,21,51,72,9,9,14,12,37,91,15
Kyle Singler,SF,27,OKC,68,2,977,86,221,.389,30,97,.309,56,124,.452,.457,29,44,.659,50,91,141,24,30,9,32,120,231,15
Donald Sloan,PG,28,BRK,61,33,1318,154,350,.440,38,99,.384,116,251,.462,.494,78,104,.750,17,156,173,268,32,4,80,73,424,15
Marcus Smart,PG,21,BOS,61,10,1667,184,529,.348,61,241,.253,123,288,.427,.405,129,166,.777,76,179,255,185,91,18,80,183,558,15
Greg Smith,PF,25,MIN,18,0,192,18,32,.563,0,0,0,18,32,.563,.563,7,17,.412,12,30,42,6,4,1,7,28,43,15
Ish Smith,PG,27,TOT,77,53,2239,397,967,.411,56,170,.329,341,797,.428,.440,122,176,.693,43,262,305,502,88,24,175,133,972,15
J.R. Smith,SG,30,CLE,77,77,2362,353,850,.415,204,510,.400,149,340,.438,.535,45,71,.634,43,174,217,130,81,21,59,204,955,15
Jason Smith,C,29,ORL,76,2,1181,244,503,.485,4,16,.250,240,487,.493,.489,54,67,.806,53,166,219,62,33,65,57,163,546,15
Josh Smith,PF,30,TOT,55,7,880,127,349,.364,41,143,.287,86,206,.417,.423,37,67,.552,51,141,192,90,34,47,77,118,332,15
Russ Smith,PG,24,MEM,15,0,66,7,22,.318,1,5,.200,6,17,.353,.341,8,13,.615,1,8,9,11,5,1,7,5,23,15
Tony Snell,SF,24,CHI,64,33,1301,126,339,.372,56,155,.361,70,184,.380,.454,30,33,.909,19,180,199,63,16,17,52,100,338,15
Marreese Speights,C,28,GSW,72,0,832,197,456,.432,24,62,.387,173,394,.439,.458,94,114,.825,77,162,239,61,19,34,66,117,512,15
Tiago Splitter,C,31,ATL,36,2,579,81,155,.523,0,2,0,81,153,.529,.523,39,48,.813,45,75,120,30,20,12,24,71,201,15
Nik Stauskas,SG,22,PHI,73,35,1809,210,545,.385,106,325,.326,104,220,.473,.483,91,118,.771,23,160,183,138,44,20,94,115,617,15
Lance Stephenson,SF,25,TOT,69,13,1372,228,474,.481,30,78,.385,198,396,.500,.513,87,111,.784,40,183,223,133,43,9,94,135,573,15
Alex Stepheson,PF,28,TOT,8,0,73,9,27,.333,0,0,0,9,27,.333,.333,4,12,.333,19,9,28,2,1,5,0,12,22,15
Jarnell Stokes,C,22,TOT,7,0,18,3,5,.600,0,0,0,3,5,.600,.600,1,2,.500,1,3,4,1,1,0,0,1,7,15
Amar'e Stoudemire,C,33,MIA,52,36,762,125,221,.566,0,0,0,125,221,.566,.566,50,67,.746,65,157,222,27,18,41,47,92,300,15
Rodney Stuckey,PG,29,IND,58,1,1275,183,443,.413,20,83,.241,163,360,.453,.436,131,158,.829,19,137,156,142,43,8,76,77,517,15
Jared Sullinger,PF,23,BOS,81,73,1915,351,806,.435,29,103,.282,322,703,.458,.453,103,161,.640,194,479,673,187,75,47,102,209,834,15
Edy Tavares,C,23,ATL,11,0,73,11,19,.579,0,0,0,11,19,.579,.579,3,8,.375,7,14,21,3,1,6,5,8,25,15
Jeff Teague,PG,27,ATL,79,78,2255,434,988,.439,110,275,.400,324,713,.454,.495,261,312,.837,33,181,214,470,97,24,218,167,1239,15
Mirza Teletović,PF,30,PHO,79,1,1686,332,777,.427,181,460,.393,151,317,.476,.544,120,155,.774,55,247,302,89,32,21,84,159,965,15
Garrett Temple,SF,29,WAS,80,43,1951,201,505,.398,89,258,.345,112,247,.453,.486,91,125,.728,36,176,212,140,69,18,64,195,582,15
Jason Terry,SG,38,HOU,72,7,1258,151,376,.402,93,261,.356,58,115,.504,.525,27,33,.818,14,65,79,103,47,9,49,91,422,15
Isaiah Thomas,PG,26,BOS,82,79,2644,591,1382,.428,167,465,.359,424,917,.462,.488,474,544,.871,46,197,243,509,91,9,220,167,1823,15
Lance Thomas,PF,27,NYK,59,5,1313,169,382,.442,44,109,.404,125,273,.458,.500,102,119,.857,34,97,131,53,22,7,57,109,484,15
Hollis Thompson,SG,24,PHI,77,17,2154,270,680,.397,149,392,.380,121,288,.420,.507,69,96,.719,54,218,272,99,36,24,76,187,758,15
Jason Thompson,C,29,TOT,47,7,471,52,108,.481,5,15,.333,47,93,.505,.505,38,54,.704,32,102,134,29,12,20,15,80,147,15
Klay Thompson,SG,25,GSW,80,80,2666,651,1386,.470,276,650,.425,375,736,.510,.569,193,221,.873,35,271,306,166,60,49,138,152,1771,15
Tristan Thompson,PF,24,CLE,82,34,2269,247,420,.588,0,0,0,247,420,.588,.588,149,242,.616,268,470,738,62,38,51,61,202,643,15
Marcus Thornton,SG,28,TOT,61,8,1109,216,542,.399,91,270,.337,125,272,.460,.482,67,79,.848,38,112,150,85,47,4,51,90,590,15
Anthony Tolliver,PF,30,DET,72,5,1341,128,332,.386,98,272,.360,30,60,.500,.533,29,47,.617,39,190,229,52,26,16,28,86,383,15
Axel Toupane,SF,23,DEN,21,0,305,25,70,.357,13,40,.325,12,30,.400,.450,13,17,.765,8,23,31,15,7,6,6,40,76,15
Karl-Anthony Towns,C,20,MIN,82,82,2627,625,1153,.542,30,88,.341,595,1065,.559,.555,223,275,.811,229,629,858,161,58,138,183,245,1503,15
P.J. Tucker,SF,30,PHO,82,80,2540,239,582,.411,68,206,.330,171,376,.455,.469,106,142,.746,165,347,512,177,106,20,111,202,652,15
Evan Turner,SG,27,BOS,81,12,2271,343,753,.456,20,83,.241,323,670,.482,.469,148,179,.827,50,347,397,359,80,28,169,139,854,15
Myles Turner,C,19,IND,60,30,1367,264,530,.498,3,14,.214,261,516,.506,.501,88,121,.727,68,264,332,41,25,86,67,158,619,15
Beno Udrih,PG,33,TOT,44,5,707,86,198,.434,15,44,.341,71,154,.461,.472,18,20,.900,8,64,72,116,14,1,53,51,205,15
Jonas Valančiūnas,C,23,TOR,60,59,1557,303,536,.565,0,0,0,303,536,.565,.565,162,213,.761,184,363,547,42,25,80,85,158,768,15
Anderson Varejão,C,33,TOT,53,0,496,53,124,.427,0,1,0,53,123,.431,.427,32,50,.640,37,104,141,35,16,10,22,70,138,15
Greivis Vásquez,PG,29,MIL,23,0,460,45,138,.326,18,73,.247,27,65,.415,.391,22,26,.846,5,42,47,91,10,0,40,42,130,15
Rashad Vaughn,SG,19,MIL,70,6,1001,81,266,.305,43,147,.293,38,119,.319,.385,12,15,.800,11,77,88,39,29,16,28,73,217,15
Charlie Villanueva,PF,31,DAL,62,4,665,125,327,.382,47,172,.273,78,155,.503,.454,22,24,.917,24,128,152,24,18,15,31,71,319,15
Noah Vonleh,PF,20,POR,78,56,1174,117,278,.421,11,46,.239,106,232,.457,.441,38,51,.745,91,214,305,30,27,26,50,152,283,15
Nikola Vučević,C,25,ORL,65,60,2037,533,1046,.510,2,9,.222,531,1037,.512,.511,113,150,.753,174,402,576,179,53,70,123,173,1181,15
Sasha Vujačić,SG,31,NYK,61,25,908,106,277,.383,52,143,.364,54,134,.403,.477,32,39,.821,26,123,149,84,34,5,44,83,296,15
Dwyane Wade,SG,34,MIA,74,73,2258,540,1183,.456,7,44,.159,533,1139,.468,.459,322,406,.793,82,220,302,344,79,42,203,116,1409,15
Dion Waiters,SG,24,OKC,78,15,2152,282,706,.399,86,240,.358,196,466,.421,.460,112,157,.713,36,166,202,154,81,15,120,143,762,15
Kemba Walker,PG,25,CHO,81,81,2885,568,1331,.427,182,490,.371,386,841,.459,.495,371,438,.847,56,301,357,421,126,39,171,111,1689,15
John Wall,PG,25,WAS,77,77,2784,572,1349,.424,115,328,.351,457,1021,.448,.467,272,344,.791,42,337,379,789,145,59,318,159,1531,15
T.J. Warren,SF,22,PHO,47,4,1070,221,441,.501,28,70,.400,193,371,.520,.533,45,64,.703,57,90,147,44,37,16,32,94,515,15
C.J. Watson,PG,31,ORL,33,2,656,47,137,.343,14,48,.292,33,89,.371,.394,34,39,.872,10,56,66,88,19,5,25,49,142,15
Briante Weber,PG,23,TOT,7,4,169,14,39,.359,0,5,0,14,34,.412,.359,3,4,.750,8,17,25,21,9,3,9,12,31,15
Sonny Weems,SG-SF,29,TOT,43,0,499,42,110,.382,15,41,.366,27,69,.391,.450,8,15,.533,7,46,53,49,10,1,41,47,107,15
David West,PF,35,SAS,78,19,1404,244,448,.545,3,7,.429,241,441,.546,.548,63,80,.788,72,237,309,143,44,55,68,142,554,15
Russell Westbrook,PG,27,OKC,80,80,2750,656,1444,.454,101,341,.296,555,1103,.503,.489,465,573,.812,145,481,626,834,163,20,342,200,1878,15
Hassan Whiteside,C,26,MIA,73,43,2125,413,682,.606,0,0,0,413,682,.606,.606,214,329,.650,238,627,865,30,44,269,137,201,1040,15
Shayne Whittington,PF,24,IND,7,0,41,5,11,.455,0,2,0,5,9,.556,.455,1,2,.500,5,7,12,3,1,1,5,7,11,15
Andrew Wiggins,SF,20,MIN,81,81,2845,594,1294,.459,57,190,.300,537,1104,.486,.481,430,565,.761,105,186,291,164,78,46,182,165,1675,15
C.J. Wilcox,SG,25,LAC,23,0,167,26,66,.394,9,23,.391,17,43,.395,.462,9,12,.750,1,11,12,10,10,2,2,15,70,15
Alan Williams,PF,23,PHO,10,0,68,10,24,.417,0,0,0,10,24,.417,.417,9,14,.643,14,24,38,5,4,5,6,15,29,15
Deron Williams,PG,31,DAL,65,63,2106,321,775,.414,97,282,.344,224,493,.454,.477,179,206,.869,19,171,190,378,61,14,150,155,918,15
Derrick Williams,SF,24,NYK,80,9,1435,254,565,.450,44,150,.293,210,415,.506,.488,194,256,.758,47,249,296,75,29,9,61,69,746,15
Elliot Williams,PG,26,MEM,5,0,45,2,10,.200,1,4,.250,1,6,.167,.250,3,4,.750,1,3,4,4,0,0,1,2,8,15
Lou Williams,SG,29,LAL,67,35,1907,283,693,.408,110,320,.344,173,373,.464,.488,352,424,.830,31,138,169,167,62,19,107,107,1028,15
Marvin Williams,PF,29,CHO,81,81,2338,338,747,.452,152,378,.402,186,369,.504,.554,120,144,.833,127,394,521,110,58,77,62,133,948,15
Mo Williams,PG,33,CLE,41,14,748,132,302,.437,36,102,.353,96,200,.480,.497,38,42,.905,6,66,72,98,14,5,57,60,338,15
Justise Winslow,SF,19,MIA,78,8,2232,195,462,.422,32,116,.276,163,346,.471,.457,80,117,.684,81,322,403,117,68,26,95,184,502,15
Jeff Withey,C,25,UTA,51,10,658,87,162,.537,0,2,0,87,160,.544,.537,43,59,.729,56,117,173,20,21,53,28,75,217,15
Christian Wood,PF,20,PHI,17,0,145,22,53,.415,4,11,.364,18,42,.429,.453,13,21,.619,13,25,38,3,5,7,2,11,61,15
Metta World Peace,SF,36,LAL,35,5,590,55,177,.311,26,84,.310,29,93,.312,.384,40,57,.702,19,70,89,27,22,11,15,67,176,15
Brandan Wright,PF,28,MEM,12,2,212,35,52,.673,0,0,0,35,52,.673,.673,13,24,.542,14,29,43,6,5,15,10,21,83,15
Delon Wright,PG,23,TOR,27,1,229,36,80,.450,5,13,.385,31,67,.463,.481,26,35,.743,8,29,37,31,8,3,16,7,103,15
Tony Wroten,PG,22,PHI,8,3,144,22,65,.338,3,17,.176,19,48,.396,.362,20,37,.541,2,19,21,20,3,0,29,11,67,15
James Young,SG,20,BOS,29,0,199,11,36,.306,6,26,.231,5,10,.500,.389,1,4,.250,4,22,26,9,6,1,5,17,29,15
Joe Young,PG,23,IND,41,0,384,62,169,.367,10,46,.217,52,123,.423,.396,20,25,.800,6,44,50,65,15,0,33,30,154,15
Nick Young,SG,30,LAL,54,2,1033,126,372,.339,77,237,.325,49,135,.363,.442,63,76,.829,14,83,97,34,23,7,30,50,392,15
Thaddeus Young,PF,27,BRK,73,73,2407,495,963,.514,7,30,.233,488,933,.523,.518,105,163,.644,176,484,660,136,112,37,136,182,1102,15
Cody Zeller,C,23,CHO,73,60,1774,231,437,.529,1,10,.100,230,427,.539,.530,175,232,.754,138,317,455,71,57,63,68,204,638,15
Tyler Zeller,C,26,BOS,60,3,710,138,290,.476,0,0,0,138,290,.476,.476,88,108,.815,62,116,178,29,10,22,46,97,364,15
Álex Abrines,SG,23,OKC,68,6,1055,134,341,.393,94,247,.381,40,94,.426,.531,44,49,.898,18,68,86,40,37,8,33,114,406,16
Quincy Acy,PF,26,TOT,38,1,558,70,170,.412,37,90,.411,33,80,.413,.521,45,60,.750,20,95,115,18,14,15,21,67,222,16
Steven Adams,C,23,OKC,80,80,2389,374,655,.571,0,1,0,374,654,.572,.571,157,257,.611,281,332,613,86,89,78,146,195,905,16
Arron Afflalo,SG,31,SAC,61,45,1580,185,420,.440,62,151,.411,123,269,.457,.514,83,93,.892,9,116,125,78,21,6,42,104,515,16
Alexis Ajinça,C,28,NOP,39,15,584,89,178,.500,0,4,0,89,174,.511,.500,29,40,.725,46,131,177,12,20,22,31,77,207,16
Cole Aldrich,C,28,MIN,62,0,531,45,86,.523,0,0,0,45,86,.523,.523,15,22,.682,51,107,158,25,25,23,17,85,105,16
LaMarcus Aldridge,PF,31,SAS,72,72,2335,500,1049,.477,23,56,.411,477,993,.480,.488,220,271,.812,172,351,523,139,46,88,98,158,1243,16
Lavoy Allen,PF,27,IND,61,5,871,77,168,.458,0,1,0,77,167,.461,.458,23,33,.697,105,114,219,57,18,24,29,78,177,16
Tony Allen,SG,35,MEM,71,66,1914,274,595,.461,15,54,.278,259,541,.479,.473,80,130,.615,166,225,391,98,115,29,100,178,643,16
Al-Farouq Aminu,PF,26,POR,61,25,1773,183,466,.393,70,212,.330,113,254,.445,.468,96,136,.706,77,374,451,99,60,44,94,102,532,16
Chris Andersen,C,38,CLE,12,0,114,9,22,.409,0,3,0,9,19,.474,.409,10,14,.714,9,22,31,5,5,7,5,20,28,16
Alan Anderson,SF,34,LAC,30,0,308,30,80,.375,14,44,.318,16,36,.444,.463,12,16,.750,3,21,24,11,3,0,7,35,86,16
Justin Anderson,SF,23,TOT,75,10,1228,186,439,.424,58,194,.299,128,245,.522,.490,102,129,.791,69,176,245,66,41,23,66,109,532,16
Kyle Anderson,SF,23,SAS,72,14,1020,93,209,.445,15,40,.375,78,169,.462,.481,45,57,.789,33,175,208,91,51,26,39,63,246,16
Ryan Anderson,PF,28,HOU,72,72,2116,323,773,.418,204,506,.403,119,267,.446,.550,129,150,.860,112,218,330,68,31,14,55,142,979,16
Giannis Antetokounmpo,SF,22,MIL,80,80,2845,656,1259,.521,49,180,.272,607,1079,.563,.541,471,612,.770,142,558,700,434,131,151,234,246,1832,16
Carmelo Anthony,SF,32,NYK,74,74,2538,602,1389,.433,151,421,.359,451,968,.466,.488,304,365,.833,62,376,438,213,60,34,153,198,1659,16
Joel Anthony,C,34,SAS,19,0,122,10,16,.625,0,0,0,10,16,.625,.625,5,8,.625,8,23,31,3,2,6,4,11,25,16
Trevor Ariza,SF,31,HOU,80,80,2773,326,798,.409,191,555,.344,135,243,.556,.528,93,126,.738,54,404,458,175,147,20,73,133,936,16
Darrell Arthur,PF,28,DEN,41,7,639,95,215,.442,53,117,.453,42,98,.429,.565,19,22,.864,25,87,112,42,19,21,36,76,262,16
Ömer Aşık,C,30,NOP,31,19,482,31,65,.477,0,0,0,31,65,.477,.477,23,39,.590,48,115,163,15,5,10,14,51,85,16
D.J. Augustin,PG,29,ORL,78,20,1538,195,517,.377,95,274,.347,100,243,.412,.469,131,161,.814,15,102,117,209,31,1,90,101,616,16
Luke Babbitt,SF,27,MIA,68,55,1065,113,281,.402,87,210,.414,26,71,.366,.557,11,15,.733,12,129,141,36,20,11,25,118,324,16
Ron Baker,SG,23,NYK,52,13,857,82,217,.378,23,86,.267,59,131,.450,.431,28,43,.651,12,86,98,107,34,8,56,74,215,16
Wade Baldwin,PG,20,MEM,33,1,405,36,115,.313,3,22,.136,33,93,.355,.326,31,37,.838,11,35,46,61,18,7,39,40,106,16
Leandro Barbosa,SG,34,PHO,67,0,963,172,392,.439,35,98,.357,137,294,.466,.483,40,45,.889,15,89,104,81,31,8,48,82,419,16
J.J. Barea,PG,32,DAL,35,6,771,142,343,.414,53,148,.358,89,195,.456,.491,44,51,.863,9,75,84,193,14,1,63,30,381,16
Harrison Barnes,PF,24,DAL,79,79,2803,599,1280,.468,78,222,.351,521,1058,.492,.498,242,281,.861,93,301,394,116,65,15,102,128,1518,16
Matt Barnes,SF,36,TOT,74,18,1777,185,473,.391,87,263,.331,98,210,.467,.483,70,89,.787,70,314,384,195,48,26,107,185,527,16
Will Barton,SG,26,DEN,60,19,1705,295,666,.443,87,235,.370,208,431,.483,.508,143,190,.753,58,201,259,206,48,28,97,110,820,16
Brandon Bass,PF,31,LAC,52,0,577,107,186,.575,1,3,.333,106,183,.579,.578,77,88,.875,43,86,129,21,14,11,29,45,292,16
Nicolas Batum,SG,28,CHO,77,77,2617,393,975,.403,135,405,.333,258,570,.453,.472,243,284,.856,46,435,481,456,86,29,194,109,1164,16
Jerryd Bayless,PG,28,PHI,3,1,71,11,32,.344,2,5,.400,9,27,.333,.375,9,10,.900,3,9,12,13,0,0,9,4,33,16
Aron Baynes,C,30,DET,75,2,1163,143,279,.513,0,0,0,143,279,.513,.513,79,94,.840,111,222,333,32,17,39,50,166,365,16
Kent Bazemore,SF,27,ATL,73,64,1963,295,721,.409,92,266,.346,203,455,.446,.473,119,168,.708,45,186,231,177,91,52,125,165,801,16
Bradley Beal,SG,23,WAS,77,77,2684,637,1322,.482,223,552,.404,414,770,.538,.566,282,342,.825,53,187,240,267,83,21,156,169,1779,16
Malik Beasley,SG,20,DEN,22,1,165,33,73,.452,9,28,.321,24,45,.533,.514,8,10,.800,5,12,17,11,7,0,8,10,83,16
Michael Beasley,PF,28,MIL,56,6,935,216,406,.532,18,43,.419,198,363,.545,.554,78,105,.743,40,153,193,53,27,27,66,92,528,16
Marco Belinelli,SG,30,CHO,74,0,1778,264,615,.429,102,283,.360,162,332,.488,.512,150,168,.893,14,164,178,147,44,9,70,90,780,16
DeAndre' Bembry,SF,22,ATL,38,1,371,47,98,.480,1,18,.056,46,80,.575,.485,6,16,.375,14,45,59,28,8,5,16,21,101,16
Dragan Bender,PF,19,PHO,43,0,574,57,161,.354,28,101,.277,29,60,.483,.441,4,11,.364,23,80,103,23,10,22,32,74,146,16
Anthony Bennett,PF,23,BRK,23,1,264,38,92,.413,13,48,.271,25,44,.568,.484,26,36,.722,25,53,78,12,5,3,12,18,115,16
Ben Bentil,PF,21,DAL,3,0,10,0,3,0,0,1,0,0,2,0,0,0,0,0,0,2,2,0,0,0,1,1,0,16
Dāvis Bertāns,PF,24,SAS,67,6,808,103,234,.440,69,173,.399,34,61,.557,.588,28,34,.824,22,76,98,46,20,28,32,75,303,16
Patrick Beverley,SG,28,HOU,67,67,2058,228,543,.420,110,288,.382,118,255,.463,.521,73,95,.768,95,298,393,281,99,25,100,222,639,16
Bismack Biyombo,C,24,ORL,81,27,1793,179,339,.528,0,0,0,179,339,.528,.528,125,234,.534,157,410,567,74,25,91,95,202,483,16
Nemanja Bjelica,PF,28,MIN,65,1,1190,151,356,.424,56,177,.316,95,179,.531,.503,45,61,.738,57,187,244,79,40,20,59,154,403,16
Tarik Black,C,25,LAL,67,16,1091,150,294,.510,1,2,.500,149,292,.510,.512,82,109,.752,144,199,343,39,29,44,58,173,383,16
Eric Bledsoe,PG,27,PHO,66,66,2176,449,1034,.434,104,310,.335,345,724,.477,.485,388,458,.847,52,268,320,418,91,31,224,164,1390,16
Bojan Bogdanović,SF,27,TOT,81,54,2083,376,845,.445,144,392,.367,232,453,.512,.530,217,243,.893,37,240,277,111,34,7,131,146,1113,16
Andrew Bogut,C,32,TOT,27,21,583,38,81,.469,0,1,0,38,80,.475,.469,3,11,.273,56,162,218,49,13,25,43,86,79,16
Joel Bolomboy,PF,23,UTA,12,0,53,9,16,.563,1,4,.250,8,12,.667,.594,3,6,.500,4,13,17,2,1,2,2,1,22,16
Devin Booker,SG,20,PHO,78,78,2730,606,1431,.423,147,405,.363,459,1026,.447,.475,367,441,.832,46,203,249,268,72,21,241,242,1726,16
Trevor Booker,PF,29,BRK,71,43,1754,305,591,.516,25,78,.321,280,513,.546,.537,74,110,.673,143,428,571,138,75,28,127,152,709,16
Avery Bradley,SG,26,BOS,55,55,1835,359,775,.463,108,277,.390,251,498,.504,.533,68,93,.731,65,269,334,122,68,11,88,141,894,16
Corey Brewer,SF,30,TOT,82,11,1281,147,348,.422,27,118,.229,120,230,.522,.461,50,68,.735,32,134,166,97,61,20,55,133,371,16
Malcolm Brogdon,SG,24,MIL,75,28,1982,290,635,.457,78,193,.404,212,442,.480,.518,109,126,.865,47,166,213,317,84,12,113,140,767,16
Aaron Brooks,PG,32,IND,65,0,894,121,300,.403,48,128,.375,73,172,.424,.483,32,40,.800,18,51,69,125,25,9,66,93,322,16
Anthony Brown,SF,24,TOT,11,0,159,18,50,.360,7,27,.259,11,23,.478,.430,0,0,0,8,25,33,8,5,1,6,15,43,16
Bobby Brown,PG,32,HOU,25,0,123,23,60,.383,14,35,.400,9,25,.360,.500,2,2,1.000,0,6,6,14,1,0,5,5,62,16
Jaylen Brown,SF,20,BOS,78,20,1341,192,423,.454,46,135,.341,146,288,.507,.508,85,124,.685,45,175,220,64,35,18,68,142,515,16
Nicolás Brussino,SG,23,DAL,54,2,521,52,141,.369,29,95,.305,23,46,.500,.472,17,22,.773,26,69,95,47,17,8,26,43,150,16
Reggie Bullock,SF,25,DET,31,5,467,54,128,.422,28,73,.384,26,55,.473,.531,5,7,.714,13,51,64,29,18,3,10,22,141,16
Trey Burke,PG,24,WAS,57,0,703,116,255,.455,31,70,.443,85,185,.459,.516,22,29,.759,7,40,47,100,11,5,48,54,285,16
Alec Burks,SG,25,UTA,42,0,653,99,248,.399,25,76,.329,74,172,.430,.450,60,78,.769,17,103,120,30,18,5,35,50,283,16
Jimmy Butler,SF,27,CHI,76,75,2809,570,1252,.455,91,248,.367,479,1004,.477,.492,585,676,.865,129,341,470,417,143,32,159,112,1816,16
Bruno Caboclo,SF,21,TOR,9,0,40,6,16,.375,2,6,.333,4,10,.400,.438,0,0,0,5,5,10,4,2,1,2,4,14,16
José Calderón,PG,35,TOT,41,13,539,55,134,.410,20,64,.313,35,70,.500,.485,11,12,.917,15,59,74,88,11,1,41,36,141,16
Kentavious Caldwell-Pope,SG,23,DET,76,75,2529,370,928,.399,153,437,.350,217,491,.442,.481,154,185,.832,55,193,248,193,89,12,86,118,1047,16
Isaiah Canaan,SG,25,CHI,39,0,592,63,173,.364,25,94,.266,38,79,.481,.436,30,33,.909,6,44,50,37,22,1,21,35,181,16
Clint Capela,C,22,HOU,65,59,1551,362,563,.643,0,0,0,362,563,.643,.643,94,177,.531,178,348,526,63,34,79,87,179,818,16
DeMarre Carroll,SF,30,TOR,72,72,1882,220,550,.400,109,320,.341,111,230,.483,.499,89,117,.761,63,212,275,74,81,27,54,143,638,16
Vince Carter,SF,40,MEM,73,15,1799,193,490,.394,112,296,.378,81,194,.418,.508,88,115,.765,36,191,227,133,60,36,50,163,586,16
Michael Carter-Williams,PG,25,CHI,45,19,846,112,306,.366,15,64,.234,97,242,.401,.391,58,77,.753,24,129,153,113,38,23,66,102,297,16
Omri Casspi,PF,28,TOT,36,2,643,77,164,.470,15,43,.349,62,121,.512,.515,17,29,.586,27,85,112,37,23,3,29,50,186,16
Willie Cauley-Stein,C,23,SAC,75,21,1421,255,481,.530,0,2,0,255,479,.532,.530,101,151,.669,85,254,339,80,53,44,69,147,611,16
Tyson Chandler,C,34,PHO,47,46,1298,153,228,.671,0,0,0,153,228,.671,.671,91,124,.734,153,386,539,30,33,24,65,126,397,16
Wilson Chandler,SF,29,DEN,71,33,2197,433,939,.461,110,326,.337,323,613,.527,.520,141,194,.727,103,357,460,141,51,30,114,172,1117,16
Marquese Chriss,PF,19,PHO,82,75,1743,284,632,.449,72,224,.321,212,408,.520,.506,113,181,.624,96,252,348,60,67,70,108,263,753,16
Rakeem Christmas,PF,25,IND,29,0,219,19,43,.442,0,0,0,19,43,.442,.442,21,29,.724,26,30,56,4,3,6,8,37,59,16
Semaj Christon,PG,24,OKC,64,1,973,77,223,.345,12,63,.190,65,160,.406,.372,17,31,.548,19,68,87,130,28,7,43,79,183,16
Ian Clark,SG,25,GSW,77,0,1137,211,433,.487,61,163,.374,150,270,.556,.558,44,58,.759,22,99,121,90,39,8,55,77,527,16
Jordan Clarkson,SG,24,LAL,82,19,2397,477,1071,.445,117,356,.329,360,715,.503,.500,134,168,.798,49,197,246,213,88,8,164,150,1205,16
Norris Cole,PG,28,OKC,13,0,125,16,52,.308,3,13,.231,13,39,.333,.337,8,10,.800,0,11,11,14,8,0,7,18,43,16
Darren Collison,PG,29,SAC,68,64,2063,340,714,.476,73,175,.417,267,539,.495,.527,147,171,.860,23,129,152,312,67,9,114,119,900,16
Nick Collison,PF,36,OKC,20,0,128,14,23,.609,0,1,0,14,22,.636,.609,5,8,.625,9,22,31,12,2,2,4,17,33,16
Mike Conley,PG,29,MEM,69,68,2292,464,1009,.460,171,419,.408,293,590,.497,.545,316,368,.859,31,210,241,433,92,19,156,126,1415,16
Pat Connaughton,SG,24,POR,39,1,316,37,72,.514,17,33,.515,20,39,.513,.632,7,9,.778,10,42,52,28,6,2,17,23,98,16
Quinn Cook,PG,23,TOT,14,0,188,33,66,.500,11,26,.423,22,40,.550,.583,2,5,.400,1,6,7,26,4,0,13,13,79,16
DeMarcus Cousins,C,26,TOT,72,72,2465,647,1432,.452,131,363,.361,516,1069,.483,.498,517,670,.772,152,642,794,332,100,93,269,278,1942,16
Robert Covington,SF,26,PHI,67,67,2119,292,732,.399,137,412,.333,155,320,.484,.492,143,174,.822,92,344,436,102,127,69,131,203,864,16
Allen Crabbe,SG,24,POR,79,7,2254,303,647,.468,134,302,.444,169,345,.490,.572,105,124,.847,19,207,226,94,54,20,62,171,845,16
Jamal Crawford,SG,36,LAC,82,1,2157,359,870,.413,116,322,.360,243,548,.443,.479,174,203,.857,17,112,129,214,61,14,134,115,1008,16
Jordan Crawford,SG,28,NOP,19,0,442,105,218,.482,37,95,.389,68,123,.553,.567,20,26,.769,4,30,34,57,11,2,25,30,267,16
Jae Crowder,SF,26,BOS,72,72,2335,333,720,.463,157,394,.398,176,326,.540,.572,176,217,.811,48,367,415,155,73,23,80,161,999,16
Dante Cunningham,PF,29,NOP,66,35,1649,174,359,.485,71,181,.392,103,178,.579,.584,16,27,.593,56,221,277,37,39,28,28,100,435,16
Seth Curry,PG,26,DAL,70,42,2029,338,703,.481,137,322,.425,201,381,.528,.578,85,100,.850,25,154,179,189,79,7,92,126,898,16
Stephen Curry,PG,28,GSW,79,79,2638,675,1443,.468,324,789,.411,351,654,.537,.580,325,362,.898,61,292,353,524,142,17,239,183,1999,16
Troy Daniels,SG,25,MEM,67,3,1183,185,495,.374,138,355,.389,47,140,.336,.513,43,54,.796,22,78,100,46,20,4,45,90,551,16
Anthony Davis,C,23,NOP,75,75,2708,770,1526,.505,40,134,.299,730,1392,.524,.518,519,647,.802,172,712,884,157,94,167,181,168,2099,16
Deyonta Davis,C,20,MEM,36,0,238,24,47,.511,0,0,0,24,47,.511,.511,10,18,.556,20,40,60,2,3,17,8,40,58,16
Ed Davis,PF,27,POR,46,12,789,75,142,.528,0,0,0,75,142,.528,.528,50,81,.617,96,148,244,26,15,22,37,137,200,16
Dewayne Dedmon,C,27,SAS,76,37,1330,161,259,.622,0,0,0,161,259,.622,.622,65,93,.699,129,367,496,44,37,61,61,180,387,16
Sam Dekker,PF,22,HOU,77,2,1419,203,429,.473,60,187,.321,143,242,.591,.543,38,68,.559,94,190,284,76,38,21,41,83,504,16
Malcolm Delaney,PG,27,ATL,73,2,1248,145,388,.374,26,110,.236,119,278,.428,.407,75,93,.806,10,113,123,193,39,1,95,112,391,16
Matthew Dellavedova,PG,26,MIL,76,54,1986,208,534,.390,79,215,.367,129,319,.404,.463,82,96,.854,24,123,147,357,53,0,133,153,577,16
Luol Deng,SF,31,LAL,56,49,1486,164,424,.387,51,165,.309,113,259,.436,.447,46,63,.730,63,232,295,74,48,20,43,61,425,16
DeMar DeRozan,SG,27,TOR,74,74,2620,721,1545,.467,33,124,.266,688,1421,.484,.477,545,647,.842,70,316,386,290,78,13,180,134,2020,16
Cheick Diallo,PF,20,NOP,17,0,199,36,76,.474,0,0,0,36,76,.474,.474,15,21,.714,23,50,73,4,4,7,7,17,87,16
Boris Diaw,PF,34,UTA,73,33,1283,146,327,.446,20,81,.247,126,246,.512,.477,26,35,.743,46,112,158,170,18,9,87,83,338,16
Gorgui Dieng,PF,27,MIN,82,82,2653,332,661,.502,16,43,.372,316,618,.511,.514,136,167,.814,188,459,647,158,88,95,107,254,816,16
Spencer Dinwiddie,PG,23,BRK,59,18,1334,134,302,.444,38,101,.376,96,201,.478,.507,126,159,.792,27,137,164,185,44,23,66,119,432,16
Toney Douglas,PG,30,MEM,24,0,394,43,117,.368,7,42,.167,36,75,.480,.397,24,29,.828,13,48,61,56,18,5,21,50,117,16
Goran Dragić,PG,30,MIA,73,73,2459,534,1124,.475,117,289,.405,417,835,.499,.527,298,377,.790,62,217,279,423,89,13,212,199,1483,16
Andre Drummond,C,23,DET,81,81,2409,483,911,.530,2,7,.286,481,904,.532,.531,137,355,.386,345,770,1115,90,124,89,152,237,1105,16
Jared Dudley,PF,31,PHO,64,7,1362,157,346,.454,77,203,.379,80,143,.559,.565,43,65,.662,31,194,225,121,42,16,73,154,434,16
Mike Dunleavy,SF,36,TOT,53,2,841,93,220,.423,53,134,.396,40,86,.465,.543,36,45,.800,18,97,115,50,15,7,28,67,275,16
Kris Dunn,PG,22,MIN,78,7,1333,118,313,.377,21,73,.288,97,240,.404,.411,36,59,.610,24,142,166,188,78,36,89,178,293,16
Kevin Durant,PF,28,GSW,62,62,2070,551,1026,.537,117,312,.375,434,714,.608,.594,336,384,.875,39,474,513,300,66,99,138,117,1555,16
Jarell Eddie,SF,25,PHO,5,0,62,6,19,.316,4,16,.250,2,3,.667,.421,8,9,.889,1,6,7,0,1,0,1,1,24,16
Henry Ellenson,PF,20,DET,19,2,146,23,64,.359,10,35,.286,13,29,.448,.438,4,8,.500,8,33,41,7,1,1,14,6,60,16
Wayne Ellington,SG,29,MIA,62,13,1500,231,555,.416,149,394,.378,82,161,.509,.550,37,43,.860,18,114,132,70,35,4,30,70,648,16
Monta Ellis,SG,31,IND,74,33,1998,247,557,.443,43,135,.319,204,422,.483,.482,93,128,.727,19,185,204,236,78,27,135,149,630,16
Joel Embiid,C,22,PHI,31,31,786,200,429,.466,36,98,.367,164,331,.495,.508,191,244,.783,61,182,243,66,27,76,117,112,627,16
James Ennis III,SF,26,MEM,64,28,1501,146,321,.455,51,137,.372,95,184,.516,.534,86,110,.782,69,190,259,64,46,19,59,165,429,16
Tyler Ennis,PG,22,TOT,53,2,588,90,208,.433,27,70,.386,63,138,.457,.498,21,25,.840,9,36,45,86,25,2,45,58,228,16
Tyreke Evans,SF,27,TOT,40,6,788,150,370,.405,42,118,.356,108,252,.429,.462,69,92,.750,13,124,137,124,35,9,61,60,411,16
Dante Exum,PG,21,UTA,66,26,1228,155,363,.427,44,149,.295,111,214,.519,.488,58,73,.795,30,102,132,111,21,12,80,146,412,16
Kenneth Faried,PF,27,DEN,61,34,1296,228,416,.548,0,6,0,228,410,.556,.548,131,189,.693,183,279,462,55,43,40,59,124,587,16
Jordan Farmar,PG,30,SAC,2,0,35,4,12,.333,4,9,.444,0,3,0,.500,0,0,0,1,2,3,9,2,0,3,1,12,16
Derrick Favors,PF,25,UTA,50,39,1186,203,417,.487,3,10,.300,200,407,.491,.490,67,109,.615,92,213,305,56,45,40,60,103,476,16
Kay Felder,PG,21,CLE,42,0,386,62,158,.392,7,22,.318,55,136,.404,.415,35,49,.714,3,38,41,58,18,7,30,38,166,16
Cristiano Felício,C,24,CHI,66,0,1040,128,221,.579,0,0,0,128,221,.579,.579,60,93,.645,124,187,311,40,25,17,33,110,316,16
Raymond Felton,PG,32,LAC,80,11,1700,221,514,.430,46,144,.319,175,370,.473,.475,50,64,.781,33,185,218,191,66,22,83,125,538,16
Yogi Ferrell,PG,23,TOT,46,29,1197,160,394,.406,68,176,.386,92,218,.422,.492,74,89,.831,20,91,111,172,42,9,70,90,462,16
Dorian Finney-Smith,PF,23,DAL,81,35,1642,124,333,.372,56,191,.293,68,142,.479,.456,46,61,.754,55,167,222,67,52,25,45,125,350,16
Bryn Forbes,SG,23,SAS,36,0,285,36,99,.364,17,53,.321,19,46,.413,.449,5,6,.833,2,21,23,23,1,0,11,20,94,16
Evan Fournier,SG,24,ORL,68,66,2234,408,930,.439,128,360,.356,280,570,.491,.508,223,277,.805,44,165,209,202,66,4,141,180,1167,16
Randy Foye,SG,33,BRK,69,40,1284,118,325,.363,67,203,.330,51,122,.418,.466,54,63,.857,9,146,155,135,35,9,80,99,357,16
Tim Frazier,PG,26,NOP,65,35,1525,163,404,.403,40,128,.313,123,276,.446,.453,98,129,.760,34,139,173,335,56,6,101,133,464,16
Enes Freedom,C,24,OKC,72,0,1533,402,737,.545,5,38,.132,397,699,.568,.549,224,285,.786,195,287,482,67,32,38,123,154,1033,16
Channing Frye,C,33,CLE,74,15,1398,238,520,.458,137,335,.409,101,185,.546,.589,63,74,.851,37,253,290,45,33,37,53,138,676,16
Danilo Gallinari,SF,28,DEN,63,63,2134,335,750,.447,126,324,.389,209,426,.491,.531,349,387,.902,39,286,325,135,40,15,82,93,1145,16
Langston Galloway,PG,25,TOT,74,2,1495,207,545,.380,120,308,.390,87,237,.367,.490,51,64,.797,27,129,156,93,46,6,46,96,585,16
Patricio Garino,SG,23,ORL,5,0,43,0,7,0,0,5,0,0,2,0,0,0,0,0,1,6,7,0,0,0,3,4,0,16
Marc Gasol,C,32,MEM,74,74,2531,532,1160,.459,104,268,.388,428,892,.480,.503,278,332,.837,60,404,464,338,67,99,166,171,1446,16
Pau Gasol,C,36,SAS,64,39,1627,303,604,.502,56,104,.538,247,500,.494,.548,130,184,.707,107,394,501,150,24,70,81,110,792,16
Rudy Gay,SF,30,SAC,30,30,1013,201,442,.455,42,113,.372,159,329,.483,.502,118,138,.855,35,155,190,83,44,26,74,79,562,16
Michael Gbinije,SG,24,DET,9,0,32,1,10,.100,0,4,0,1,6,.167,.100,2,2,1.000,2,1,3,2,0,0,0,2,4,16
Alonzo Gee,SF,29,DEN,13,0,89,3,14,.214,0,3,0,3,11,.273,.214,5,9,.556,4,11,15,6,5,1,4,14,11,16
Paul George,SF,26,IND,75,75,2689,622,1348,.461,195,496,.393,427,852,.501,.534,336,374,.898,58,434,492,251,119,27,220,206,1775,16
Marcus Georges-Hunt,SG,22,ORL,5,0,48,2,7,.286,1,2,.500,1,5,.200,.357,9,10,.900,1,8,9,3,1,0,2,5,14,16
Jonathan Gibson,PG,29,DAL,17,0,231,35,95,.368,15,45,.333,20,50,.400,.447,21,29,.724,1,21,22,26,8,0,21,21,106,16
Taj Gibson,PF,31,TOT,78,71,1989,365,709,.515,3,13,.231,362,696,.520,.517,113,158,.715,158,327,485,73,41,65,105,163,846,16
Manu Ginóbili,SG,39,SAS,69,0,1291,171,439,.390,89,227,.392,82,212,.387,.491,86,107,.804,28,129,157,183,82,16,96,119,517,16
Rudy Gobert,C,24,UTA,81,81,2744,413,625,.661,0,1,0,413,624,.662,.661,311,476,.653,314,721,1035,97,49,214,147,246,1137,16
Archie Goodwin,SG,22,TOT,15,0,214,36,66,.545,5,15,.333,31,51,.608,.583,33,42,.786,7,21,28,24,4,5,14,8,110,16
Aaron Gordon,SF,21,ORL,80,72,2298,393,865,.454,77,267,.288,316,598,.528,.499,156,217,.719,116,289,405,150,65,40,89,172,1019,16
Eric Gordon,SG,28,HOU,75,15,2323,412,1016,.406,246,661,.372,166,355,.468,.527,147,175,.840,29,172,201,188,48,41,121,150,1217,16
Marcin Gortat,C,32,WAS,82,82,2556,390,674,.579,0,2,0,390,672,.580,.579,103,159,.648,238,611,849,121,40,61,119,213,883,16
Treveon Graham,SG,23,CHO,27,1,189,19,40,.475,9,15,.600,10,25,.400,.588,10,15,.667,5,17,22,6,6,1,3,18,57,16
Jerami Grant,PF,22,TOT,80,4,1531,152,328,.463,43,116,.371,109,212,.514,.529,90,147,.612,38,167,205,46,33,79,44,149,437,16
Jerian Grant,PG,24,CHI,63,28,1028,128,301,.425,49,134,.366,79,167,.473,.507,65,73,.890,17,94,111,121,47,8,44,93,370,16
Danny Green,SG,29,SAS,68,68,1807,176,449,.392,118,311,.379,58,138,.420,.523,27,32,.844,31,193,224,124,70,57,76,120,497,16
Draymond Green,PF,26,GSW,76,76,2471,272,650,.418,81,263,.308,191,387,.494,.481,151,213,.709,98,501,599,533,154,106,184,217,776,16
Gerald Green,SF,31,BOS,47,0,538,95,232,.409,39,111,.351,56,121,.463,.494,33,41,.805,16,68,84,33,9,7,25,48,262,16
JaMychal Green,PF,26,MEM,77,75,2101,250,500,.500,55,145,.379,195,355,.549,.555,134,167,.802,167,377,544,84,47,34,94,248,689,16
Jeff Green,PF,30,ORL,69,11,1534,220,558,.394,53,193,.275,167,365,.458,.442,145,168,.863,39,175,214,81,37,13,75,103,638,16
Blake Griffin,PF,27,LAC,61,61,2076,479,971,.493,38,113,.336,441,858,.514,.513,320,421,.760,112,385,497,300,57,22,142,157,1316,16
Justin Hamilton,C,26,BRK,64,7,1177,174,379,.459,55,180,.306,119,199,.598,.532,39,52,.750,71,191,262,55,29,43,43,91,442,16
A.J. Hammons,C,24,DAL,22,0,163,17,42,.405,5,10,.500,12,32,.375,.464,9,20,.450,8,28,36,4,1,13,10,21,48,16
Tim Hardaway Jr.,SG,24,ATL,79,30,2154,415,912,.455,149,417,.357,266,495,.537,.537,164,214,.766,35,189,224,182,55,15,106,103,1143,16
James Harden,PG,27,HOU,81,81,2947,674,1533,.440,262,756,.347,412,777,.530,.525,746,881,.847,95,564,659,907,121,38,464,215,2356,16
Maurice Harkless,SF,23,POR,77,69,2223,314,624,.503,68,194,.351,246,430,.572,.558,77,124,.621,125,216,341,88,85,70,86,214,773,16
Justin Harper,PF,27,PHI,3,0,31,5,12,.417,2,7,.286,3,5,.600,.500,0,0,0,2,3,5,2,0,0,4,2,12,16
Montrezl Harrell,C,23,HOU,58,14,1064,225,345,.652,1,7,.143,224,338,.663,.654,76,121,.628,81,138,219,64,20,42,44,126,527,16
Devin Harris,PG,33,DAL,65,0,1087,136,341,.399,58,177,.328,78,164,.476,.484,107,129,.829,11,116,127,136,43,7,57,101,437,16
Gary Harris,SG,22,DEN,57,56,1782,320,637,.502,107,255,.420,213,382,.558,.586,104,134,.776,48,130,178,164,71,8,76,92,851,16
Joe Harris,SG,25,BRK,52,11,1138,154,362,.425,85,221,.385,69,141,.489,.543,35,49,.714,16,131,147,54,30,8,55,121,428,16
Manny Harris,SG,27,DAL,4,0,25,3,15,.200,0,2,0,3,13,.231,.200,2,4,.500,3,6,9,2,0,0,2,1,8,16
Tobias Harris,PF,24,DET,82,48,2567,511,1063,.481,109,314,.347,402,749,.537,.532,190,226,.841,63,353,416,142,60,39,96,133,1321,16
Aaron Harrison,SG,22,CHO,5,0,17,0,4,0,0,2,0,0,2,0,0,1,2,.500,0,3,3,3,0,0,0,2,1,16
Andrew Harrison,PG,22,MEM,72,18,1474,117,360,.325,43,156,.276,74,204,.363,.385,148,194,.763,23,113,136,198,53,21,85,194,425,16
Udonis Haslem,C,36,MIA,16,0,130,11,23,.478,0,3,0,11,20,.550,.478,9,15,.600,8,28,36,6,6,1,8,22,31,16
Spencer Hawes,PF,28,TOT,54,1,797,134,277,.484,25,81,.309,109,196,.556,.529,44,52,.846,38,153,191,81,15,30,49,77,337,16
Gordon Hayward,SF,26,UTA,73,73,2516,545,1156,.471,149,374,.398,396,782,.506,.536,362,429,.844,49,345,394,252,73,20,140,117,1601,16
Gerald Henderson,SG,29,PHI,72,41,1667,234,553,.423,61,173,.353,173,380,.455,.478,133,165,.806,34,151,185,112,40,15,62,129,662,16
John Henson,C,26,MIL,58,39,1123,159,309,.515,0,1,0,159,308,.516,.515,74,107,.692,92,203,295,57,29,78,52,151,392,16
Juancho Hernangómez,PF,21,DEN,62,9,842,101,224,.451,46,113,.407,55,111,.495,.554,57,76,.750,43,144,187,29,30,12,31,62,305,16
Willy Hernangómez,C,22,NYK,72,22,1324,246,465,.529,4,15,.267,242,450,.538,.533,91,125,.728,170,332,502,96,41,36,100,150,587,16
Mario Hezonja,SF,21,ORL,65,2,960,117,330,.355,43,144,.299,74,186,.398,.420,40,50,.800,20,126,146,62,30,15,58,74,317,16
Roy Hibbert,C,30,TOT,48,13,682,80,147,.544,0,0,0,80,147,.544,.544,61,75,.813,54,98,152,21,8,46,32,100,221,16
Buddy Hield,SG,24,TOT,82,55,1888,327,767,.426,148,379,.391,179,388,.461,.523,64,76,.842,35,234,269,121,38,9,101,115,866,16
Nenê,C,34,HOU,67,8,1198,245,397,.617,3,9,.333,242,388,.624,.621,116,197,.589,95,187,282,65,56,39,73,163,609,16
George Hill,PG,30,UTA,49,49,1544,289,606,.477,94,233,.403,195,373,.523,.554,157,196,.801,23,144,167,204,50,11,85,114,829,16
Jordan Hill,C,29,MIN,7,0,47,5,13,.385,0,0,0,5,13,.385,.385,2,2,1.000,8,6,14,0,1,0,4,9,12,16
Solomon Hill,SF,25,NOP,80,71,2374,183,478,.383,94,270,.348,89,208,.428,.481,103,128,.805,51,256,307,141,72,32,82,182,563,16
Darrun Hilliard,SG,23,DET,39,1,381,47,126,.373,12,46,.261,35,80,.438,.421,21,28,.750,2,31,33,33,11,2,28,39,127,16
Jrue Holiday,PG,26,NOP,67,61,2190,405,893,.454,100,281,.356,305,612,.498,.510,119,168,.708,46,218,264,488,100,44,194,133,1029,16
Justin Holiday,SG,27,NYK,82,4,1639,233,538,.433,97,273,.355,136,265,.513,.523,66,80,.825,27,198,225,102,65,31,66,109,629,16
Rondae Hollis-Jefferson,SF,22,BRK,78,50,1761,235,542,.434,15,67,.224,220,475,.463,.447,190,253,.751,96,356,452,154,82,44,116,177,675,16
Richaun Holmes,C,23,PHI,57,17,1193,230,412,.558,27,77,.351,203,335,.606,.591,72,103,.699,94,217,311,58,42,55,55,136,559,16
Rodney Hood,SG,24,UTA,59,55,1593,272,666,.408,114,307,.371,158,359,.440,.494,90,115,.783,16,186,202,96,38,11,65,132,748,16
Al Horford,C,30,BOS,68,68,2193,379,801,.473,86,242,.355,293,559,.524,.527,108,135,.800,95,370,465,337,52,86,115,138,952,16
Danuel House Jr.,SG,23,WAS,1,0,1,0,0,0,0,0,0,0,0,0,0,0,0,0,0,1,1,0,0,0,0,0,0,16
Dwight Howard,C,31,ATL,74,74,2199,388,613,.633,0,2,0,388,611,.635,.633,226,424,.533,296,644,940,104,64,92,170,203,1002,16
Marcelo Huertas,PG,33,LAL,23,1,237,25,68,.368,4,19,.211,21,49,.429,.397,9,17,.529,2,22,24,52,10,2,19,16,63,16
Josh Huestis,PF,25,OKC,2,0,31,6,11,.545,2,4,.500,4,7,.571,.636,0,1,0,4,5,9,3,0,3,0,0,14,16
Kris Humphries,PF,31,ATL,56,4,689,87,214,.407,19,54,.352,68,160,.425,.451,64,82,.780,60,146,206,29,15,21,28,69,257,16
R.J. Hunter,SG,23,CHI,3,0,9,0,1,0,0,1,0,0,0,0,0,0,0,0,0,1,1,0,0,0,0,0,0,16
Serge Ibaka,PF,27,TOT,79,79,2422,471,982,.480,124,317,.391,347,665,.522,.543,107,125,.856,129,409,538,75,41,124,105,215,1173,16
Andre Iguodala,SF,33,GSW,76,0,1998,219,415,.528,64,177,.362,155,238,.651,.605,72,102,.706,51,253,304,261,76,39,58,97,574,16
Ersan İlyasova,PF,29,TOT,82,52,2142,384,890,.431,142,402,.353,242,488,.496,.511,161,207,.778,115,366,481,141,58,23,116,211,1071,16
Joe Ingles,SF,29,UTA,82,26,1972,204,451,.452,123,279,.441,81,172,.471,.589,50,68,.735,23,238,261,225,96,8,107,163,581,16
Brandon Ingram,SF,19,LAL,79,40,2279,276,686,.402,55,187,.294,221,499,.443,.442,133,214,.621,60,256,316,166,50,36,116,158,740,16
Kyrie Irving,PG,24,CLE,72,72,2525,671,1420,.473,177,441,.401,494,979,.505,.535,297,328,.905,52,178,230,418,83,24,180,157,1816,16
Jarrett Jack,PG,33,NOP,2,0,33,2,3,.667,0,1,0,2,2,1.000,.667,2,2,1.000,0,0,0,5,2,0,3,4,6,16
Demetrius Jackson,PG,22,BOS,5,0,17,3,4,.750,1,1,1.000,2,3,.667,.875,3,6,.500,2,2,4,3,0,0,0,0,10,16
Pierre Jackson,PG,25,DAL,8,1,84,13,39,.333,3,11,.273,10,28,.357,.372,6,7,.857,1,8,9,19,2,0,3,5,35,16
Reggie Jackson,PG,26,DET,52,50,1424,284,677,.419,66,184,.359,218,493,.442,.468,118,136,.868,21,93,114,270,35,5,114,129,752,16
LeBron James,SF,32,CLE,74,74,2794,736,1344,.548,124,342,.363,612,1002,.611,.594,358,531,.674,97,542,639,646,92,44,303,134,1954,16
Al Jefferson,C,32,IND,66,1,931,235,471,.499,0,1,0,235,470,.500,.499,65,85,.765,75,203,278,57,19,16,33,125,535,16
Richard Jefferson,SF,36,CLE,79,13,1614,153,343,.446,62,186,.333,91,157,.580,.536,80,108,.741,28,175,203,78,26,10,52,153,448,16
John Jenkins,SG,25,PHO,4,0,13,2,5,.400,1,2,.500,1,3,.333,.500,2,2,1.000,0,1,1,1,0,0,0,0,7,16
Brandon Jennings,PG,27,TOT,81,13,1802,192,535,.359,79,252,.313,113,283,.399,.433,114,152,.750,29,167,196,395,70,4,128,116,577,16
Jonas Jerebko,PF,29,BOS,78,6,1232,114,262,.435,45,130,.346,69,132,.523,.521,26,37,.703,59,213,272,71,25,17,39,122,299,16
Amir Johnson,PF,29,BOS,80,77,1608,213,370,.576,27,66,.409,186,304,.612,.612,67,100,.670,118,248,366,140,51,62,77,211,520,16
Brice Johnson,PF,22,LAC,3,0,9,2,7,.286,0,0,0,2,7,.286,.286,0,0,0,1,2,3,1,2,1,1,0,4,16
James Johnson,PF,29,MIA,76,5,2085,368,769,.479,87,256,.340,281,513,.548,.535,152,215,.707,66,310,376,276,76,86,171,197,975,16
Joe Johnson,SF,35,UTA,78,14,1843,273,626,.436,106,258,.411,167,368,.454,.521,63,77,.818,33,210,243,144,36,18,69,93,715,16
Stanley Johnson,SF,20,DET,77,1,1371,129,365,.353,45,154,.292,84,211,.398,.415,36,53,.679,36,153,189,105,56,24,71,121,339,16
Tyler Johnson,PG,24,MIA,73,0,2178,357,824,.433,93,250,.372,264,574,.460,.490,195,254,.768,50,243,293,233,84,44,90,176,1002,16
Wesley Johnson,SF,29,LAC,68,3,810,73,200,.365,29,118,.246,44,82,.537,.438,11,17,.647,26,155,181,23,29,30,18,83,186,16
Nikola Jokić,C,21,DEN,73,59,2038,494,854,.578,45,139,.324,449,715,.628,.605,188,228,.825,212,506,718,359,61,55,171,214,1221,16
Dahntay Jones,SF,36,CLE,1,0,12,3,8,.375,0,2,0,3,6,.500,.375,3,4,.750,1,1,2,1,0,0,1,1,9,16
Damian Jones,C,21,GSW,10,0,85,8,16,.500,0,0,0,8,16,.500,.500,3,10,.300,9,14,23,0,1,4,6,15,19,16
Derrick Jones Jr.,SF,19,PHO,32,8,545,68,121,.562,3,11,.273,65,110,.591,.574,29,41,.707,39,40,79,12,14,13,13,63,168,16
James Jones,SF,36,CLE,48,2,381,44,92,.478,31,66,.470,13,26,.500,.647,13,20,.650,3,34,37,14,6,10,10,37,132,16
Terrence Jones,PF,25,TOT,54,12,1270,231,492,.470,19,75,.253,212,417,.508,.489,103,170,.606,65,241,306,59,40,54,48,67,584,16
Tyus Jones,PG,20,MIN,60,0,774,75,181,.414,26,73,.356,49,108,.454,.486,33,43,.767,10,57,67,156,48,5,38,50,209,16
DeAndre Jordan,C,28,LAC,81,81,2570,412,577,.714,0,2,0,412,575,.717,.714,205,425,.482,298,816,1114,96,51,134,115,212,1029,16
Cory Joseph,PG,25,TOR,80,22,2003,299,661,.452,48,135,.356,251,526,.477,.489,94,122,.770,51,184,235,265,66,13,108,140,740,16
Frank Kaminsky,C,23,CHO,75,16,1954,320,802,.399,116,354,.328,204,448,.455,.471,118,156,.756,57,279,336,162,46,34,76,139,874,16
Ryan Kelly,PF,25,ATL,16,0,110,8,28,.286,4,10,.400,4,18,.222,.357,5,6,.833,1,17,18,8,4,5,4,5,25,16
Michael Kidd-Gilchrist,SF,23,CHO,81,81,2349,295,618,.477,1,9,.111,294,609,.483,.478,152,194,.784,156,409,565,114,81,77,56,187,743,16
Sean Kilpatrick,SG,27,BRK,70,24,1754,305,735,.415,105,308,.341,200,427,.468,.486,204,242,.843,22,258,280,157,45,6,135,118,919,16
Brandon Knight,SG,25,PHO,54,5,1140,209,525,.398,45,139,.324,164,386,.425,.441,132,154,.857,25,93,118,130,27,5,88,87,595,16
Kyle Korver,SG,35,TOT,67,22,1753,239,515,.464,162,359,.451,77,156,.494,.621,38,42,.905,7,179,186,110,34,21,69,107,678,16
Kosta Koufos,C,27,SAC,71,62,1419,216,392,.551,0,1,0,216,391,.552,.551,38,62,.613,118,285,403,47,36,48,61,172,470,16
Mindaugas Kuzminskas,SF,27,NYK,68,5,1016,158,369,.428,54,168,.321,104,201,.517,.501,55,68,.809,47,79,126,69,29,11,51,79,425,16
Skal Labissière,PF,20,SAC,33,12,612,117,218,.537,3,8,.375,114,210,.543,.544,52,74,.703,51,111,162,27,16,13,37,64,289,16
Jeremy Lamb,SG,24,CHO,62,5,1143,226,491,.460,41,146,.281,185,345,.536,.502,110,129,.853,30,234,264,75,27,23,40,98,603,16
Nicolás Laprovíttola,PG,27,SAS,18,3,174,20,47,.426,10,27,.370,10,20,.500,.532,9,9,1.000,1,9,10,28,4,1,19,19,59,16
Joffrey Lauvergne,PF-C,25,TOT,70,1,980,148,336,.440,33,98,.337,115,238,.483,.490,46,73,.630,72,179,251,70,25,6,56,83,375,16
Zach LaVine,SG,21,MIN,47,47,1749,326,710,.459,120,310,.387,206,400,.515,.544,117,140,.836,19,141,160,139,41,10,85,104,889,16
Ty Lawson,PG,29,SAC,69,24,1732,237,522,.454,34,118,.288,203,404,.502,.487,173,217,.797,44,135,179,334,74,6,129,119,681,16
Jake Layman,SF,22,POR,35,1,249,26,89,.292,13,51,.255,13,38,.342,.365,13,17,.765,6,18,24,11,9,3,11,22,78,16
Courtney Lee,SG,31,NYK,77,74,2459,321,704,.456,108,269,.401,213,435,.490,.533,85,98,.867,53,206,259,179,81,24,69,141,835,16
David Lee,PF,33,SAS,79,10,1477,248,420,.590,0,0,0,248,420,.590,.590,80,113,.708,149,292,441,124,31,40,82,125,576,16
Alex Len,C,23,PHO,77,34,1560,230,463,.497,3,12,.250,227,451,.503,.500,150,208,.721,156,354,510,44,38,98,102,242,613,16
Kawhi Leonard,SF,25,SAS,74,74,2474,636,1312,.485,147,387,.380,489,925,.529,.541,469,533,.880,80,350,430,260,133,55,154,122,1888,16
Meyers Leonard,PF,24,POR,74,12,1222,146,378,.386,74,213,.347,72,165,.436,.484,35,40,.875,27,210,237,71,13,28,35,172,401,16
Jon Leuer,PF,27,DET,75,34,1944,310,646,.480,49,167,.293,261,479,.545,.518,98,113,.867,102,300,402,111,31,26,66,145,767,16
Caris LeVert,SF,22,BRK,57,26,1237,171,380,.450,59,184,.321,112,196,.571,.528,67,93,.720,23,165,188,110,49,8,59,91,468,16
DeAndre Liggins,SG,28,TOT,62,19,777,55,142,.387,17,46,.370,38,96,.396,.447,25,40,.625,20,88,108,54,47,14,42,81,152,16
Damian Lillard,PG,26,POR,75,75,2694,661,1488,.444,214,579,.370,447,909,.492,.516,488,545,.895,46,322,368,440,68,20,197,152,2024,16
Jeremy Lin,PG,28,BRK,36,33,883,175,400,.438,58,156,.372,117,244,.480,.510,115,141,.816,11,124,135,184,42,14,86,79,523,16
Shaun Livingston,PG,31,GSW,76,3,1345,173,316,.547,1,3,.333,172,313,.550,.549,42,60,.700,28,123,151,139,38,20,62,120,389,16
Shawn Long,C,24,PHI,18,0,234,61,109,.560,7,19,.368,54,90,.600,.592,19,35,.543,41,44,85,13,9,9,13,49,148,16
Kevon Looney,C,20,GSW,53,4,447,56,107,.523,2,9,.222,54,98,.551,.533,21,34,.618,44,80,124,29,15,17,17,64,135,16
Brook Lopez,C,28,BRK,75,75,2222,555,1172,.474,134,387,.346,421,785,.536,.531,295,364,.810,121,282,403,176,38,124,184,192,1539,16
Robin Lopez,C,28,CHI,81,81,2271,382,775,.493,0,2,0,382,773,.494,.493,75,104,.721,244,276,520,80,18,117,91,151,839,16
Kevin Love,PF,28,CLE,60,60,1885,370,867,.427,145,389,.373,225,478,.471,.510,257,295,.871,148,518,666,116,53,21,122,125,1142,16
Kyle Lowry,PG,30,TOR,60,60,2244,426,918,.464,193,468,.412,233,450,.518,.569,299,365,.819,48,238,286,417,88,19,173,170,1344,16
John Lucas III,PG,34,MIN,5,0,11,1,4,.250,0,1,0,1,3,.333,.250,0,0,0,0,0,0,1,2,0,0,0,2,16
Timothé Luwawu-Cabarrot,SF,21,PHI,69,19,1190,145,361,.402,50,161,.311,95,200,.475,.471,105,123,.854,25,124,149,75,32,10,73,154,445,16
Trey Lyles,PF,21,UTA,71,4,1158,159,439,.362,65,204,.319,94,235,.400,.436,57,79,.722,48,187,235,69,26,20,64,97,440,16
Sheldon Mac,SG,24,WAS,30,3,287,30,75,.400,7,30,.233,23,45,.511,.447,23,27,.852,4,30,34,15,8,2,5,17,90,16
Shelvin Mack,PG,26,UTA,55,9,1205,170,381,.446,37,120,.308,133,261,.510,.495,53,77,.688,20,105,125,154,42,3,90,100,430,16
Ian Mahinmi,C,30,WAS,31,0,555,65,111,.586,0,0,0,65,111,.586,.586,43,75,.573,47,103,150,19,33,24,34,90,173,16
Thon Maker,C,19,MIL,57,34,562,83,181,.459,28,74,.378,55,107,.514,.536,32,49,.653,40,74,114,23,10,26,17,84,226,16
Boban Marjanović,C,28,DET,35,0,293,72,132,.545,0,0,0,72,132,.545,.545,47,58,.810,46,84,130,9,6,12,10,25,191,16
Jarell Martin,PF,22,MEM,42,3,558,58,151,.384,9,25,.360,49,126,.389,.414,40,50,.800,42,120,162,8,17,9,28,91,165,16
Wesley Matthews,SG,30,DAL,73,73,2495,333,847,.393,174,479,.363,159,368,.432,.496,146,179,.816,18,241,259,210,77,15,102,161,986,16
Luc Mbah a Moute,SF,30,LAC,80,76,1787,191,378,.505,43,110,.391,148,268,.552,.562,59,87,.678,44,126,170,39,81,35,46,122,484,16
James Michael McAdoo,PF,24,GSW,52,2,457,62,117,.530,2,8,.250,60,109,.550,.538,21,42,.500,34,57,91,18,18,29,19,47,147,16
Patrick McCaw,SG,21,GSW,71,20,1074,106,245,.433,41,123,.333,65,122,.533,.516,29,37,.784,21,79,100,77,32,15,36,62,282,16
CJ McCollum,SG,25,POR,80,80,2796,692,1441,.480,185,439,.421,507,1002,.506,.544,268,294,.912,60,229,289,285,72,42,172,202,1837,16
T.J. McConnell,PG,24,PHI,81,51,2133,236,512,.461,11,55,.200,225,457,.492,.472,73,90,.811,39,212,251,534,134,10,159,139,556,16
Chris McCullough,PF,21,TOT,16,0,80,16,32,.500,1,7,.143,15,25,.600,.516,3,5,.600,9,10,19,2,2,2,3,7,36,16
K.J. McDaniels,SF,23,TOT,49,0,505,77,169,.456,20,66,.303,57,103,.553,.515,32,38,.842,15,67,82,13,19,18,29,49,206,16
Doug McDermott,SF,25,TOT,66,5,1508,222,497,.447,77,208,.370,145,289,.502,.524,71,84,.845,20,159,179,58,13,5,38,79,592,16
JaVale McGee,C,29,GSW,77,10,739,208,319,.652,0,3,0,208,316,.658,.652,56,111,.505,100,144,244,17,19,67,40,109,472,16
Rodney McGruder,SG,25,MIA,78,65,1966,190,460,.413,73,220,.332,117,240,.488,.492,44,71,.620,94,162,256,124,46,18,56,140,497,16
Ben McLemore,SG,23,SAC,61,26,1176,180,419,.430,65,170,.382,115,249,.462,.507,70,93,.753,19,110,129,51,29,6,62,108,495,16
Jordan McRae,SG,25,CLE,37,4,384,58,150,.387,18,51,.353,40,99,.404,.447,27,34,.794,6,35,41,19,8,6,14,31,161,16
Josh McRoberts,PF,29,MIA,22,14,381,44,118,.373,13,31,.419,31,87,.356,.428,6,9,.667,23,51,74,50,10,4,23,31,107,16
Jodie Meeks,SG,29,ORL,36,10,738,103,256,.402,56,137,.409,47,119,.395,.512,65,74,.878,5,72,77,45,34,4,36,41,327,16
Salah Mejri,C,30,DAL,73,11,905,88,137,.642,1,3,.333,87,134,.649,.646,36,61,.590,97,211,308,14,32,61,40,152,213,16
Jordan Mickey,PF,22,BOS,25,1,141,15,34,.441,0,1,0,15,33,.455,.441,8,14,.571,13,21,34,7,3,6,9,12,38,16
Khris Middleton,SF,25,MIL,29,23,889,150,333,.450,45,104,.433,105,229,.459,.518,81,92,.880,11,112,123,99,41,7,65,79,426,16
C.J. Miles,SF,29,IND,76,29,1776,281,647,.434,169,409,.413,112,238,.471,.565,84,93,.903,30,199,229,48,46,25,40,151,815,16
Mike Miller,SF,36,DEN,20,0,151,9,23,.391,8,20,.400,1,3,.333,.565,2,2,1.000,2,36,38,22,2,0,13,9,28,16
Patty Mills,PG,28,SAS,80,8,1754,273,621,.440,147,355,.414,126,266,.474,.558,66,80,.825,24,117,141,280,65,3,101,109,759,16
Elijah Millsap,SG,29,PHO,2,0,23,1,7,.143,0,2,0,1,5,.200,.143,1,2,.500,3,3,6,1,0,0,2,2,3,16
Paul Millsap,PF,31,ATL,69,67,2343,430,972,.442,75,241,.311,355,731,.486,.481,311,405,.768,111,422,533,252,90,62,158,186,1246,16
Nikola Mirotić,PF,25,CHI,70,15,1679,258,625,.413,129,377,.342,129,248,.520,.516,99,128,.773,61,323,384,75,53,55,80,128,744,16
Greg Monroe,C,26,MIL,81,0,1823,387,726,.533,0,4,0,387,722,.536,.533,177,239,.741,167,365,532,187,92,38,140,168,951,16
E'Twaun Moore,SG,27,NOP,73,22,1820,283,619,.457,77,208,.370,206,411,.501,.519,57,74,.770,33,119,152,164,50,32,62,131,700,16
Marcus Morris,SF,27,DET,79,79,2565,421,1007,.418,118,357,.331,303,650,.466,.477,145,185,.784,77,289,366,160,52,25,87,168,1105,16
Markieff Morris,PF,27,WAS,76,76,2374,406,889,.457,71,196,.362,335,693,.483,.497,180,215,.837,107,386,493,126,82,42,129,254,1063,16
Anthony Morrow,SG,31,TOT,49,7,714,98,252,.389,41,133,.308,57,119,.479,.470,34,37,.919,12,19,31,25,24,2,6,44,271,16
Donatas Motiejūnas,PF,26,NOP,34,0,479,57,138,.413,11,47,.234,46,91,.505,.453,25,49,.510,26,75,101,32,18,11,31,55,150,16
Timofey Mozgov,C,30,LAL,54,52,1104,169,328,.515,0,1,0,169,327,.517,.515,63,78,.808,104,160,264,43,16,31,72,133,401,16
Emmanuel Mudiay,PG,20,DEN,55,41,1406,208,551,.377,56,178,.315,152,373,.408,.428,131,167,.784,29,149,178,217,41,13,123,95,603,16
Shabazz Muhammad,SF,24,MIN,78,1,1516,288,598,.482,49,145,.338,239,453,.528,.523,147,190,.774,84,136,220,35,22,6,56,86,772,16
Dejounte Murray,PG,20,SAS,38,8,322,50,116,.431,9,23,.391,41,93,.441,.470,21,30,.700,6,36,42,48,8,6,38,29,130,16
Jamal Murray,SG,19,DEN,82,10,1764,295,730,.404,115,344,.334,180,386,.466,.483,106,120,.883,41,173,214,170,51,24,113,124,811,16
Mike Muscala,C,25,ATL,70,3,1237,170,337,.504,46,110,.418,124,227,.546,.573,49,64,.766,76,164,240,95,30,41,55,97,435,16
Larry Nance Jr.,PF,24,LAL,63,7,1442,190,361,.526,10,36,.278,180,325,.554,.540,59,80,.738,120,249,369,96,82,39,56,149,449,16
Shabazz Napier,PG,25,POR,53,2,512,73,183,.399,34,92,.370,39,91,.429,.492,38,49,.776,8,53,61,67,32,2,41,38,218,16
Maurice Ndour,PF,24,NYK,32,4,331,39,86,.453,1,7,.143,38,79,.481,.459,19,26,.731,22,42,64,8,15,8,12,30,98,16
Gary Neal,SG,32,ATL,2,0,18,0,7,0,0,2,0,0,5,0,0,4,4,1.000,0,1,1,1,0,0,0,1,4,16
Jameer Nelson,PG,34,DEN,75,39,2045,268,604,.444,106,273,.388,162,331,.489,.531,45,63,.714,28,164,192,385,54,8,128,197,687,16
Raul Neto,PG,24,UTA,40,0,346,41,91,.451,10,31,.323,31,60,.517,.505,8,9,.889,4,26,30,34,21,5,15,48,100,16
Georges Niang,PF,23,IND,23,0,93,9,36,.250,1,12,.083,8,24,.333,.264,2,2,1.000,2,15,17,5,3,0,5,6,21,16
Andrew Nicholson,PF,27,TOT,38,0,342,43,111,.387,5,27,.185,38,84,.452,.410,9,14,.643,15,46,61,10,16,6,17,55,100,16
Joakim Noah,C,31,NYK,46,46,1015,99,202,.490,0,1,0,99,201,.493,.490,34,78,.436,162,241,403,103,30,37,58,127,232,16
Nerlens Noel,C,22,TOT,51,19,1047,184,309,.595,0,1,0,184,308,.597,.595,77,111,.694,93,201,294,50,65,50,51,126,445,16
Lucas Nogueira,C,24,TOR,57,6,1088,103,156,.660,3,12,.250,100,144,.694,.670,44,67,.657,82,162,244,42,52,89,46,137,253,16
Steve Novak,PF,33,MIL,8,0,22,2,7,.286,1,6,.167,1,1,1.000,.357,0,0,0,0,3,3,0,0,0,0,1,5,16
Dirk Nowitzki,PF,38,DAL,54,54,1424,296,678,.437,79,209,.378,217,469,.463,.495,98,112,.875,23,330,353,82,30,38,51,113,769,16
Jusuf Nurkić,C,22,TOT,65,48,1391,271,534,.507,0,1,0,271,533,.508,.507,120,210,.571,154,313,467,123,50,74,143,161,662,16
David Nwaba,SG,24,LAL,20,2,397,47,81,.580,1,5,.200,46,76,.605,.586,25,39,.641,17,46,63,14,13,7,11,36,120,16
Johnny O'Bryant,PF,23,TOT,11,0,80,15,30,.500,3,6,.500,12,24,.500,.550,5,6,.833,9,10,19,6,0,1,6,10,38,16
Kyle O'Quinn,C,26,NYK,79,8,1229,215,413,.521,2,17,.118,213,396,.538,.523,64,83,.771,157,282,439,117,36,104,76,174,496,16
Daniel Ochefu,C,23,WAS,19,0,75,12,27,.444,0,0,0,12,27,.444,.444,0,2,0,5,17,22,3,2,0,3,17,24,16
Jahlil Okafor,C,21,PHI,50,33,1134,242,471,.514,0,0,0,242,471,.514,.514,106,158,.671,81,159,240,58,20,49,91,122,590,16
Victor Oladipo,SG,24,OKC,67,67,2222,412,932,.442,127,352,.361,285,580,.491,.510,116,154,.753,39,252,291,176,78,21,119,155,1067,16
Kelly Olynyk,C,25,BOS,75,6,1538,260,508,.512,68,192,.354,192,316,.608,.579,90,123,.732,73,288,361,148,43,29,96,207,678,16
Arinze Onuaku,C,29,ORL,8,0,28,2,4,.500,0,0,0,2,4,.500,.500,0,0,0,2,4,6,2,0,1,2,3,4,16
Chinanu Onuaku,C,20,HOU,5,1,52,5,7,.714,0,0,0,5,7,.714,.714,4,4,1.000,2,8,10,3,3,1,4,6,14,16
Kelly Oubre Jr.,SF,21,WAS,79,5,1605,186,442,.421,54,188,.287,132,254,.520,.482,75,99,.758,61,200,261,47,58,17,50,195,501,16
Zaza Pachulia,C,32,GSW,70,70,1268,164,307,.534,0,2,0,164,305,.538,.534,98,126,.778,140,270,410,132,59,33,87,166,426,16
Georgios Papagiannis,C,19,SAC,22,0,355,56,102,.549,0,2,0,56,100,.560,.549,12,14,.857,24,62,86,20,3,17,24,44,124,16
Jabari Parker,PF,21,MIL,51,50,1728,399,814,.490,65,178,.365,334,636,.525,.530,162,218,.743,79,235,314,142,50,22,93,111,1025,16
Tony Parker,PG,34,SAS,63,63,1587,265,569,.466,23,69,.333,242,500,.484,.486,85,117,.726,9,104,113,285,34,2,89,92,638,16
Chandler Parsons,SF,28,MEM,34,34,675,75,222,.338,25,93,.269,50,129,.388,.394,35,43,.814,6,78,84,55,20,5,24,52,210,16
Lamar Patterson,SG,25,ATL,5,0,40,3,15,.200,1,6,.167,2,9,.222,.233,2,3,.667,1,6,7,6,1,0,4,6,9,16
Patrick Patterson,PF,27,TOR,65,8,1599,154,384,.401,94,253,.372,60,131,.458,.523,43,60,.717,62,231,293,76,40,23,38,120,445,16
Chris Paul,PG,31,LAC,61,61,1921,374,785,.476,124,302,.411,250,483,.518,.555,232,260,.892,40,264,304,563,119,8,147,146,1104,16
Adreian Payne,PF,25,MIN,18,0,135,23,54,.426,3,15,.200,20,39,.513,.454,14,19,.737,9,24,33,7,8,7,8,32,63,16
Cameron Payne,PG,22,TOT,31,0,462,64,193,.332,27,86,.314,37,107,.346,.402,5,8,.625,3,45,48,55,14,4,29,52,160,16
Elfrid Payton,PG,22,ORL,82,58,2412,430,912,.471,40,146,.274,390,766,.509,.493,146,211,.692,89,298,387,529,88,40,178,177,1046,16
Gary Payton II,PG,24,MIL,6,0,99,8,22,.364,1,9,.111,7,13,.538,.386,3,5,.600,0,12,12,13,3,4,10,9,20,16
Paul Pierce,SF,39,LAC,25,7,277,28,70,.400,15,43,.349,13,27,.481,.507,10,13,.769,1,47,48,10,4,5,16,40,81,16
Marshall Plumlee,C,24,NYK,21,1,170,16,30,.533,0,0,0,16,30,.533,.533,8,19,.421,23,28,51,10,4,4,12,23,40,16
Mason Plumlee,C,26,TOT,81,64,2148,334,623,.536,0,6,0,334,617,.541,.536,174,300,.580,170,435,605,284,69,92,134,226,842,16
Miles Plumlee,C,28,TOT,45,12,484,44,92,.478,0,0,0,44,92,.478,.478,25,39,.641,38,57,95,21,18,13,30,73,113,16
Jakob Poeltl,C,21,TOR,54,4,626,67,115,.583,0,0,0,67,115,.583,.583,31,57,.544,78,87,165,12,17,20,29,113,165,16
Otto Porter Jr.,SF,23,WAS,80,80,2605,414,803,.516,148,341,.434,266,462,.576,.608,99,119,.832,118,396,514,121,116,42,44,193,1075,16
Bobby Portis,PF,21,CHI,64,13,1000,183,375,.488,32,96,.333,151,279,.541,.531,39,59,.661,75,221,296,35,16,11,37,94,437,16
Kristaps Porziņģis,PF,21,NYK,66,65,2164,443,985,.450,112,314,.357,331,671,.493,.507,198,252,.786,111,364,475,97,47,129,118,244,1196,16
Dwight Powell,C,25,DAL,77,3,1333,194,377,.515,21,74,.284,173,303,.571,.542,107,141,.759,93,213,306,49,61,39,34,135,516,16
Norman Powell,SG,23,TOR,76,18,1368,227,506,.449,56,173,.324,171,333,.514,.504,126,159,.792,26,143,169,82,52,14,70,127,636,16
Alex Poythress,PF,23,PHI,6,1,157,25,54,.463,6,19,.316,19,35,.543,.519,8,10,.800,11,18,29,5,3,2,3,14,64,16
Ronnie Price,PG,33,PHO,14,0,134,4,24,.167,3,17,.176,1,7,.143,.229,3,4,.750,3,8,11,18,11,1,3,14,14,16
Taurean Prince,SF,22,ATL,59,10,981,114,285,.400,33,102,.324,81,183,.443,.458,74,94,.787,25,132,157,55,43,27,61,96,335,16
Tim Quarterman,SG,22,POR,16,0,80,13,29,.448,5,13,.385,8,16,.500,.534,0,3,0,4,10,14,11,2,3,11,6,31,16
Chasson Randle,PG,23,TOT,26,0,299,40,98,.408,16,47,.340,24,51,.471,.490,41,43,.953,6,26,32,34,9,2,19,39,137,16
Julius Randle,PF,22,LAL,74,73,2132,377,773,.488,17,63,.270,360,710,.507,.499,204,282,.723,150,486,636,264,49,37,173,248,975,16
Zach Randolph,PF,35,MEM,73,5,1786,433,964,.449,21,94,.223,412,870,.474,.460,141,193,.731,182,416,598,122,38,10,99,136,1028,16
J.J. Redick,SG,32,LAC,78,78,2198,396,890,.445,201,468,.429,195,422,.462,.558,180,202,.891,11,160,171,110,54,13,98,125,1173,16
Willie Reed,C,26,MIA,71,5,1031,162,285,.568,1,4,.250,161,281,.573,.570,49,88,.557,129,203,332,26,18,47,31,137,374,16
Josh Richardson,SG,23,MIA,53,34,1614,202,513,.394,75,227,.330,127,286,.444,.467,60,77,.779,35,133,168,140,60,39,65,132,539,16
Malachi Richardson,SG,21,SAC,22,0,198,28,68,.412,8,28,.286,20,40,.500,.471,15,19,.789,3,20,23,11,5,1,8,23,79,16
Austin Rivers,SG,24,LAC,74,29,2054,323,731,.442,111,299,.371,212,432,.491,.518,132,191,.691,20,141,161,204,48,10,115,187,889,16
Andre Roberson,SF,25,OKC,79,79,2376,215,463,.464,45,184,.245,170,279,.609,.513,47,111,.423,98,305,403,79,94,79,51,204,522,16
Brian Roberts,PG,31,CHO,41,2,416,46,122,.377,17,44,.386,29,78,.372,.447,33,39,.846,5,34,39,52,9,1,26,18,142,16
Glenn Robinson III,SF,23,IND,69,27,1427,158,338,.467,49,125,.392,109,213,.512,.540,54,76,.711,57,189,246,47,41,20,37,63,419,16
Thomas Robinson,PF,25,LAL,48,1,560,105,196,.536,0,1,0,105,195,.538,.536,31,66,.470,84,139,223,31,26,9,46,76,241,16
Sergio Rodríguez,PG,30,PHI,68,30,1518,210,536,.392,92,252,.365,118,284,.415,.478,18,27,.667,21,136,157,344,49,4,128,95,530,16
Rajon Rondo,PG,30,CHI,69,42,1843,229,561,.408,50,133,.376,179,428,.418,.453,30,50,.600,73,282,355,461,99,11,169,144,538,16
Derrick Rose,PG,28,NYK,64,64,2082,460,977,.471,13,60,.217,447,917,.487,.477,221,253,.874,66,180,246,283,44,17,147,84,1154,16
Terrence Ross,SF,25,TOT,78,24,1955,326,746,.437,142,391,.363,184,355,.518,.532,64,77,.831,18,188,206,88,87,33,68,143,858,16
Terry Rozier,PG,22,BOS,74,0,1263,151,411,.367,57,179,.318,94,232,.405,.437,51,66,.773,40,187,227,131,46,11,47,69,410,16
Ricky Rubio,PG,26,MIN,75,75,2469,261,650,.402,60,196,.306,201,454,.443,.448,254,285,.891,68,237,305,682,128,10,195,202,836,16
Damjan Rudež,SF,30,ORL,45,0,314,31,88,.352,20,64,.313,11,24,.458,.466,0,0,0,5,20,25,20,12,1,9,31,82,16
Brandon Rush,SG,31,MIN,47,33,1030,70,187,.374,44,114,.386,26,73,.356,.492,13,18,.722,16,83,99,45,22,23,28,42,197,16
D'Angelo Russell,PG,20,LAL,63,60,1811,351,867,.405,135,384,.352,216,483,.447,.483,147,188,.782,31,190,221,303,87,16,176,130,984,16
Domantas Sabonis,PF,20,OKC,81,66,1632,192,481,.399,51,159,.321,141,322,.438,.452,44,67,.657,46,242,288,82,39,32,83,200,479,16
Larry Sanders,C,28,CLE,5,0,13,1,4,.250,0,0,0,1,4,.250,.250,2,2,1.000,3,1,4,0,1,1,2,5,4,16
Dario Šarić,PF,22,PHI,81,36,2129,381,927,.411,106,341,.311,275,586,.469,.468,172,220,.782,112,401,513,182,57,30,183,162,1040,16
Tomáš Satoranský,SG,25,WAS,57,3,719,61,147,.415,9,37,.243,52,110,.473,.446,23,33,.697,25,58,83,92,26,6,38,60,154,16
Dennis Schröder,PG,23,ATL,79,78,2485,548,1214,.451,100,294,.340,448,920,.487,.493,218,255,.855,42,206,248,499,74,16,258,149,1414,16
Luis Scola,PF,36,BRK,36,1,461,71,151,.470,17,50,.340,54,101,.535,.526,25,37,.676,51,88,139,37,14,4,34,63,184,16
Mike Scott,PF,28,ATL,18,0,195,17,59,.288,4,27,.148,13,32,.406,.322,7,8,.875,10,27,37,17,4,3,8,12,45,16
Thabo Sefolosha,SF,32,ATL,62,42,1596,174,395,.441,41,120,.342,133,275,.484,.492,55,75,.733,54,216,270,107,96,31,58,97,444,16
Wayne Selden,SG,22,TOT,14,5,236,25,58,.431,7,28,.250,18,30,.600,.491,14,22,.636,1,15,16,13,6,1,12,18,71,16
Kevin Séraphin,PF,27,IND,49,3,559,109,198,.551,0,2,0,109,196,.556,.551,14,22,.636,41,101,142,23,7,20,29,66,232,16
Ramon Sessions,PG,30,CHO,50,1,811,100,263,.380,21,62,.339,79,201,.393,.420,91,118,.771,11,62,73,129,27,3,46,43,312,16
Iman Shumpert,SG,26,CLE,76,31,1937,201,489,.411,94,261,.360,107,228,.469,.507,71,90,.789,39,179,218,109,62,27,78,150,567,16
Pascal Siakam,PF,22,TOR,55,38,859,103,205,.502,1,7,.143,102,198,.515,.505,22,32,.688,64,121,185,17,26,45,33,109,229,16
Jonathon Simmons,SG,27,SAS,78,8,1392,177,421,.420,30,102,.294,147,319,.461,.456,99,132,.750,20,140,160,126,47,25,76,146,483,16
Kyle Singler,SF,28,OKC,32,2,385,34,83,.410,7,37,.189,27,46,.587,.452,13,17,.765,8,40,48,9,7,5,11,29,88,16
Marcus Smart,SG,22,BOS,79,24,2399,269,749,.359,94,332,.283,175,417,.420,.422,203,250,.812,78,227,305,364,125,34,159,192,835,16
Ish Smith,PG,28,DET,81,32,1955,329,749,.439,28,105,.267,301,644,.467,.458,72,102,.706,21,214,235,418,61,33,112,127,758,16
J.R. Smith,SG,31,CLE,41,35,1187,123,356,.346,95,271,.351,28,85,.329,.479,10,15,.667,17,96,113,62,40,11,26,77,351,16
Jason Smith,C,30,WAS,74,3,1068,174,329,.529,37,78,.474,137,251,.546,.585,35,51,.686,64,194,258,37,21,54,58,168,420,16
Tony Snell,SG,25,MIL,80,80,2336,246,541,.455,144,355,.406,102,186,.548,.588,47,58,.810,22,226,248,96,55,14,55,125,683,16
Marreese Speights,C,29,LAC,82,2,1286,244,548,.445,103,277,.372,141,271,.520,.539,120,137,.876,88,285,373,65,23,41,69,229,711,16
Tiago Splitter,C,32,PHI,8,0,76,14,31,.452,2,6,.333,12,25,.480,.484,9,11,.818,8,14,22,4,1,1,6,8,39,16
Nik Stauskas,SG,23,PHI,80,27,2188,251,634,.396,132,359,.368,119,275,.433,.500,122,150,.813,21,205,226,188,45,32,128,144,756,16
Lance Stephenson,SG,26,TOT,18,0,361,54,120,.450,6,20,.300,48,100,.480,.475,8,13,.615,4,48,52,59,5,3,26,32,122,16
Jarnell Stokes,C,23,DEN,2,0,7,1,1,1.000,0,0,0,1,1,1.000,1.000,1,2,.500,1,1,2,2,1,0,0,3,3,16
Diamond Stone,C,19,LAC,7,0,24,3,13,.231,0,0,0,3,13,.231,.231,4,4,1.000,1,5,6,0,0,1,2,5,10,16
Rodney Stuckey,PG,30,IND,39,0,696,91,244,.373,19,60,.317,72,184,.391,.412,80,107,.748,6,78,84,84,16,0,53,44,281,16
Jared Sullinger,PF,24,TOR,11,1,118,15,47,.319,3,18,.167,12,29,.414,.351,4,8,.500,10,17,27,3,4,1,4,17,37,16
Edy Tavares,C,24,TOT,2,0,28,4,5,.800,0,0,0,4,5,.800,.800,0,3,0,4,7,11,1,0,6,2,3,8,16
Isaiah Taylor,PG,22,HOU,4,0,52,1,7,.143,0,2,0,1,5,.200,.143,1,2,.500,1,2,3,3,1,1,0,6,3,16
Jeff Teague,PG,28,IND,82,82,2657,402,909,.442,90,252,.357,312,657,.475,.492,360,415,.867,33,297,330,639,100,32,216,165,1254,16
Mirza Teletović,PF,31,MIL,70,2,1133,156,418,.373,104,305,.341,52,113,.460,.498,35,45,.778,11,151,162,48,12,13,37,109,451,16
Garrett Temple,SG,30,SAC,65,21,1728,183,432,.424,82,220,.373,101,212,.476,.519,58,74,.784,32,152,184,168,84,28,78,141,506,16
Jason Terry,SG,39,MIL,74,0,1365,105,243,.432,73,171,.427,32,72,.444,.582,24,29,.828,15,91,106,98,46,20,36,95,307,16
Isaiah Thomas,PG,27,BOS,76,76,2569,682,1473,.463,245,646,.379,437,827,.528,.546,590,649,.909,43,162,205,448,70,13,210,167,2199,16
Lance Thomas,PF,28,NYK,46,15,968,97,244,.398,38,85,.447,59,159,.371,.475,43,51,.843,32,110,142,35,21,5,25,85,275,16
Hollis Thompson,SG,25,TOT,40,9,752,77,200,.385,32,95,.337,45,105,.429,.465,19,29,.655,19,93,112,35,20,6,11,69,205,16
Klay Thompson,SG,26,GSW,78,78,2649,644,1376,.468,268,647,.414,376,729,.516,.565,186,218,.853,49,236,285,160,66,40,128,139,1742,16
Tristan Thompson,C,25,CLE,78,78,2336,262,437,.600,0,3,0,262,434,.604,.600,106,213,.498,286,429,715,77,39,84,64,176,630,16
Marcus Thornton,SG,29,WAS,33,1,575,84,210,.400,28,80,.350,56,130,.431,.467,23,27,.852,22,54,76,41,19,3,25,48,219,16
Mike Tobey,C,22,CHO,2,0,25,1,4,.250,0,0,0,1,4,.250,.250,0,0,0,2,1,3,1,0,0,1,2,2,16
Anthony Tolliver,PF,31,SAC,65,9,1477,155,351,.442,90,230,.391,65,121,.537,.570,61,82,.744,51,186,237,77,34,20,56,109,461,16
Axel Toupane,SF,24,TOT,4,0,47,5,9,.556,1,4,.250,4,5,.800,.611,0,0,0,0,1,1,0,1,1,0,6,11,16
Karl-Anthony Towns,C,21,MIN,82,82,3030,802,1480,.542,101,275,.367,701,1205,.582,.576,356,428,.832,296,711,1007,220,56,103,212,241,2061,16
P.J. Tucker,SF,31,TOT,81,21,2236,199,482,.413,70,196,.357,129,286,.451,.485,72,93,.774,117,354,471,99,116,19,66,196,540,16
Evan Turner,SF,28,POR,65,12,1658,235,552,.426,31,118,.263,204,434,.470,.454,85,103,.825,36,211,247,205,53,24,100,121,586,16
Myles Turner,C,20,IND,81,81,2541,444,869,.511,40,115,.348,404,754,.536,.534,245,303,.809,139,450,589,106,74,172,105,262,1173,16
Beno Udrih,PG,34,DET,39,0,560,92,197,.467,11,32,.344,81,165,.491,.495,32,34,.941,6,51,57,131,13,0,36,29,227,16
Tyler Ulis,PG,21,PHO,61,15,1123,184,437,.421,21,79,.266,163,358,.455,.445,55,71,.775,20,75,95,226,48,5,77,73,444,16
Jarrod Uthoff,PF,23,DAL,9,0,115,16,38,.421,3,9,.333,13,29,.448,.461,5,7,.714,8,14,22,9,2,4,3,8,40,16
Jonas Valančiūnas,C,24,TOR,80,80,2066,391,702,.557,1,2,.500,390,700,.557,.558,176,217,.811,226,533,759,57,37,63,106,216,959,16
Denzel Valentine,SG,23,CHI,57,0,976,102,288,.354,73,208,.351,29,80,.363,.481,14,18,.778,11,140,151,63,30,7,49,86,291,16
Fred VanVleet,PG,22,TOR,37,0,294,39,111,.351,11,29,.379,28,82,.341,.401,18,22,.818,4,38,42,35,16,3,15,36,107,16
Anderson Varejão,C,34,GSW,14,1,92,5,14,.357,0,0,0,5,14,.357,.357,8,11,.727,12,15,27,10,3,3,8,16,18,16
Greivis Vásquez,PG,30,BRK,3,0,39,2,8,.250,1,3,.333,1,5,.200,.313,2,3,.667,0,2,2,5,1,1,1,6,7,16
Rashad Vaughn,SG,20,MIL,41,2,458,57,156,.365,26,81,.321,31,75,.413,.449,2,5,.400,4,45,49,23,19,10,14,32,142,16
Noah Vonleh,PF,21,POR,74,41,1265,130,270,.481,7,20,.350,123,250,.492,.494,60,94,.638,131,256,387,31,30,27,64,154,327,16
Nikola Vučević,C,26,ORL,75,55,2163,483,1031,.468,23,75,.307,460,956,.481,.480,107,160,.669,176,603,779,208,76,74,117,180,1096,16
Sasha Vujačić,SG,32,NYK,42,4,408,42,136,.309,23,74,.311,19,62,.306,.393,17,24,.708,12,47,59,52,13,2,16,38,124,16
Dwyane Wade,SG,35,CHI,60,59,1792,414,955,.434,45,145,.310,369,810,.456,.457,223,281,.794,63,207,270,228,86,41,138,112,1096,16
Dion Waiters,SG,25,MIA,46,43,1384,281,663,.424,85,215,.395,196,448,.438,.488,82,127,.646,18,135,153,200,42,20,103,95,729,16
Kemba Walker,PG,26,CHO,79,79,2739,643,1449,.444,240,602,.399,403,847,.476,.527,304,359,.847,45,263,308,434,85,22,168,119,1830,16
John Wall,PG,26,WAS,78,78,2836,647,1435,.451,89,272,.327,558,1163,.480,.482,422,527,.801,59,267,326,831,157,49,322,151,1805,16
T.J. Warren,SF,23,PHO,66,59,2048,403,814,.495,26,98,.265,377,716,.527,.511,119,154,.773,125,214,339,75,76,39,57,175,951,16
C.J. Watson,PG,32,ORL,62,9,1012,96,248,.387,32,105,.305,64,143,.448,.452,57,66,.864,16,73,89,114,43,2,47,84,281,16
Briante Weber,PG,24,TOT,20,0,205,25,60,.417,1,10,.100,24,50,.480,.425,11,16,.688,8,18,26,21,12,1,8,16,62,16
David West,C,36,GSW,68,0,854,135,252,.536,3,8,.375,132,244,.541,.542,43,56,.768,47,156,203,151,42,48,78,105,316,16
Russell Westbrook,PG,28,OKC,81,81,2802,824,1941,.425,200,583,.343,624,1358,.459,.476,710,840,.845,137,727,864,840,132,31,438,190,2558,16
Okaro White,PF,24,MIA,35,0,471,33,87,.379,12,34,.353,21,53,.396,.448,20,22,.909,25,57,82,21,10,10,18,52,98,16
Isaiah Whitehead,PG,21,BRK,73,26,1643,204,508,.402,44,149,.295,160,359,.446,.445,91,113,.805,32,152,184,192,42,36,142,175,543,16
Hassan Whiteside,C,27,MIA,77,77,2513,542,973,.557,0,0,0,542,973,.557,.557,225,358,.628,293,795,1088,57,57,161,154,226,1309,16
Andrew Wiggins,SF,21,MIN,82,82,3048,709,1570,.452,103,289,.356,606,1281,.473,.484,412,542,.760,102,226,328,189,82,30,187,183,1933,16
C.J. Wilcox,SG,26,ORL,22,0,108,8,31,.258,3,15,.200,5,16,.313,.306,2,2,1.000,4,8,12,12,2,1,6,8,21,16
Alan Williams,C,24,PHO,47,0,708,138,267,.517,0,1,0,138,266,.519,.517,70,112,.625,94,198,292,23,27,32,37,125,346,16
Deron Williams,PG,32,TOT,64,44,1657,263,600,.438,85,234,.363,178,366,.486,.509,90,109,.826,14,133,147,360,31,8,138,138,701,16
Derrick Williams,PF,25,TOT,50,11,804,108,244,.443,30,97,.309,78,147,.531,.504,58,89,.652,19,111,130,28,14,7,28,60,304,16
Lou Williams,SG,30,TOT,81,1,1994,428,998,.429,163,446,.365,265,552,.480,.511,402,457,.880,26,176,202,239,80,20,160,92,1421,16
Marvin Williams,PF,30,CHO,76,76,2295,297,704,.422,124,354,.350,173,350,.494,.510,131,150,.873,89,411,500,106,58,53,60,134,849,16
Reggie Williams,SF,30,NOP,6,0,79,8,23,.348,5,11,.455,3,12,.250,.457,6,7,.857,2,4,6,4,3,0,0,2,27,16
Troy Williams,SF,22,TOT,30,16,557,73,167,.437,18,62,.290,55,105,.524,.491,21,32,.656,15,54,69,25,27,10,32,60,185,16
Kyle Wiltjer,PF,24,HOU,14,0,44,4,14,.286,4,13,.308,0,1,0,.429,1,2,.500,4,6,10,2,3,1,5,4,13,16
Justise Winslow,SF,20,MIA,18,15,625,80,225,.356,7,35,.200,73,190,.384,.371,29,47,.617,23,71,94,66,26,6,33,52,196,16
Jeff Withey,C,26,UTA,51,1,432,55,103,.534,0,1,0,55,102,.539,.534,36,48,.750,52,69,121,7,16,32,14,52,146,16
Christian Wood,PF,21,CHO,13,0,107,12,23,.522,0,5,0,12,18,.667,.522,11,15,.733,14,15,29,2,3,6,7,11,35,16
Metta World Peace,SF,37,LAL,25,2,160,19,68,.279,9,38,.237,10,30,.333,.346,10,16,.625,5,15,20,11,10,2,7,18,57,16
Brandan Wright,PF,29,MEM,28,5,447,83,135,.615,0,1,0,83,134,.619,.615,23,35,.657,31,47,78,15,11,20,10,42,189,16
Delon Wright,PG,24,TOR,27,0,446,49,116,.422,10,30,.333,39,86,.453,.466,42,55,.764,16,32,48,57,27,11,25,31,150,16
James Young,SG,21,BOS,29,0,220,25,58,.431,12,35,.343,13,23,.565,.534,6,9,.667,6,20,26,4,10,2,4,15,68,16
Joe Young,PG,24,IND,33,0,135,26,72,.361,5,23,.217,21,49,.429,.396,11,15,.733,1,16,17,15,4,0,5,5,68,16
Nick Young,SG,31,LAL,60,60,1556,272,633,.430,170,421,.404,102,212,.481,.564,77,90,.856,25,113,138,58,37,14,36,137,791,16
Thaddeus Young,PF,28,IND,74,74,2237,362,687,.527,45,118,.381,317,569,.557,.560,45,86,.523,131,317,448,122,113,29,95,135,814,16
Cody Zeller,C,24,CHO,62,58,1725,253,443,.571,0,1,0,253,442,.572,.571,133,196,.679,135,270,405,99,62,58,65,189,639,16
Tyler Zeller,C,27,BOS,51,5,525,78,158,.494,0,1,0,78,157,.497,.494,22,39,.564,43,81,124,42,7,21,20,61,178,16
Stephen Zimmerman,C,20,ORL,19,0,108,10,31,.323,0,0,0,10,31,.323,.323,3,5,.600,11,24,35,4,2,5,3,17,23,16
Paul Zipser,SF,22,CHI,44,18,843,88,221,.398,33,99,.333,55,122,.451,.473,31,40,.775,15,110,125,36,15,16,40,78,240,16
Ivica Zubac,C,19,LAL,38,11,609,126,238,.529,0,3,0,126,235,.536,.529,32,49,.653,41,118,159,30,14,33,30,66,284,16
Álex Abrines,SG,24,OKC,75,8,1134,115,291,.395,84,221,.380,31,70,.443,.540,39,46,.848,26,88,114,28,38,8,25,124,353,17
Quincy Acy,PF,27,BRK,70,8,1359,130,365,.356,102,292,.349,28,73,.384,.496,49,60,.817,40,217,257,57,33,29,60,149,411,17
Steven Adams,C,24,OKC,76,76,2487,448,712,.629,0,2,0,448,710,.631,.629,160,286,.559,384,301,685,88,92,78,128,215,1056,17
Bam Adebayo,C,20,MIA,69,19,1368,174,340,.512,0,7,0,174,333,.523,.512,129,179,.721,118,263,381,101,32,41,66,138,477,17
Arron Afflalo,SG,32,ORL,53,3,682,65,162,.401,27,70,.386,38,92,.413,.485,22,26,.846,4,62,66,30,4,9,21,56,179,17
Cole Aldrich,C,29,MIN,21,0,49,5,15,.333,0,0,0,5,15,.333,.333,2,6,.333,3,12,15,3,2,1,1,11,12,17
LaMarcus Aldridge,C,32,SAS,75,75,2509,687,1347,.510,27,92,.293,660,1255,.526,.520,334,399,.837,246,389,635,152,43,90,111,161,1735,17
Jarrett Allen,C,19,BRK,72,31,1441,234,397,.589,5,15,.333,229,382,.599,.596,114,147,.776,144,244,388,49,28,88,82,147,587,17
Kadeem Allen,PG,25,BOS,18,1,107,6,22,.273,0,11,0,6,11,.545,.273,7,9,.778,4,7,11,12,3,2,9,15,19,17
Tony Allen,SF,36,NOP,22,0,273,44,91,.484,4,12,.333,40,79,.506,.505,11,21,.524,20,27,47,9,11,3,19,49,103,17
Al-Farouq Aminu,PF,27,POR,69,67,2072,230,582,.395,125,339,.369,105,243,.432,.503,59,80,.738,97,428,525,84,79,40,79,136,644,17
Justin Anderson,SF,24,PHI,38,0,519,87,202,.431,34,103,.330,53,99,.535,.515,28,38,.737,25,68,93,25,15,7,16,54,236,17
Kyle Anderson,SF,24,SAS,74,67,1978,231,438,.527,19,57,.333,212,381,.556,.549,104,146,.712,84,312,396,202,115,60,94,114,585,17
Ryan Anderson,PF,29,HOU,66,50,1725,207,480,.431,131,339,.386,76,141,.539,.568,72,93,.774,94,237,331,60,24,21,42,126,617,17
Ike Anigbogu,C,19,IND,11,0,30,4,9,.444,0,0,0,4,9,.444,.444,5,6,.833,5,4,9,0,1,3,2,1,13,17
Giannis Antetokounmpo,PF,23,MIL,75,75,2756,742,1402,.529,43,140,.307,699,1262,.554,.545,487,641,.760,156,597,753,361,109,106,223,231,2014,17
Carmelo Anthony,PF,33,OKC,78,78,2501,472,1168,.404,169,474,.357,303,694,.437,.476,148,193,.767,67,386,453,103,47,49,99,197,1261,17
OG Anunoby,SF,20,TOR,74,62,1481,163,346,.471,73,197,.371,90,149,.604,.577,39,62,.629,44,140,184,55,52,14,45,130,438,17
Ryan Arcidiacono,PG,23,CHI,24,0,304,17,41,.415,9,31,.290,8,10,.800,.524,5,6,.833,1,24,25,35,13,0,13,18,48,17
Trevor Ariza,SF,32,HOU,67,67,2269,268,651,.412,170,462,.368,98,189,.519,.542,76,89,.854,33,261,294,105,98,13,52,132,782,17
Darrell Arthur,PF,29,DEN,19,1,141,22,47,.468,8,23,.348,14,24,.583,.553,2,3,.667,3,12,15,9,8,3,15,22,54,17
Jamel Artis,SG,25,ORL,15,1,279,31,79,.392,8,29,.276,23,50,.460,.443,7,12,.583,4,34,38,18,2,3,8,11,77,17
Ömer Aşık,C,31,TOT,18,0,182,9,22,.409,0,0,0,9,22,.409,.409,4,13,.308,9,38,47,3,2,4,9,20,22,17
Ömer Aşık,C,31,NOP,14,0,121,7,16,.438,0,0,0,7,16,.438,.438,4,12,.333,7,30,37,2,1,2,5,14,18,17
Ömer Aşık,C,31,CHI,4,0,61,2,6,.333,0,0,0,2,6,.333,.333,0,1,0,2,8,10,1,1,2,4,6,4,17
D.J. Augustin,PG,30,ORL,75,36,1760,244,540,.452,114,272,.419,130,268,.485,.557,164,189,.868,30,130,160,287,54,0,123,94,766,17
Luke Babbitt,SF,28,TOT,50,14,715,91,215,.423,60,156,.385,31,59,.525,.563,17,22,.773,7,89,96,31,8,7,19,54,259,17
Luke Babbitt,SF,28,ATL,37,9,570,80,168,.476,49,111,.441,31,57,.544,.622,17,22,.773,5,76,81,26,7,5,15,47,226,17
Luke Babbitt,SF,28,MIA,13,5,145,11,47,.234,11,45,.244,0,2,0,.351,0,0,0,2,13,15,5,1,2,4,7,33,17
Dwayne Bacon,SG,22,CHO,53,6,713,72,192,.375,11,43,.256,61,149,.409,.404,20,25,.800,4,120,124,38,16,2,23,46,175,17
Ron Baker,SG,24,NYK,29,1,385,20,59,.339,11,33,.333,9,26,.346,.432,20,26,.769,5,25,30,47,26,6,18,33,71,17
Wade Baldwin,PG,21,POR,7,0,80,14,21,.667,4,5,.800,10,16,.625,.762,6,10,.600,1,7,8,5,2,1,4,12,38,17
Lonzo Ball,PG,20,LAL,52,50,1780,203,564,.360,90,295,.305,113,269,.420,.440,32,71,.451,69,291,360,376,88,43,136,117,528,17
J.J. Barea,PG,33,DAL,69,10,1603,303,690,.439,115,313,.367,188,377,.499,.522,80,102,.784,15,186,201,434,35,3,143,83,801,17
Harrison Barnes,PF,25,DAL,77,77,2634,537,1208,.445,119,333,.357,418,875,.478,.494,259,313,.827,77,391,468,152,49,14,118,94,1452,17
Will Barton,SG,27,DEN,81,40,2683,465,1028,.452,156,422,.370,309,606,.510,.528,182,226,.805,70,339,409,331,82,52,149,168,1268,17
Nicolas Batum,SG,29,CHO,64,64,1981,270,650,.415,92,274,.336,178,376,.473,.486,108,130,.831,57,249,306,349,65,23,131,72,740,17
Jerryd Bayless,SG,29,PHI,39,11,925,109,262,.416,54,146,.370,55,116,.474,.519,35,44,.795,15,65,80,54,23,6,46,91,307,17
Aron Baynes,C,31,BOS,81,67,1485,210,446,.471,3,21,.143,207,425,.487,.474,59,78,.756,130,304,434,93,22,51,80,200,482,17
Kent Bazemore,SG,28,ATL,65,65,1789,284,676,.420,108,274,.394,176,402,.438,.500,160,201,.796,25,223,248,228,100,45,157,147,836,17
Bradley Beal,SG,24,WAS,82,82,2977,683,1484,.460,199,530,.375,484,954,.507,.527,292,369,.791,61,302,363,373,96,36,214,160,1857,17
Malik Beasley,SG,21,DEN,62,0,583,73,178,.410,28,82,.341,45,96,.469,.489,22,33,.667,14,57,71,31,15,7,24,36,196,17
Michael Beasley,PF,29,NYK,74,30,1653,409,807,.507,34,86,.395,375,721,.520,.528,124,159,.780,97,317,414,123,36,43,143,145,976,17
Marco Belinelli,SG,31,TOT,80,2,1947,337,764,.441,149,395,.377,188,369,.509,.539,148,163,.908,20,131,151,148,66,12,94,91,971,17
Marco Belinelli,SG,31,ATL,52,1,1210,199,485,.410,92,247,.372,107,238,.450,.505,101,109,.927,14,86,100,103,46,3,54,41,591,17
Marco Belinelli,SG,31,PHI,28,1,737,138,279,.495,57,148,.385,81,131,.618,.597,47,54,.870,6,45,51,45,20,9,40,50,380,17
Jordan Bell,C,23,GSW,57,13,809,116,185,.627,0,4,0,116,181,.641,.627,30,44,.682,60,147,207,102,35,56,51,92,262,17
DeAndre' Bembry,SF,23,ATL,26,3,455,53,128,.414,11,30,.367,42,98,.429,.457,19,33,.576,8,64,72,49,21,12,47,38,136,17
Dragan Bender,PF,20,PHO,82,37,2069,187,484,.386,118,322,.366,69,162,.426,.508,39,51,.765,40,321,361,130,22,53,112,166,531,17
Dāvis Bertāns,PF,25,SAS,77,10,1086,161,366,.440,94,252,.373,67,114,.588,.568,40,49,.816,18,135,153,74,26,28,36,93,456,17
Patrick Beverley,SG,29,LAC,11,11,334,48,119,.403,24,60,.400,24,59,.407,.504,14,17,.824,16,29,45,32,19,5,25,34,134,17
Khem Birch,C,25,ORL,42,0,578,68,126,.540,0,0,0,68,126,.540,.540,42,61,.689,70,110,180,34,15,21,21,56,178,17
Jabari Bird,SG,23,BOS,13,1,115,15,26,.577,3,7,.429,12,19,.632,.635,6,13,.462,6,13,19,8,3,1,8,7,39,17
Bismack Biyombo,C,25,ORL,82,25,1495,183,352,.520,0,1,0,183,351,.521,.520,102,157,.650,144,324,468,66,21,95,84,158,468,17
Nemanja Bjelica,PF,29,MIN,67,21,1371,171,371,.461,76,183,.415,95,188,.505,.563,36,45,.800,53,221,274,86,50,16,52,141,454,17
Tarik Black,C,26,HOU,51,2,536,75,127,.591,1,11,.091,74,116,.638,.594,29,63,.460,63,100,163,13,21,30,35,107,180,17
Antonio Blakeney,SG,21,CHI,19,0,314,53,143,.371,15,52,.288,38,91,.418,.423,30,39,.769,4,29,33,20,7,1,11,19,151,17
Eric Bledsoe,PG,28,TOT,74,74,2322,468,989,.473,125,360,.347,343,629,.545,.536,252,317,.795,51,233,284,370,149,42,216,185,1313,17
Eric Bledsoe,PG,28,PHO,3,3,83,16,40,.400,4,13,.308,12,27,.444,.450,11,14,.786,3,4,7,9,4,2,10,6,47,17
Eric Bledsoe,PG,28,MIL,71,71,2239,452,949,.476,121,347,.349,331,602,.550,.540,241,303,.795,48,229,277,361,145,40,206,179,1266,17
Vander Blue,SG,25,LAL,5,0,45,1,5,.200,0,2,0,1,3,.333,.200,1,2,.500,0,1,1,3,1,0,3,2,3,17
Bogdan Bogdanović,SG,25,SAC,78,53,2175,344,772,.446,129,329,.392,215,443,.485,.529,100,119,.840,31,192,223,258,72,16,125,172,917,17
Bojan Bogdanović,SF,28,IND,80,80,2464,404,852,.474,155,386,.402,249,466,.534,.565,178,205,.868,30,240,270,119,55,8,106,129,1141,17
Andrew Bogut,C,33,LAL,24,5,216,17,25,.680,0,0,0,17,25,.680,.680,2,2,1.000,26,52,78,15,4,13,19,40,36,17
Joel Bolomboy,PF,24,MIL,6,0,38,3,6,.500,0,1,0,3,5,.600,.500,3,6,.500,6,4,10,0,2,0,2,3,9,17
Devin Booker,SG,21,PHO,54,54,1865,455,1054,.432,147,384,.383,308,670,.460,.501,289,329,.878,26,218,244,253,47,14,194,168,1346,17
Trevor Booker,PF,30,TOT,68,7,1158,177,343,.516,8,33,.242,169,310,.545,.528,66,93,.710,117,201,318,82,28,21,59,119,428,17
Trevor Booker,PF,30,BRK,18,6,395,77,150,.513,3,12,.250,74,138,.536,.523,24,43,.558,38,81,119,38,8,5,30,43,181,17
Trevor Booker,PF,30,PHI,33,0,494,61,109,.560,2,7,.286,59,102,.578,.569,32,39,.821,47,75,122,27,16,11,20,50,156,17
Trevor Booker,PF,30,IND,17,1,269,39,84,.464,3,14,.214,36,70,.514,.482,10,11,.909,32,45,77,17,4,5,9,26,91,17
Chris Boucher,PF,25,GSW,1,0,1,0,1,0,0,1,0,0,0,0,0,0,0,0,0,1,1,0,0,0,0,0,0,17
Avery Bradley,SG,27,TOT,46,46,1433,259,625,.414,75,203,.369,184,422,.436,.474,63,82,.768,22,94,116,94,51,8,101,92,656,17
Avery Bradley,SG,27,DET,40,40,1268,233,570,.409,74,194,.381,159,376,.423,.474,61,80,.763,19,75,94,83,46,7,93,80,601,17
Avery Bradley,SG,27,LAC,6,6,165,26,55,.473,1,9,.111,25,46,.543,.482,2,2,1.000,3,19,22,11,5,1,8,12,55,17
Tony Bradley,C,20,UTA,9,0,29,3,11,.273,0,1,0,3,10,.300,.273,2,2,1.000,4,7,11,1,0,0,0,1,8,17
Corey Brewer,SF-SG,31,TOT,72,18,1208,142,316,.449,31,110,.282,111,206,.539,.498,65,90,.722,43,111,154,65,79,14,49,139,380,17
Corey Brewer,SF,31,LAL,54,2,694,78,172,.453,8,43,.186,70,129,.543,.477,34,51,.667,23,70,93,41,41,8,38,83,198,17
Corey Brewer,SG,31,OKC,18,16,514,64,144,.444,23,67,.343,41,77,.532,.524,31,39,.795,20,41,61,24,38,6,11,56,182,17
Malcolm Brogdon,PG,25,MIL,48,20,1436,244,503,.485,62,161,.385,182,342,.532,.547,75,85,.882,23,133,156,152,41,13,66,128,625,17
Aaron Brooks,PG,33,MIN,32,1,189,28,69,.406,11,31,.355,17,38,.447,.486,8,11,.727,7,10,17,20,6,0,11,28,75,17
Dillon Brooks,SF,22,MEM,82,74,2350,340,772,.440,94,264,.356,246,508,.484,.501,124,166,.747,49,208,257,135,73,17,124,233,898,17
MarShon Brooks,SG,29,MEM,7,1,193,51,102,.500,19,32,.594,32,70,.457,.593,20,23,.870,8,13,21,25,11,3,16,6,141,17
Anthony Brown,SF,25,MIN,1,0,4,1,1,1.000,1,1,1.000,0,0,0,1.500,0,0,0,0,0,0,1,0,0,0,0,3,17
Bobby Brown,PG,33,HOU,20,0,115,19,58,.328,11,40,.275,8,18,.444,.422,1,2,.500,0,7,7,11,4,0,9,6,50,17
Jaylen Brown,SG,21,BOS,70,70,2152,373,803,.465,121,306,.395,252,497,.507,.540,150,233,.644,66,280,346,114,70,26,124,181,1017,17
Lorenzo Brown,PG,27,TOR,14,0,139,14,34,.412,2,12,.167,12,22,.545,.441,2,2,1.000,1,14,15,13,5,0,3,7,32,17
Markel Brown,SG,26,HOU,4,0,31,2,7,.286,1,5,.200,1,2,.500,.357,0,0,0,1,4,5,2,0,0,2,6,5,17
Sterling Brown,SG,22,MIL,54,4,776,82,205,.400,32,91,.352,50,114,.439,.478,21,24,.875,27,116,143,25,31,13,25,80,217,17
Nicolás Brussino,SF,24,ATL,4,0,10,0,2,0,0,2,0,0,0,0,0,0,0,0,0,3,3,0,0,0,0,0,0,17
Thomas Bryant,C,20,LAL,15,0,72,8,21,.381,1,10,.100,7,11,.636,.405,5,9,.556,3,14,17,6,1,2,2,6,22,17
Reggie Bullock,SF,26,DET,62,52,1732,267,546,.489,125,281,.445,142,265,.536,.603,39,49,.796,27,127,154,95,47,13,47,70,698,17
Trey Burke,PG,25,NYK,36,9,785,193,384,.503,38,105,.362,155,279,.556,.552,37,57,.649,13,58,71,170,24,4,43,43,461,17
Alec Burks,SG,26,UTA,64,1,1059,170,414,.411,47,142,.331,123,272,.452,.467,107,124,.863,19,173,192,67,37,8,60,75,494,17
Jimmy Butler,SG,28,MIN,59,59,2164,437,921,.474,70,200,.350,367,721,.509,.512,363,425,.854,79,235,314,288,116,24,108,78,1307,17
Dwight Buycks,PG,28,DET,29,0,427,82,198,.414,15,45,.333,67,153,.438,.452,36,41,.878,12,29,41,59,19,2,39,39,215,17
Bruno Caboclo,SF,22,TOT,12,0,107,9,31,.290,3,17,.176,6,14,.429,.339,5,6,.833,7,15,22,4,3,4,4,8,26,17
Bruno Caboclo,SF,22,TOR,2,0,7,0,2,0,0,2,0,0,0,0,0,0,0,0,0,1,1,1,1,0,0,1,0,17
Bruno Caboclo,SF,22,SAC,10,0,100,9,29,.310,3,15,.200,6,14,.429,.362,5,6,.833,7,14,21,3,2,4,4,7,26,17
José Calderón,PG,36,CLE,57,32,914,93,185,.503,45,97,.464,48,88,.545,.624,24,30,.800,14,70,84,117,27,2,41,81,255,17
Kentavious Caldwell-Pope,SG,24,LAL,74,74,2458,340,798,.426,159,415,.383,181,383,.473,.526,153,194,.789,60,327,387,162,106,16,97,145,992,17
Isaiah Canaan,PG-SG,26,TOT,20,1,422,52,137,.380,22,66,.333,30,71,.423,.460,46,51,.902,6,39,45,76,16,1,29,36,172,17
Isaiah Canaan,SG,26,HOU,1,0,4,0,1,0,0,0,0,0,1,0,0,0,0,0,0,1,1,0,0,0,0,0,0,17
Isaiah Canaan,PG,26,PHO,19,1,418,52,136,.382,22,66,.333,30,70,.429,.463,46,51,.902,6,38,44,76,16,1,29,36,172,17
Clint Capela,C,23,HOU,74,74,2034,441,676,.652,0,1,0,441,675,.653,.652,144,257,.560,241,561,802,68,58,137,103,185,1026,17
DeMarre Carroll,PF,31,BRK,73,73,2180,325,785,.414,145,391,.371,180,394,.457,.506,188,246,.764,105,374,479,147,59,30,103,165,983,17
Vince Carter,SF,41,SAC,58,5,1026,114,283,.403,57,165,.345,57,118,.483,.504,28,37,.757,18,130,148,69,42,26,36,96,313,17
Michael Carter-Williams,PG,26,CHO,52,2,835,76,229,.332,14,59,.237,62,170,.365,.362,73,89,.820,37,101,138,116,44,23,52,99,239,17
Alex Caruso,PG,23,LAL,37,7,562,50,116,.431,13,43,.302,37,73,.507,.487,21,30,.700,15,50,65,75,23,10,42,52,134,17
Omri Casspi,SF,29,GSW,53,7,740,120,207,.580,10,22,.455,110,185,.595,.604,50,69,.725,30,170,200,51,18,19,37,71,300,17
Willie Cauley-Stein,C,24,SAC,73,58,2044,388,773,.502,3,12,.250,385,761,.506,.504,153,247,.619,131,379,510,172,77,67,109,185,932,17
Tyler Cavanaugh,PF,23,ATL,39,1,518,67,152,.441,32,89,.360,35,63,.556,.546,17,21,.810,45,82,127,27,9,4,14,61,183,17
Mario Chalmers,PG,31,MEM,66,10,1421,168,443,.379,53,191,.277,115,252,.456,.439,118,138,.855,13,144,157,197,79,14,117,179,507,17
Tyson Chandler,C,35,PHO,46,46,1151,121,187,.647,0,0,0,121,187,.647,.647,58,93,.624,134,284,418,53,16,27,59,106,300,17
Wilson Chandler,SF,30,DEN,74,71,2346,281,631,.445,88,246,.358,193,385,.501,.515,88,114,.772,102,296,398,159,43,39,92,156,738,17
Marquese Chriss,PF,20,PHO,72,49,1527,202,477,.423,56,190,.295,146,287,.509,.482,96,158,.608,76,319,395,83,51,70,107,205,556,17
Ian Clark,SG,26,NOP,74,2,1455,222,495,.448,62,195,.318,160,300,.533,.511,45,59,.763,10,117,127,110,33,10,57,120,551,17
Jordan Clarkson,SG,25,TOT,81,2,1888,430,954,.451,112,318,.352,318,636,.500,.509,152,190,.800,57,160,217,221,58,6,127,107,1124,17
Jordan Clarkson,SG,25,LAL,53,2,1256,299,667,.448,68,210,.324,231,457,.505,.499,105,132,.795,44,115,159,173,39,3,95,63,771,17
Jordan Clarkson,SG,25,CLE,28,0,632,131,287,.456,44,108,.407,87,179,.486,.533,47,58,.810,13,45,58,48,19,3,32,44,353,17
Gian Clavell,SG,24,DAL,7,0,64,6,18,.333,6,15,.400,0,3,0,.500,2,2,1.000,1,6,7,3,2,0,2,8,20,17
Antonius Cleveland,SG,23,TOT,17,0,123,8,21,.381,3,4,.750,5,17,.294,.452,4,6,.667,3,11,14,2,7,5,7,23,23,17
Antonius Cleveland,SG,23,DAL,13,0,81,4,14,.286,0,1,0,4,13,.308,.286,2,4,.500,2,8,10,2,6,4,2,11,10,17
Antonius Cleveland,SG,23,ATL,4,0,42,4,7,.571,3,3,1.000,1,4,.250,.786,2,2,1.000,1,3,4,0,1,1,5,12,13,17
John Collins,PF,20,ATL,74,26,1785,314,545,.576,16,47,.340,298,498,.598,.591,133,186,.715,176,365,541,98,47,80,105,215,777,17
Zach Collins,C,20,POR,66,1,1045,115,289,.398,35,113,.310,80,176,.455,.458,27,42,.643,45,176,221,52,17,31,58,133,292,17
Kyle Collinsworth,SF,26,DAL,32,2,480,38,99,.384,4,17,.235,34,82,.415,.404,21,40,.525,32,75,107,56,17,9,24,44,101,17
Darren Collison,PG,30,IND,69,64,2018,316,638,.495,96,205,.468,220,433,.508,.571,127,144,.882,37,141,178,368,92,15,86,122,855,17
Nick Collison,PF,37,OKC,15,0,75,13,19,.684,0,0,0,13,19,.684,.684,5,13,.385,7,13,20,4,0,0,7,7,31,17
Mike Conley,PG,30,MEM,12,12,373,64,168,.381,24,77,.312,40,91,.440,.452,53,66,.803,0,27,27,49,12,3,18,24,205,17
Pat Connaughton,SG,25,POR,82,5,1488,165,390,.423,74,210,.352,91,180,.506,.518,37,44,.841,36,125,161,91,23,22,43,120,441,17
Quinn Cook,PG,24,GSW,33,18,740,122,252,.484,46,104,.442,76,148,.514,.575,22,25,.880,10,72,82,89,12,1,32,59,312,17
Charles Cooke,SG,23,NOP,13,0,38,2,14,.143,1,8,.125,1,6,.167,.179,1,2,.500,0,2,2,1,1,0,1,0,6,17
Jack Cooley,PF,26,SAC,7,0,87,13,27,.481,0,0,0,13,27,.481,.481,14,19,.737,14,16,30,6,1,0,3,13,40,17
Matt Costello,C,24,SAS,4,0,32,2,4,.500,0,0,0,2,4,.500,.500,0,0,0,1,8,9,2,2,2,1,7,4,17
DeMarcus Cousins,C,27,NOP,48,48,1737,406,864,.470,104,294,.354,302,570,.530,.530,294,394,.746,105,512,617,257,79,76,242,183,1210,17
Robert Covington,SF,27,PHI,80,80,2532,345,836,.413,203,550,.369,142,286,.497,.534,116,136,.853,55,378,433,156,137,72,126,238,1009,17
Allen Crabbe,SG,25,BRK,75,68,2197,337,827,.407,201,532,.378,136,295,.461,.529,115,135,.852,28,296,324,117,47,35,78,168,990,17
Torrey Craig,SF,27,DEN,39,5,629,62,137,.453,17,58,.293,45,79,.570,.515,22,35,.629,40,87,127,25,12,15,20,63,163,17
Jamal Crawford,SG,37,MIN,80,0,1653,308,742,.415,104,314,.331,204,428,.477,.485,102,113,.903,21,78,99,185,40,9,95,85,822,17
Jordan Crawford,SG,29,NOP,5,0,53,12,27,.444,8,14,.571,4,13,.308,.593,1,1,1.000,2,2,4,13,1,1,5,7,33,17
Jae Crowder,SF,27,TOT,80,47,2090,271,671,.404,110,341,.323,161,330,.488,.486,121,148,.818,59,216,275,99,64,21,74,187,773,17
Jae Crowder,SF,27,CLE,53,47,1346,157,376,.418,62,189,.328,95,187,.508,.500,78,92,.848,41,132,173,58,41,12,42,124,454,17
Jae Crowder,SF,27,UTA,27,0,744,114,295,.386,48,152,.316,66,143,.462,.468,43,56,.768,18,84,102,41,23,9,32,63,319,17
Dante Cunningham,SF,30,TOT,73,25,1562,164,364,.451,58,168,.345,106,196,.541,.530,31,52,.596,78,220,298,48,39,30,33,111,417,17
Dante Cunningham,SF,30,NOP,51,24,1115,99,225,.440,35,108,.324,64,117,.547,.518,20,36,.556,50,143,193,26,27,16,16,75,253,17
Dante Cunningham,SF,30,BRK,22,1,447,65,139,.468,23,60,.383,42,79,.532,.550,11,16,.688,28,77,105,22,12,14,17,36,164,17
Stephen Curry,PG,29,GSW,51,51,1631,428,864,.495,212,501,.423,216,363,.595,.618,278,302,.921,36,225,261,310,80,8,153,114,1346,17
Troy Daniels,SG,26,PHO,79,15,1622,232,575,.403,183,458,.400,49,117,.419,.563,56,64,.875,12,115,127,48,26,5,56,137,703,17
Anthony Davis,PF,24,NOP,75,75,2727,780,1462,.534,55,162,.340,725,1300,.558,.552,495,598,.828,187,645,832,174,115,193,162,159,2110,17
Deyonta Davis,C,21,MEM,62,6,943,161,265,.608,0,0,0,161,265,.608,.608,38,57,.667,75,175,250,40,15,39,32,125,360,17
Ed Davis,C,28,POR,78,0,1471,170,292,.582,0,1,0,170,291,.584,.582,74,111,.667,183,392,575,40,32,52,66,188,414,17
Dewayne Dedmon,C,28,ATL,62,46,1542,250,477,.524,50,141,.355,200,336,.595,.577,67,86,.779,100,389,489,90,40,51,86,162,617,17
Sam Dekker,PF,23,LAC,73,1,883,128,259,.494,10,60,.167,118,199,.593,.514,37,56,.661,44,130,174,38,24,9,33,71,303,17
Malcolm Delaney,PG,28,ATL,54,3,1014,109,285,.382,46,124,.371,63,161,.391,.463,74,92,.804,9,91,100,163,35,6,66,82,338,17
Matthew Dellavedova,PG,27,MIL,38,3,712,55,152,.362,29,78,.372,26,74,.351,.457,25,27,.926,14,50,64,145,14,0,49,67,164,17
Luol Deng,SF,32,LAL,1,1,13,1,2,.500,0,0,0,1,2,.500,.500,0,0,0,0,0,0,1,1,0,1,0,2,17
DeMar DeRozan,SG,28,TOR,80,80,2711,645,1413,.456,89,287,.310,556,1126,.494,.488,461,559,.825,59,256,315,417,85,22,175,151,1840,17
Cheick Diallo,PF,21,NOP,52,0,581,102,176,.580,0,0,0,102,176,.580,.580,50,66,.758,47,164,211,19,11,21,28,82,254,17
Gorgui Dieng,C,28,MIN,79,0,1333,186,388,.479,19,61,.311,167,327,.511,.504,79,102,.775,106,254,360,71,45,39,59,147,470,17
Spencer Dinwiddie,PG,24,BRK,80,58,2306,324,838,.387,141,433,.326,183,405,.452,.471,218,268,.813,40,219,259,524,68,23,128,186,1007,17
Tyler Dorsey,SG,21,ATL,56,5,974,144,382,.377,72,199,.362,72,183,.393,.471,45,63,.714,17,113,130,79,17,5,37,63,405,17
Damyean Dotson,SG,23,NYK,44,2,474,72,161,.447,22,68,.324,50,93,.538,.516,16,23,.696,9,75,84,31,12,2,17,34,182,17
Milton Doyle,SG,24,BRK,10,0,125,13,47,.277,4,23,.174,9,24,.375,.319,4,8,.500,3,15,18,10,6,2,2,13,34,17
PJ Dozier,PG,21,OKC,2,0,3,1,2,.500,0,0,0,1,2,.500,.500,0,0,0,0,1,1,0,0,0,1,1,2,17
Goran Dragić,PG,31,MIA,75,75,2378,484,1075,.450,111,300,.370,373,775,.481,.502,217,271,.801,54,252,306,359,63,12,166,180,1296,17
Larry Drew II,PG,27,TOT,10,0,70,7,24,.292,3,9,.333,4,15,.267,.354,0,0,0,3,0,3,10,0,0,3,6,17,17
Larry Drew II,PG,27,PHI,3,0,15,1,7,.143,0,3,0,1,4,.250,.143,0,0,0,1,0,1,2,0,0,1,2,2,17
Larry Drew II,PG,27,NOP,7,0,55,6,17,.353,3,6,.500,3,11,.273,.441,0,0,0,2,0,2,8,0,0,2,4,15,17
Andre Drummond,C,24,DET,78,78,2625,466,881,.529,0,11,0,466,870,.536,.529,239,395,.605,399,848,1247,237,114,127,200,250,1171,17
Jared Dudley,PF,32,PHO,48,0,686,48,122,.393,29,80,.363,19,42,.452,.512,27,35,.771,8,86,94,78,24,11,28,85,152,17
Kris Dunn,PG,23,CHI,52,43,1525,286,666,.429,43,134,.321,243,532,.457,.462,84,114,.737,24,197,221,310,104,27,150,174,699,17
Kevin Durant,SF,29,GSW,68,68,2325,630,1222,.516,173,413,.419,457,809,.565,.586,359,404,.889,31,433,464,366,50,119,207,133,1792,17
Jarell Eddie,SF,26,TOT,3,0,9,0,2,0,0,2,0,0,0,0,0,0,0,0,0,1,1,0,1,0,0,0,0,17
Jarell Eddie,SF,26,BOS,2,0,6,0,1,0,0,1,0,0,0,0,0,0,0,0,0,1,1,0,1,0,0,0,0,17
Jarell Eddie,SF,26,CHI,1,0,3,0,1,0,0,1,0,0,0,0,0,0,0,0,0,0,0,0,0,0,0,0,0,17
Henry Ellenson,PF,21,DET,38,0,329,53,146,.363,20,60,.333,33,86,.384,.432,25,29,.862,10,71,81,20,5,0,18,22,151,17
Wayne Ellington,SG,30,MIA,77,2,2041,285,700,.407,227,579,.392,58,121,.479,.569,67,78,.859,23,195,218,79,53,8,52,94,864,17
Joel Embiid,C,23,PHI,63,63,1912,510,1056,.483,66,214,.308,444,842,.527,.514,359,467,.769,143,547,690,199,40,111,234,209,1445,17
James Ennis III,SF,27,TOT,72,22,1604,182,384,.474,51,153,.333,131,231,.567,.540,97,116,.836,73,151,224,71,47,18,56,134,512,17
James Ennis III,SF,27,MEM,45,14,1053,108,222,.486,30,84,.357,78,138,.565,.554,64,73,.877,53,104,157,49,32,12,38,81,310,17
James Ennis III,SF,27,DET,27,8,551,74,162,.457,21,69,.304,53,93,.570,.522,33,43,.767,20,47,67,22,15,6,18,53,202,17
Tyler Ennis,PG,23,LAL,54,11,683,94,224,.420,14,56,.250,80,168,.476,.451,22,29,.759,19,76,95,105,30,10,38,75,224,17
Jawun Evans,PG,21,LAC,48,4,778,89,253,.352,15,54,.278,74,199,.372,.381,38,49,.776,9,75,84,100,36,6,44,97,231,17
Jeremy Evans,SF,30,ATL,1,0,5,1,1,1.000,0,0,0,1,1,1.000,1.000,0,0,0,1,0,1,0,0,0,1,1,2,17
Tyreke Evans,PG,28,MEM,52,32,1607,366,809,.452,114,286,.399,252,523,.482,.523,164,209,.785,44,221,265,269,57,17,117,96,1010,17
Dante Exum,PG,22,UTA,14,0,235,42,87,.483,5,18,.278,37,69,.536,.511,25,31,.806,4,22,26,43,8,3,20,20,114,17
Kenneth Faried,PF,28,DEN,32,7,461,76,148,.514,0,1,0,76,147,.517,.514,36,51,.706,68,85,153,18,12,13,23,51,188,17
Derrick Favors,C,26,UTA,77,77,2153,395,702,.563,14,63,.222,381,639,.596,.573,140,215,.651,198,354,552,102,54,82,88,164,944,17
Kay Felder,PG,22,TOT,16,0,140,21,70,.300,4,19,.211,17,51,.333,.329,11,12,.917,3,15,18,20,3,1,16,11,57,17
Kay Felder,PG,22,CHI,14,0,134,20,66,.303,4,18,.222,16,48,.333,.333,11,12,.917,1,13,14,20,3,1,15,11,55,17
Kay Felder,PG,22,DET,2,0,6,1,4,.250,0,1,0,1,3,.333,.250,0,0,0,2,2,4,0,0,0,1,0,2,17
Cristiano Felício,C,25,CHI,55,16,977,127,215,.591,0,2,0,127,213,.596,.591,54,81,.667,83,150,233,55,16,11,54,104,308,17
Raymond Felton,PG,33,OKC,82,2,1365,224,552,.406,81,230,.352,143,322,.444,.479,36,44,.818,25,131,156,203,49,16,76,91,565,17
Terrance Ferguson,SG,19,OKC,61,12,763,70,169,.414,40,120,.333,30,49,.612,.533,9,10,.900,19,28,47,19,24,10,11,83,189,17
Yogi Ferrell,SG,24,DAL,82,21,2282,311,730,.426,134,359,.373,177,371,.477,.518,82,103,.796,26,223,249,201,64,9,78,153,838,17
Dorian Finney-Smith,PF,24,DAL,21,13,448,46,121,.380,20,67,.299,26,54,.481,.463,11,15,.733,22,53,75,26,10,4,21,43,123,17
Bryn Forbes,SG,24,SAS,80,12,1517,209,497,.421,89,228,.390,120,269,.446,.510,48,72,.667,12,98,110,80,28,2,37,108,555,17
Evan Fournier,SF,25,ORL,57,57,1837,368,802,.459,127,335,.379,241,467,.516,.538,150,173,.867,23,157,180,165,47,16,95,138,1013,17
De'Aaron Fox,PG,20,SAC,73,60,2026,328,797,.412,47,153,.307,281,644,.436,.441,141,195,.723,33,171,204,320,70,20,173,163,844,17
Tim Frazier,PG,27,WAS,59,11,838,68,172,.395,17,56,.304,51,116,.440,.445,23,30,.767,18,97,115,194,47,7,57,97,176,17
Enes Freedom,C,25,NYK,71,71,1830,422,713,.592,0,2,0,422,711,.594,.592,156,184,.848,273,507,780,105,36,37,122,187,1000,17
Channing Frye,C,34,TOT,53,1,695,104,212,.491,39,115,.339,65,97,.670,.583,17,19,.895,12,123,135,38,18,13,21,69,264,17
Channing Frye,C,34,CLE,44,1,545,84,169,.497,30,90,.333,54,79,.684,.586,14,15,.933,10,100,110,28,17,12,17,54,212,17
Channing Frye,C,34,LAL,9,0,150,20,43,.465,9,25,.360,11,18,.611,.570,3,4,.750,2,23,25,10,1,1,4,15,52,17
Markelle Fultz,SG,19,PHI,14,0,253,45,111,.405,0,1,0,45,110,.409,.405,10,21,.476,11,32,43,53,12,4,17,22,100,17
Danilo Gallinari,SF,29,LAC,21,21,671,102,256,.398,36,111,.324,66,145,.455,.469,81,87,.931,9,92,101,41,12,10,26,30,321,17
Langston Galloway,SG,26,DET,58,2,863,126,340,.371,75,218,.344,51,122,.418,.481,33,41,.805,13,79,92,58,35,5,18,39,360,17
Marc Gasol,C,33,MEM,73,73,2408,434,1033,.420,109,320,.341,325,713,.456,.473,281,337,.834,78,514,592,305,54,101,194,185,1258,17
Pau Gasol,C,37,SAS,77,63,1812,287,627,.458,43,120,.358,244,507,.481,.492,158,209,.756,129,490,619,238,24,79,108,121,775,17
Rudy Gay,PF,31,SAS,57,6,1231,253,537,.471,37,118,.314,216,419,.516,.506,112,145,.772,76,215,291,73,46,38,78,98,655,17
Paul George,SF,27,OKC,79,79,2891,576,1340,.430,244,609,.401,332,731,.454,.521,338,411,.822,72,375,447,263,161,39,212,233,1734,17
Marcus Georges-Hunt,SG,23,MIN,42,0,224,21,48,.438,4,15,.267,17,33,.515,.479,13,21,.619,7,9,16,7,6,0,3,32,59,17
Jonathan Gibson,PG,30,BOS,4,0,40,14,23,.609,6,12,.500,8,11,.727,.739,0,0,0,0,3,3,4,0,0,3,5,34,17
Taj Gibson,PF,32,MIN,82,82,2726,425,737,.577,7,35,.200,418,702,.595,.581,142,185,.768,194,390,584,99,62,59,89,218,999,17
Manu Ginóbili,SG,40,SAS,65,0,1299,201,463,.434,64,192,.333,137,271,.506,.503,110,131,.840,19,123,142,163,43,16,105,126,576,17
Rudy Gobert,C,25,UTA,56,56,1816,276,444,.622,0,0,0,276,444,.622,.622,204,299,.682,165,436,601,80,44,129,107,153,756,17
Aaron Gordon,PF,22,ORL,58,57,1909,375,865,.434,115,342,.336,260,523,.497,.500,157,225,.698,87,370,457,136,59,45,107,111,1022,17
Eric Gordon,SG,29,HOU,69,30,2154,415,970,.428,218,608,.359,197,362,.544,.540,195,241,.809,25,145,170,154,44,27,130,116,1243,17
Marcin Gortat,C,33,WAS,82,82,2075,290,560,.518,0,0,0,290,560,.518,.518,110,163,.675,181,442,623,151,40,61,99,175,690,17
Treveon Graham,SG,24,CHO,63,2,1050,96,221,.434,40,97,.412,56,124,.452,.525,41,59,.695,42,79,121,59,33,2,27,109,273,17
Jerami Grant,PF,23,OKC,81,1,1647,244,456,.535,32,110,.291,212,346,.613,.570,162,240,.675,86,233,319,57,31,77,54,155,682,17
Jerian Grant,PG,25,CHI,74,26,1686,209,503,.416,61,187,.326,148,316,.468,.476,140,188,.745,31,141,172,342,63,8,89,132,619,17
Josh Gray,PG,24,PHO,5,0,86,11,41,.268,3,13,.231,8,28,.286,.305,7,11,.636,2,8,10,12,8,2,7,8,32,17
Danny Green,SG,30,SAS,70,60,1791,217,561,.387,116,320,.363,101,241,.419,.490,50,65,.769,41,208,249,110,63,80,74,122,600,17
Draymond Green,PF,27,GSW,70,70,2287,281,619,.454,77,256,.301,204,363,.562,.516,134,173,.775,75,460,535,508,95,91,202,185,773,17
Gerald Green,SG,32,HOU,41,2,929,168,413,.407,110,298,.369,58,115,.504,.540,51,60,.850,15,118,133,25,24,15,31,87,497,17
JaMychal Green,PF,27,MEM,55,54,1542,223,488,.457,43,127,.339,180,361,.499,.501,80,111,.721,147,317,464,79,32,25,76,153,569,17
Jeff Green,PF,31,CLE,78,13,1828,295,618,.477,53,170,.312,242,448,.540,.520,203,234,.868,60,186,246,99,41,34,75,149,846,17
Blake Griffin,PF,28,TOT,58,58,1970,436,996,.438,111,322,.345,325,674,.482,.493,259,330,.785,73,355,428,334,41,18,165,139,1242,17
Blake Griffin,PF,28,LAC,33,33,1139,255,578,.441,64,187,.342,191,391,.488,.497,172,219,.785,46,216,262,179,30,9,99,78,746,17
Blake Griffin,PF,28,DET,25,25,831,181,418,.433,47,135,.348,134,283,.473,.489,87,111,.784,27,139,166,155,11,9,66,61,496,17
Daniel Hamilton,SG,22,OKC,6,0,28,5,11,.455,2,5,.400,3,6,.500,.545,0,0,0,0,5,5,8,1,0,2,2,12,17
Tim Hardaway Jr.,SG,25,NYK,57,54,1885,360,856,.421,130,410,.317,230,446,.516,.496,146,179,.816,32,192,224,155,62,10,92,123,996,17
James Harden,SG,28,HOU,72,72,2551,651,1449,.449,265,722,.367,386,727,.531,.541,624,727,.858,41,348,389,630,126,50,315,169,2191,17
Maurice Harkless,SF,24,POR,59,36,1264,147,297,.495,49,118,.415,98,179,.547,.577,42,59,.712,46,116,162,53,48,43,40,103,385,17
Montrezl Harrell,C,24,LAC,76,3,1293,348,548,.635,1,7,.143,347,541,.641,.636,139,222,.626,103,203,306,74,36,52,68,143,836,17
Devin Harris,PG,34,TOT,71,1,1340,187,454,.412,79,227,.348,108,227,.476,.499,142,170,.835,12,115,127,152,47,12,76,158,595,17
Devin Harris,PG,34,DAL,44,1,807,118,284,.415,44,125,.352,74,159,.465,.493,93,112,.830,9,76,85,85,33,8,49,103,373,17
Devin Harris,PG,34,DEN,27,0,533,69,170,.406,35,102,.343,34,68,.500,.509,49,58,.845,3,39,42,67,14,4,27,55,222,17
Gary Harris,SG,23,DEN,67,65,2304,440,908,.485,156,394,.396,284,514,.553,.570,134,162,.827,37,139,176,194,122,15,119,119,1170,17
Joe Harris,SG,26,BRK,78,14,1975,305,621,.491,150,358,.419,155,263,.589,.612,86,104,.827,51,209,260,128,35,20,91,153,846,17
Tobias Harris,PF,25,TOT,80,80,2668,562,1221,.460,183,445,.411,379,776,.488,.535,179,216,.829,58,379,437,192,71,35,105,164,1486,17
Tobias Harris,PF,25,DET,48,48,1563,320,709,.451,113,276,.409,207,433,.478,.531,115,136,.846,36,208,244,94,34,15,51,91,868,17
Tobias Harris,PF,25,LAC,32,32,1105,242,512,.473,70,169,.414,172,343,.501,.541,64,80,.800,22,171,193,98,37,20,54,73,618,17
Aaron Harrison,SG,23,DAL,9,3,233,19,69,.275,9,43,.209,10,26,.385,.341,13,17,.765,4,20,24,11,9,2,3,27,60,17
Andrew Harrison,PG,23,MEM,56,46,1326,181,429,.422,47,142,.331,134,287,.467,.477,124,159,.780,23,108,131,177,38,26,81,138,533,17
Shaquille Harrison,PG,24,PHO,23,2,384,59,124,.476,6,26,.231,53,98,.541,.500,28,38,.737,9,52,61,55,26,7,22,42,152,17
Josh Hart,SG,22,LAL,63,23,1461,176,375,.469,78,197,.396,98,178,.551,.573,66,94,.702,42,221,263,80,47,16,47,107,496,17
Udonis Haslem,C,37,MIA,14,0,72,3,15,.200,1,8,.125,2,7,.286,.233,1,2,.500,3,7,10,5,0,2,2,3,8,17
Nigel Hayes,SF,23,TOT,9,0,122,11,33,.333,4,16,.250,7,17,.412,.394,1,3,.333,4,18,22,6,2,3,2,8,27,17
Nigel Hayes,SF,23,LAL,2,0,11,1,3,.333,0,2,0,1,1,1.000,.333,1,1,1.000,0,0,0,2,0,0,0,0,3,17
Nigel Hayes,SF,23,TOR,2,0,6,2,2,1.000,2,2,1.000,0,0,0,1.500,0,0,0,0,0,0,0,0,0,1,0,6,17
Nigel Hayes,SF,23,SAC,5,0,105,8,28,.286,2,12,.167,6,16,.375,.321,0,2,0,4,18,22,4,2,3,1,8,18,17
Gordon Hayward,SF,27,BOS,1,1,5,1,2,.500,0,1,0,1,1,1.000,.500,0,0,0,0,1,1,0,0,0,0,1,2,17
Reggie Hearn,SG,26,DET,3,0,7,1,2,.500,1,2,.500,0,0,0,.750,0,0,0,0,0,0,0,0,0,0,0,3,17
Myke Henry,SF,25,MEM,20,0,378,41,109,.376,19,58,.328,22,51,.431,.463,6,10,.600,10,28,38,22,31,6,19,28,107,17
John Henson,C,27,MIL,76,69,1970,287,502,.572,1,7,.143,286,495,.578,.573,90,158,.570,150,363,513,114,45,109,84,202,665,17
Juancho Hernangómez,PF,22,DEN,25,3,277,29,75,.387,14,50,.280,15,25,.600,.480,10,12,.833,18,36,54,12,6,3,9,25,82,17
Willy Hernangómez,C,23,TOT,48,1,495,91,164,.555,5,12,.417,86,152,.566,.570,59,90,.656,61,122,183,33,18,16,35,64,246,17
Willy Hernangómez,C,23,NYK,26,0,233,49,81,.605,1,5,.200,48,76,.632,.611,12,28,.429,22,45,67,21,8,7,26,32,111,17
Willy Hernangómez,C,23,CHO,22,1,262,42,83,.506,4,7,.571,38,76,.500,.530,47,62,.758,39,77,116,12,10,9,9,32,135,17
Mario Hezonja,SF,22,ORL,75,30,1657,273,617,.442,90,267,.337,183,350,.523,.515,86,105,.819,41,240,281,106,81,31,86,134,722,17
Isaiah Hicks,PF,23,NYK,18,0,240,33,72,.458,2,9,.222,31,63,.492,.472,12,18,.667,10,31,41,16,2,4,16,45,80,17
Buddy Hield,SG,25,SAC,80,12,2024,416,933,.446,176,408,.431,240,525,.457,.540,71,81,.877,55,252,307,155,85,22,124,148,1079,17
Nenê,C,35,HOU,52,4,758,136,239,.569,0,2,0,136,237,.574,.569,68,107,.636,54,122,176,45,28,14,38,123,340,17
George Hill,PG,31,TOT,67,60,1812,236,513,.460,85,205,.415,151,308,.490,.543,110,140,.786,42,139,181,186,61,27,88,128,667,17
George Hill,PG,31,SAC,43,36,1143,153,326,.469,58,128,.453,95,198,.480,.558,77,99,.778,22,95,117,119,39,12,60,75,441,17
George Hill,PG,31,CLE,24,24,669,83,187,.444,27,77,.351,56,110,.509,.516,33,41,.805,20,44,64,67,22,15,28,53,226,17
Solomon Hill,SF,26,NOP,12,1,187,11,41,.268,4,21,.190,7,20,.350,.317,3,6,.500,9,27,36,22,7,1,9,22,29,17
Darrun Hilliard,SG,24,SAS,14,0,95,5,19,.263,0,6,0,5,13,.385,.263,6,7,.857,0,7,7,11,2,0,4,7,16,17
Jrue Holiday,SG,27,NOP,81,81,2927,615,1244,.494,120,356,.337,495,888,.557,.543,187,238,.786,62,303,365,486,123,64,213,201,1537,17
Justin Holiday,SG,28,CHI,72,72,2265,290,782,.371,161,449,.359,129,333,.387,.474,135,164,.823,31,260,291,153,80,31,93,134,876,17
John Holland,SF,29,CLE,24,0,174,17,59,.288,11,36,.306,6,23,.261,.381,9,13,.692,6,18,24,5,7,2,8,10,54,17
Rondae Hollis-Jefferson,SF,23,BRK,68,59,1920,342,724,.472,13,54,.241,329,670,.491,.481,249,316,.788,101,358,459,167,65,48,121,145,946,17
Richaun Holmes,C,24,PHI,48,2,746,135,241,.560,4,31,.129,131,210,.624,.568,37,56,.661,57,154,211,61,20,29,25,97,311,17
Rodney Hood,SG,25,TOT,60,23,1616,322,751,.429,127,333,.381,195,418,.467,.513,111,129,.860,22,143,165,95,45,12,70,105,882,17
Rodney Hood,SG,25,UTA,39,12,1084,234,552,.424,102,262,.389,132,290,.455,.516,85,97,.876,14,97,111,65,30,7,63,64,655,17
Rodney Hood,SG,25,CLE,21,11,532,88,199,.442,25,71,.352,63,128,.492,.505,26,32,.813,8,46,54,30,15,5,7,41,227,17
Scotty Hopson,SG,28,DAL,1,0,8,0,1,0,0,0,0,0,1,0,0,1,2,.500,0,0,0,1,0,0,1,0,1,17
Al Horford,C,31,BOS,72,72,2277,368,753,.489,97,226,.429,271,527,.514,.553,94,120,.783,103,427,530,339,43,78,132,138,927,17
Danuel House Jr.,SG,24,PHO,23,3,403,56,129,.434,15,58,.259,41,71,.577,.492,25,31,.806,13,63,76,25,7,6,11,23,152,17
Dwight Howard,C,32,CHO,81,81,2463,506,911,.555,1,7,.143,505,904,.559,.556,334,582,.574,255,757,1012,105,48,131,208,249,1347,17
Josh Huestis,PF,26,OKC,69,10,982,60,182,.330,33,115,.287,27,67,.403,.420,6,20,.300,42,119,161,20,15,43,26,82,159,17
R.J. Hunter,SG,24,HOU,5,1,45,7,20,.350,3,14,.214,4,6,.667,.425,2,2,1.000,0,5,5,3,3,0,2,7,19,17
Vince Hunter,PF,23,MEM,4,0,7,3,5,.600,0,0,0,3,5,.600,.600,0,0,0,2,1,3,0,0,1,1,0,6,17
Serge Ibaka,PF,28,TOR,76,76,2093,379,784,.483,107,297,.360,272,487,.559,.552,94,118,.797,78,400,478,62,29,99,90,209,959,17
Andre Iguodala,SF,34,GSW,64,7,1622,148,320,.463,33,117,.282,115,203,.567,.514,55,87,.632,50,196,246,210,54,38,67,99,384,17
Ersan İlyasova,PF,30,TOT,69,43,1729,277,613,.452,91,253,.360,186,360,.517,.526,105,135,.778,118,287,405,90,61,26,72,157,750,17
Ersan İlyasova,PF,30,ATL,46,40,1175,184,401,.459,61,170,.359,123,231,.532,.535,72,90,.800,74,177,251,51,44,17,43,92,501,17
Ersan İlyasova,PF,30,PHI,23,3,554,93,212,.439,30,83,.361,63,129,.488,.509,33,45,.733,44,110,154,39,17,9,29,65,249,17
Joe Ingles,SF,30,UTA,82,81,2578,335,718,.467,204,464,.440,131,254,.516,.609,66,83,.795,24,320,344,392,90,20,159,178,940,17
Andre Ingram,SG,32,LAL,2,0,64,8,17,.471,5,9,.556,3,8,.375,.618,3,3,1.000,1,5,6,7,3,3,3,3,24,17
Brandon Ingram,SF,20,LAL,59,59,1975,358,761,.470,41,105,.390,317,656,.483,.497,192,282,.681,57,257,314,230,45,43,149,163,949,17
Kyrie Irving,PG,25,BOS,60,60,1931,534,1087,.491,166,407,.408,368,680,.541,.568,232,261,.889,33,194,227,306,65,17,140,122,1466,17
Jonathan Isaac,PF,20,ORL,27,10,536,55,145,.379,16,46,.348,39,99,.394,.434,19,25,.760,16,83,99,18,33,30,27,48,145,17
Wes Iwundu,SF,23,ORL,62,12,1020,93,218,.427,9,46,.196,84,172,.488,.447,34,47,.723,36,101,137,57,33,12,30,81,229,17
Jarrett Jack,PG,34,NYK,62,56,1548,189,443,.427,25,86,.291,164,357,.459,.455,63,75,.840,22,169,191,348,35,4,115,98,466,17
Aaron Jackson,PG,31,HOU,1,0,35,3,9,.333,1,4,.250,2,5,.400,.389,1,2,.500,2,1,3,1,0,0,1,4,8,17
Demetrius Jackson,PG,23,TOT,15,0,80,7,18,.389,1,7,.143,6,11,.545,.417,1,2,.500,5,7,12,9,5,1,10,7,16,17
Demetrius Jackson,PG,23,HOU,12,0,63,4,14,.286,0,6,0,4,8,.500,.286,0,0,0,4,7,11,5,4,1,9,6,8,17
Demetrius Jackson,PG,23,PHI,3,0,17,3,4,.750,1,1,1.000,2,3,.667,.875,1,2,.500,1,0,1,4,1,0,1,1,8,17
Josh Jackson,SF,20,PHO,77,35,1959,389,932,.417,57,217,.263,332,715,.464,.448,177,279,.634,95,256,351,119,80,35,146,218,1012,17
Justin Jackson,SF,22,SAC,68,41,1506,185,419,.442,57,185,.308,128,234,.547,.510,26,36,.722,27,160,187,74,28,13,40,81,453,17
Reggie Jackson,PG,27,DET,45,45,1201,246,577,.426,52,169,.308,194,408,.475,.471,112,134,.836,29,96,125,238,27,4,99,87,656,17
LeBron James,PF,33,CLE,82,82,3026,857,1580,.542,149,406,.367,708,1174,.603,.590,388,531,.731,97,612,709,747,116,71,347,136,2251,17
Mike James,PG,27,TOT,36,10,687,123,321,.383,26,98,.265,97,223,.435,.424,64,84,.762,13,77,90,126,28,7,49,48,336,17
Mike James,PG,27,PHO,32,10,669,121,312,.388,26,97,.268,95,215,.442,.429,64,84,.762,12,77,89,120,27,7,48,45,332,17
Mike James,PG,27,NOP,4,0,18,2,9,.222,0,1,0,2,8,.250,.222,0,0,0,1,0,1,6,1,0,1,3,4,17
Al Jefferson,C,33,IND,36,1,484,111,208,.534,0,3,0,111,205,.541,.534,30,36,.833,30,113,143,30,16,23,21,66,252,17
Richard Jefferson,SF,37,DEN,20,0,163,12,27,.444,2,7,.286,10,20,.500,.481,4,7,.571,2,15,17,15,2,1,5,11,30,17
Brandon Jennings,PG,28,MIL,14,0,205,27,72,.375,9,33,.273,18,39,.462,.438,10,10,1.000,5,26,31,44,6,4,18,11,73,17
Jonas Jerebko,PF,30,UTA,74,19,1134,159,341,.466,65,157,.414,94,184,.511,.562,46,57,.807,53,193,246,42,24,12,27,127,429,17
Amir Johnson,C,30,PHI,74,18,1171,140,260,.538,10,32,.313,130,228,.570,.558,52,85,.612,123,207,330,118,45,44,55,192,342,17
Brice Johnson,PF,23,TOT,18,0,98,20,42,.476,0,1,0,20,41,.488,.476,3,5,.600,9,22,31,2,9,6,5,13,43,17
Brice Johnson,PF,23,LAC,9,0,38,7,11,.636,0,1,0,7,10,.700,.636,2,2,1.000,2,11,13,1,6,2,4,7,16,17
Brice Johnson,PF,23,MEM,9,0,60,13,31,.419,0,0,0,13,31,.419,.419,1,3,.333,7,11,18,1,3,4,1,6,27,17
Dakari Johnson,C,22,OKC,31,6,161,22,39,.564,0,0,0,22,39,.564,.564,11,20,.550,16,18,34,8,6,8,3,27,55,17
James Johnson,PF,30,MIA,73,41,1943,309,614,.503,57,185,.308,252,429,.587,.550,113,162,.698,61,297,358,280,70,51,141,192,788,17
Joe Johnson,SF,36,TOT,55,4,1205,146,360,.406,40,145,.276,106,215,.493,.461,40,45,.889,14,158,172,83,18,7,49,67,372,17
Joe Johnson,SF,36,UTA,32,3,700,95,226,.420,23,84,.274,72,142,.507,.471,20,24,.833,12,95,107,45,12,6,31,32,233,17
Joe Johnson,SF,36,HOU,23,1,505,51,134,.381,17,61,.279,34,73,.466,.444,20,21,.952,2,63,65,38,6,1,18,35,139,17
Omari Johnson,PF,28,MEM,4,0,75,9,21,.429,4,12,.333,5,9,.556,.524,0,0,0,4,7,11,7,2,0,3,6,22,17
Stanley Johnson,SF,21,DET,69,50,1894,210,560,.375,67,234,.286,143,326,.439,.435,112,145,.772,33,219,252,112,95,14,77,169,599,17
Tyler Johnson,PG,25,MIA,72,39,2052,309,711,.435,119,324,.367,190,387,.491,.518,106,129,.822,34,214,248,165,60,34,81,148,843,17
Wesley Johnson,SF,30,LAC,74,40,1486,150,368,.408,60,177,.339,90,191,.471,.489,43,58,.741,29,187,216,61,76,62,55,146,403,17
Nikola Jokić,C,22,DEN,75,73,2443,504,1010,.499,111,280,.396,393,730,.538,.554,266,313,.850,195,608,803,458,90,61,210,212,1385,17
Damian Jones,C,22,GSW,15,0,89,11,22,.500,0,0,0,11,22,.500,.500,3,5,.600,5,9,14,2,1,3,4,14,25,17
Derrick Jones Jr.,SF,20,TOT,20,8,245,21,53,.396,3,18,.167,18,35,.514,.425,16,24,.667,21,17,38,9,4,13,7,24,61,17
Derrick Jones Jr.,SF,20,PHO,6,0,33,2,4,.500,0,2,0,2,2,1.000,.500,5,6,.833,2,2,4,3,1,4,1,2,9,17
Derrick Jones Jr.,SF,20,MIA,14,8,212,19,49,.388,3,16,.188,16,33,.485,.418,11,18,.611,19,15,34,6,3,9,6,22,52,17
Jalen Jones,SF,24,TOT,16,0,181,26,68,.382,10,26,.385,16,42,.381,.456,12,19,.632,13,25,38,4,5,1,7,22,74,17
Jalen Jones,SF,24,NOP,4,0,19,1,4,.250,1,1,1.000,0,3,0,.375,2,2,1.000,0,3,3,0,0,0,0,2,5,17
Jalen Jones,SF,24,DAL,12,0,162,25,64,.391,9,25,.360,16,39,.410,.461,10,17,.588,13,22,35,4,5,1,7,20,69,17
Tyus Jones,PG,21,MIN,82,11,1467,150,328,.457,45,129,.349,105,199,.528,.526,71,81,.877,16,116,132,232,95,6,59,110,416,17
DeAndre Jordan,C,29,LAC,77,77,2424,373,578,.645,0,0,0,373,578,.645,.645,181,312,.580,329,842,1171,117,39,71,137,203,927,17
Cory Joseph,PG,26,IND,82,17,2210,256,604,.424,67,190,.353,189,414,.457,.479,70,94,.745,39,224,263,260,80,18,87,141,649,17
Frank Kaminsky,PF,24,CHO,79,4,1835,307,716,.429,104,274,.380,203,442,.459,.501,155,194,.799,46,242,288,129,36,19,66,95,873,17
Luke Kennard,SG,21,DET,73,9,1463,206,465,.443,81,195,.415,125,270,.463,.530,65,76,.855,21,155,176,124,44,13,69,86,558,17
Michael Kidd-Gilchrist,SF,24,CHO,74,74,1850,282,560,.504,0,2,0,282,558,.505,.504,117,171,.684,84,218,302,71,51,32,53,143,681,17
Sean Kilpatrick,SG,28,TOT,52,1,640,110,294,.374,46,144,.319,64,150,.427,.452,64,72,.889,5,82,87,46,13,5,38,33,330,17
Sean Kilpatrick,SG,28,BRK,16,0,183,25,87,.287,11,43,.256,14,44,.318,.351,18,19,.947,1,34,35,15,2,1,16,8,79,17
Sean Kilpatrick,SG,28,MIL,23,0,205,31,82,.378,13,46,.283,18,36,.500,.457,18,19,.947,1,24,25,15,5,1,9,15,93,17
Sean Kilpatrick,SG,28,LAC,4,0,38,7,18,.389,3,7,.429,4,11,.364,.472,2,2,1.000,0,2,2,3,0,0,1,2,19,17
Sean Kilpatrick,SG,28,CHI,9,1,214,47,107,.439,19,48,.396,28,59,.475,.528,26,32,.813,3,22,25,13,6,3,12,8,139,17
Maxi Kleber,PF,26,DAL,72,36,1206,151,309,.489,40,128,.313,111,181,.613,.553,44,59,.746,71,163,234,51,26,47,30,114,386,17
Furkan Korkmaz,SG,20,PHI,14,0,80,8,28,.286,5,17,.294,3,11,.273,.375,2,4,.500,2,9,11,4,2,1,2,12,23,17
Luke Kornet,PF,22,NYK,20,1,326,49,125,.392,28,79,.354,21,46,.457,.504,8,11,.727,11,53,64,26,6,16,12,28,134,17
Kyle Korver,SG,36,CLE,73,4,1574,222,484,.459,164,376,.436,58,108,.537,.628,64,72,.889,9,156,165,88,31,27,55,130,672,17
Kosta Koufos,C,28,SAC,71,13,1391,222,389,.571,0,0,0,222,389,.571,.571,33,74,.446,149,323,472,87,47,32,49,146,477,17
Kyle Kuzma,PF,22,LAL,77,37,2401,468,1039,.450,159,434,.366,309,605,.511,.527,147,208,.707,88,395,483,141,49,34,140,160,1242,17
Mindaugas Kuzminskas,SF,28,NYK,1,0,2,0,2,0,0,0,0,0,2,0,0,0,0,0,0,0,0,0,0,0,0,0,0,17
Skal Labissière,PF,21,SAC,60,28,1240,205,458,.448,18,51,.353,187,407,.459,.467,95,118,.805,99,189,288,72,25,49,73,132,523,17
Jeremy Lamb,SG,25,CHO,80,18,1967,380,832,.457,94,254,.370,286,578,.495,.513,179,208,.861,49,275,324,186,61,32,93,138,1033,17
Shane Larkin,PG,25,BOS,54,2,775,84,219,.384,31,86,.360,53,133,.398,.454,32,37,.865,15,77,92,98,29,2,33,58,231,17
Joffrey Lauvergne,C,26,SAS,55,1,534,98,190,.516,0,5,0,98,185,.530,.516,30,47,.638,63,108,171,41,9,3,33,45,226,17
Zach LaVine,SG,22,CHI,24,24,656,136,355,.383,42,123,.341,94,232,.405,.442,87,107,.813,9,85,94,72,24,4,43,55,401,17
Jake Layman,SF,23,POR,35,1,160,14,47,.298,4,20,.200,10,27,.370,.340,2,3,.667,4,12,16,11,6,4,5,13,34,17
T.J. Leaf,PF,20,IND,53,0,459,64,136,.471,18,42,.429,46,94,.489,.537,10,16,.625,29,53,82,9,5,4,10,45,156,17
Courtney Lee,SG,32,NYK,76,69,2310,343,755,.454,113,278,.406,230,477,.482,.529,114,124,.919,30,194,224,180,80,17,84,109,913,17
Damion Lee,SG,25,ATL,15,11,404,62,152,.408,15,60,.250,47,92,.511,.457,22,29,.759,11,60,71,29,19,1,14,25,161,17
Walt Lemon Jr.,PG,25,NOP,5,0,35,7,16,.438,1,1,1.000,6,15,.400,.469,2,3,.667,0,2,2,5,0,1,4,5,17,17
Alex Len,C,24,PHO,69,13,1395,214,378,.566,1,3,.333,213,375,.568,.567,158,231,.684,175,343,518,82,27,61,78,158,587,17
Kawhi Leonard,SF,26,SAS,9,9,210,52,111,.468,11,35,.314,41,76,.539,.518,31,38,.816,6,36,42,21,18,9,16,9,146,17
Meyers Leonard,C,25,POR,33,2,254,46,78,.590,11,26,.423,35,52,.673,.660,9,11,.818,12,58,70,17,7,0,10,36,112,17
Jon Leuer,PF,28,DET,8,0,136,15,36,.417,0,3,0,15,33,.455,.417,13,15,.867,7,25,32,5,1,3,7,16,43,17
Caris LeVert,SF,23,BRK,71,10,1864,320,735,.435,85,245,.347,235,490,.480,.493,133,187,.711,53,207,260,299,82,22,153,159,858,17
DeAndre Liggins,SG,29,TOT,58,4,724,40,106,.377,19,53,.358,21,53,.396,.467,2,5,.400,7,68,75,48,37,14,20,81,101,17
DeAndre Liggins,SG,29,MIL,31,1,480,22,65,.338,11,36,.306,11,29,.379,.423,2,5,.400,5,44,49,27,27,10,13,61,57,17
DeAndre Liggins,SG,29,NOP,27,3,244,18,41,.439,8,17,.471,10,24,.417,.537,0,0,0,2,24,26,21,10,4,7,20,44,17
Damian Lillard,PG,27,POR,73,73,2670,621,1415,.439,227,629,.361,394,786,.501,.519,493,538,.916,62,263,325,481,77,27,206,117,1962,17
Jeremy Lin,PG,29,BRK,1,1,25,5,12,.417,1,2,.500,4,10,.400,.458,7,7,1.000,0,0,0,4,0,0,3,3,18,17
Shaun Livingston,PG,32,GSW,71,7,1129,172,343,.501,0,5,0,172,338,.509,.501,50,61,.820,32,99,131,140,35,21,58,117,394,17
Kevon Looney,C,21,GSW,66,4,910,112,193,.580,1,5,.200,111,188,.590,.583,42,77,.545,83,132,215,42,34,56,31,106,267,17
Brook Lopez,C,29,LAL,74,72,1735,369,793,.465,112,325,.345,257,468,.549,.536,111,158,.703,74,220,294,126,30,98,98,195,961,17
Robin Lopez,C,29,CHI,64,64,1690,342,645,.530,4,14,.286,338,631,.536,.533,68,90,.756,134,156,290,124,14,53,107,109,756,17
Kevin Love,C,29,CLE,59,59,1651,334,729,.458,137,330,.415,197,399,.494,.552,234,266,.880,101,445,546,103,43,24,90,120,1039,17
Kyle Lowry,PG,31,TOR,78,78,2510,403,944,.427,238,596,.399,165,348,.474,.553,223,261,.854,66,368,434,537,85,19,183,192,1267,17
Timothé Luwawu-Cabarrot,SF,22,PHI,52,7,807,100,267,.375,53,158,.335,47,109,.431,.474,46,58,.793,14,58,72,54,12,5,38,97,299,17
Tyler Lydon,PF,21,DEN,1,0,2,0,0,0,0,0,0,0,0,0,0,0,0,0,0,0,0,0,0,0,0,0,0,17
Trey Lyles,PF,22,DEN,73,2,1391,270,550,.491,83,218,.381,187,332,.563,.566,101,143,.706,55,292,347,91,30,34,61,111,724,17
Shelvin Mack,PG,27,ORL,69,3,1365,178,414,.430,48,139,.345,130,275,.473,.488,69,97,.711,23,143,166,272,54,8,89,91,473,17
Josh Magette,PG,28,ATL,18,0,216,15,46,.326,8,22,.364,7,24,.292,.413,8,8,1.000,2,17,19,57,8,1,9,16,46,17
Ian Mahinmi,C,31,WAS,77,0,1145,138,248,.556,0,2,0,138,246,.561,.556,90,128,.703,135,177,312,53,38,42,100,230,366,17
Thon Maker,C,20,MIL,74,12,1238,130,316,.411,31,104,.298,99,212,.467,.460,65,93,.699,75,150,225,46,38,53,44,162,356,17
Boban Marjanović,C,29,TOT,39,1,337,79,148,.534,0,0,0,79,148,.534,.534,77,97,.794,48,96,144,22,10,11,36,51,235,17
Boban Marjanović,C,29,DET,19,1,171,41,79,.519,0,0,0,41,79,.519,.519,36,45,.800,15,42,57,14,4,6,22,28,118,17
Boban Marjanović,C,29,LAC,20,0,166,38,69,.551,0,0,0,38,69,.551,.551,41,52,.788,33,54,87,8,6,5,14,23,117,17
Lauri Markkanen,PF,20,CHI,68,68,2020,374,862,.434,145,401,.362,229,461,.497,.518,140,166,.843,79,429,508,79,39,40,83,103,1033,17
Jarell Martin,PF,23,MEM,73,36,1661,221,496,.446,34,98,.347,187,398,.470,.480,89,116,.767,97,221,318,73,39,49,86,211,565,17
Frank Mason III,PG,23,SAC,52,2,984,144,380,.379,31,86,.360,113,294,.384,.420,94,115,.817,30,100,130,147,34,10,65,72,413,17
Mangok Mathiang,C,25,CHO,4,0,20,4,7,.571,0,0,0,4,7,.571,.571,0,1,0,3,7,10,0,1,0,0,5,8,17
Wesley Matthews,SF,31,DAL,63,62,2131,283,697,.406,153,402,.381,130,295,.441,.516,83,101,.822,28,170,198,172,76,16,83,140,802,17
Luc Mbah a Moute,PF,31,HOU,61,15,1564,166,345,.481,63,173,.364,103,172,.599,.572,65,95,.684,22,164,186,55,72,25,68,100,460,17
James Michael McAdoo,PF,25,PHI,3,0,18,2,7,.286,2,7,.286,0,0,0,.429,2,2,1.000,0,2,2,0,0,1,1,1,8,17
Patrick McCaw,SG,22,GSW,57,10,961,92,225,.409,19,80,.238,73,145,.503,.451,26,34,.765,16,66,82,81,43,10,41,67,229,17
CJ McCollum,SG,26,POR,81,81,2923,667,1505,.443,189,476,.397,478,1029,.465,.506,209,250,.836,53,268,321,272,77,35,151,168,1732,17
T.J. McConnell,PG,25,PHI,76,1,1706,210,421,.499,27,62,.435,183,359,.510,.531,31,39,.795,37,189,226,303,92,13,112,122,478,17
Erik McCree,SF,24,UTA,4,0,8,0,2,0,0,1,0,0,1,0,0,0,0,0,0,1,1,0,1,0,1,0,0,17
Chris McCullough,PF,22,WAS,19,0,90,18,42,.429,1,8,.125,17,34,.500,.440,9,14,.643,7,18,25,4,0,5,2,8,46,17
Doug McDermott,SF,26,TOT,81,4,1768,237,508,.467,92,216,.426,145,292,.497,.557,64,81,.790,40,160,200,79,19,16,56,122,630,17
Doug McDermott,SF,26,NYK,55,1,1172,151,328,.460,53,137,.387,98,191,.513,.541,40,53,.755,33,101,134,50,10,12,34,73,395,17
Doug McDermott,SF,26,DAL,26,3,596,86,180,.478,39,79,.494,47,101,.465,.586,24,28,.857,7,59,66,29,9,4,22,49,235,17
JaVale McGee,C,30,GSW,65,17,615,136,219,.621,0,6,0,136,213,.638,.621,38,52,.731,59,110,169,33,21,57,27,91,310,17
Rodney McGruder,SG,26,MIA,18,2,299,36,73,.493,15,35,.429,21,38,.553,.596,4,8,.500,11,22,33,17,8,3,4,21,91,17
Trey McKinney-Jones,SG,27,IND,1,0,1,0,0,0,0,0,0,0,0,0,0,0,0,0,0,0,0,0,0,0,0,0,0,17
Alfonzo McKinnie,SF,25,TOR,14,0,53,8,15,.533,3,9,.333,5,6,.833,.633,2,3,.667,1,6,7,1,1,1,3,8,21,17
Ben McLemore,SG,24,MEM,56,17,1091,157,373,.421,55,159,.346,102,214,.477,.495,53,64,.828,34,105,139,51,38,15,61,139,422,17
Josh McRoberts,PF,30,DAL,2,0,6,0,1,0,0,1,0,0,0,0,0,0,0,0,0,0,0,0,0,0,0,2,0,17
Jodie Meeks,SG,30,WAS,77,0,1119,157,393,.399,72,210,.343,85,183,.464,.491,101,117,.863,15,111,126,70,29,4,37,55,487,17
Salah Mejri,C,31,DAL,61,1,729,88,137,.642,0,3,0,88,134,.657,.642,38,66,.576,85,161,246,35,22,67,39,121,214,17
Jordan Mickey,PF,23,MIA,23,3,284,39,82,.476,2,16,.125,37,66,.561,.488,13,19,.684,18,63,81,9,6,10,18,36,93,17
Khris Middleton,SF,26,MIL,82,82,2982,593,1272,.466,146,407,.359,447,865,.517,.524,320,362,.884,45,384,429,328,119,21,191,270,1652,17
C.J. Miles,SF,30,TOR,70,3,1337,227,599,.379,164,454,.361,63,145,.434,.516,81,97,.835,18,134,152,55,37,21,39,134,699,17
Darius Miller,SF,27,NOP,82,3,1944,216,487,.444,147,358,.411,69,129,.535,.594,58,67,.866,18,146,164,111,28,17,58,160,637,17
Malcolm Miller,SF,24,TOR,15,4,126,13,28,.464,8,21,.381,5,7,.714,.607,4,4,1.000,4,11,15,3,1,2,5,10,38,17
Patty Mills,PG,29,SAS,82,36,2107,280,682,.411,154,414,.372,126,268,.470,.523,105,118,.890,26,128,154,229,55,11,106,128,819,17
Paul Millsap,PF,32,DEN,38,37,1143,202,435,.464,39,113,.345,163,322,.506,.509,112,161,.696,65,180,245,105,39,44,73,99,555,17
Nikola Mirotić,PF,26,TOT,55,14,1494,306,684,.447,135,358,.377,171,326,.525,.546,112,137,.818,59,346,405,80,44,39,62,108,859,17
Nikola Mirotić,PF,26,CHI,25,3,622,143,302,.474,69,161,.429,74,141,.525,.588,65,79,.823,18,141,159,39,15,13,31,45,420,17
Nikola Mirotić,PF,26,NOP,30,11,872,163,382,.427,66,197,.335,97,185,.524,.513,47,58,.810,41,205,246,41,29,26,31,63,439,17
Donovan Mitchell,SG,21,UTA,79,71,2638,595,1362,.437,187,550,.340,408,812,.502,.506,239,297,.805,52,244,296,291,118,27,215,213,1616,17
Naz Mitrou-Long,SG,24,UTA,1,0,1,1,1,1.000,1,1,1.000,0,0,0,1.500,0,0,0,0,0,0,0,0,0,0,0,3,17
Malik Monk,SG,19,CHO,63,0,854,153,425,.360,83,243,.342,70,182,.385,.458,32,38,.842,8,58,66,91,20,9,49,60,421,17
Greg Monroe,C,27,TOT,51,14,1040,218,386,.565,0,0,0,218,386,.565,.565,88,119,.739,109,241,350,114,44,23,94,95,524,17
Greg Monroe,C,27,MIL,5,0,79,16,33,.485,0,0,0,16,33,.485,.485,2,4,.500,6,19,25,5,0,0,6,7,34,17
Greg Monroe,C,27,PHO,20,14,465,97,155,.626,0,0,0,97,155,.626,.626,31,46,.674,50,110,160,50,16,6,40,40,225,17
Greg Monroe,C,27,BOS,26,0,496,105,198,.530,0,0,0,105,198,.530,.530,55,69,.797,53,112,165,59,28,17,48,48,265,17
Luis Montero,SG,24,DET,2,0,8,0,1,0,0,0,0,0,1,0,0,0,0,0,0,2,2,0,0,0,2,0,0,17
Ben Moore,PF,22,IND,2,0,9,0,0,0,0,0,0,0,0,0,0,0,0,0,0,1,1,1,0,0,0,4,0,17
E'Twaun Moore,SG,28,NOP,82,80,2586,423,832,.508,128,301,.425,295,531,.556,.585,48,68,.706,57,181,238,187,79,12,102,182,1022,17
Eric Moreland,PF,26,DET,67,3,805,66,122,.541,0,0,0,66,122,.541,.541,11,29,.379,81,197,278,78,31,51,42,116,143,17
Jaylen Morris,SG,22,ATL,6,0,98,13,32,.406,2,10,.200,11,22,.500,.438,0,0,0,2,14,16,7,2,1,6,2,28,17
Marcus Morris,PF,28,BOS,54,21,1442,262,611,.429,86,234,.368,176,377,.467,.499,124,154,.805,43,246,289,72,35,12,65,100,734,17
Markieff Morris,PF,28,WAS,73,73,1968,330,687,.480,76,207,.367,254,480,.529,.536,105,128,.820,75,334,409,142,56,38,127,216,841,17
Monte Morris,PG,22,DEN,3,0,25,4,6,.667,0,1,0,4,5,.800,.667,2,2,1.000,0,2,2,7,3,0,1,1,10,17
Johnathan Motley,PF,22,DAL,11,4,176,40,75,.533,1,6,.167,39,69,.565,.540,15,28,.536,14,35,49,7,3,2,9,18,96,17
Timofey Mozgov,C,31,BRK,31,13,359,52,93,.559,4,18,.222,48,75,.640,.581,23,30,.767,32,66,98,11,5,13,33,39,131,17
Emmanuel Mudiay,PG,21,TOT,64,14,1245,204,526,.388,47,148,.318,157,378,.415,.433,98,129,.760,26,126,152,206,41,11,113,80,553,17
Emmanuel Mudiay,PG,21,DEN,42,0,752,129,322,.401,38,102,.373,91,220,.414,.460,63,78,.808,16,78,94,121,21,4,72,47,359,17
Emmanuel Mudiay,PG,21,NYK,22,14,493,75,204,.368,9,46,.196,66,158,.418,.390,35,51,.686,10,48,58,85,20,7,41,33,194,17
Shabazz Muhammad,SF-SG,25,TOT,43,2,418,84,188,.447,7,27,.259,77,161,.478,.465,39,50,.780,23,53,76,14,9,3,6,30,214,17
Shabazz Muhammad,SF,25,MIN,32,2,301,47,121,.388,4,19,.211,43,102,.422,.405,22,31,.710,15,30,45,7,5,2,5,23,120,17
Shabazz Muhammad,SG,25,MIL,11,0,117,37,67,.552,3,8,.375,34,59,.576,.575,17,19,.895,8,23,31,7,4,1,1,7,94,17
Xavier Munford,SG,25,MIL,6,0,21,1,6,.167,0,2,0,1,4,.250,.167,1,2,.500,1,0,1,4,1,0,2,4,3,17
Dejounte Murray,PG,21,SAS,81,48,1743,270,609,.443,9,34,.265,261,575,.454,.451,105,148,.709,110,349,459,231,97,31,134,151,654,17
Jamal Murray,PG,20,DEN,81,80,2565,479,1062,.451,165,436,.378,314,626,.502,.529,229,253,.905,82,215,297,274,79,28,172,173,1352,17
Mike Muscala,C,26,ATL,53,7,1060,143,312,.458,62,167,.371,81,145,.559,.558,57,62,.919,56,174,230,51,31,27,42,80,405,17
Abdel Nader,SF,24,BOS,48,1,522,50,149,.336,23,65,.354,27,84,.321,.413,23,39,.590,13,58,71,26,15,10,34,45,146,17
Larry Nance Jr.,C,25,TOT,66,27,1421,240,413,.581,2,12,.167,238,401,.594,.584,91,137,.664,161,291,452,82,88,38,51,172,573,17
Larry Nance Jr.,C,25,LAL,42,17,922,152,253,.601,1,4,.250,151,249,.606,.603,55,87,.632,108,176,284,57,59,20,41,113,360,17
Larry Nance Jr.,C,25,CLE,24,10,499,88,160,.550,1,8,.125,87,152,.572,.553,36,50,.720,53,115,168,25,29,18,10,59,213,17
Shabazz Napier,PG,26,POR,74,10,1535,223,531,.420,82,218,.376,141,313,.450,.497,116,138,.841,26,144,170,150,81,14,90,84,644,17
Jameer Nelson,PG,35,TOT,50,0,1013,95,244,.389,41,124,.331,54,120,.450,.473,16,20,.800,13,91,104,179,27,4,67,81,247,17
Jameer Nelson,PG,35,NOP,43,0,897,84,205,.410,40,110,.364,44,95,.463,.507,13,17,.765,11,85,96,156,23,3,56,67,221,17
Jameer Nelson,PG,35,DET,7,0,116,11,39,.282,1,14,.071,10,25,.400,.295,3,3,1.000,2,6,8,23,4,1,11,14,26,17
Raul Neto,PG,25,UTA,41,0,498,69,151,.457,19,47,.404,50,104,.481,.520,26,35,.743,7,42,49,75,13,4,36,38,183,17
Georges Niang,PF,24,UTA,9,0,32,4,11,.364,0,4,0,4,7,.571,.364,1,2,.500,3,6,9,3,2,0,3,1,9,17
Joakim Noah,C,32,NYK,7,0,40,5,10,.500,0,0,0,5,10,.500,.500,2,4,.500,6,8,14,4,2,2,4,5,12,17
Nerlens Noel,C,23,DAL,30,6,472,55,105,.524,0,1,0,55,104,.529,.524,21,28,.750,48,120,168,20,31,22,26,59,131,17
Lucas Nogueira,C,25,TOR,49,3,418,49,80,.613,5,19,.263,44,61,.721,.644,19,28,.679,18,69,87,22,23,43,16,49,122,17
Dirk Nowitzki,C,39,DAL,77,77,1900,346,758,.456,138,337,.409,208,421,.494,.547,97,108,.898,22,416,438,120,43,45,51,146,927,17
Frank Ntilikina,PG,19,NYK,78,9,1706,182,500,.364,50,157,.318,132,343,.385,.414,49,68,.721,37,140,177,250,65,18,131,181,463,17
Jusuf Nurkić,C,23,POR,79,79,2088,480,951,.505,0,7,0,480,944,.508,.505,172,273,.630,189,519,708,143,64,111,183,247,1132,17
David Nwaba,SG,25,CHI,70,21,1646,202,423,.478,18,52,.346,184,371,.496,.499,133,203,.655,89,237,326,104,59,29,77,158,555,17
Johnny O'Bryant,PF,24,CHO,36,0,379,68,171,.398,14,43,.326,54,128,.422,.439,21,25,.840,29,64,93,14,9,6,15,45,171,17
Royce O'Neale,SF,24,UTA,69,4,1150,120,284,.423,42,118,.356,78,166,.470,.496,61,76,.803,25,211,236,95,36,16,55,105,343,17
Kyle O'Quinn,C,27,NYK,77,10,1387,224,384,.583,4,17,.235,220,367,.599,.589,98,127,.772,121,349,470,158,36,98,100,192,550,17
Semi Ojeleye,PF,23,BOS,73,0,1150,65,188,.346,40,125,.320,25,63,.397,.452,25,41,.610,37,124,161,20,21,4,25,91,195,17
Emeka Okafor,C,35,NOP,26,19,353,48,95,.505,0,0,0,48,95,.505,.505,18,22,.818,47,73,120,8,8,25,13,30,114,17
Jahlil Okafor,C,22,TOT,28,0,353,77,138,.558,1,4,.250,76,134,.567,.562,21,29,.724,21,64,85,12,3,18,21,51,176,17
Jahlil Okafor,C,22,PHI,2,0,25,4,9,.444,0,0,0,4,9,.444,.444,2,4,.500,4,5,9,1,0,2,3,7,10,17
Jahlil Okafor,C,22,BRK,26,0,328,73,129,.566,1,4,.250,72,125,.576,.570,19,25,.760,17,59,76,11,3,16,18,44,166,17
Victor Oladipo,SG,25,IND,75,75,2552,640,1342,.477,161,434,.371,479,908,.528,.537,294,368,.799,47,343,390,323,177,57,219,175,1735,17
Kelly Olynyk,PF,26,MIA,76,22,1779,316,636,.497,106,280,.379,210,356,.590,.580,134,174,.770,89,342,431,207,62,35,147,222,872,17
Chinanu Onuaku,C,21,HOU,1,0,22,2,5,.400,0,0,0,2,5,.400,.400,0,0,0,1,3,4,1,0,0,3,4,4,17
Cedi Osman,SF,22,CLE,61,12,672,90,186,.484,32,87,.368,58,99,.586,.570,26,46,.565,19,101,120,41,22,3,32,78,238,17
Kelly Oubre Jr.,SF,22,WAS,81,11,2231,318,790,.403,126,369,.341,192,421,.456,.482,191,233,.820,59,304,363,98,80,35,90,234,953,17
Zaza Pachulia,C,33,GSW,69,57,972,149,264,.564,0,1,0,149,263,.567,.564,75,93,.806,89,232,321,109,38,17,72,122,373,17
Marcus Paige,PG,24,CHO,5,0,28,4,14,.286,2,8,.250,2,6,.333,.357,2,2,1.000,0,4,4,3,0,0,0,0,12,17
Georgios Papagiannis,C,20,TOT,17,0,122,18,42,.429,0,0,0,18,42,.429,.429,0,0,0,13,24,37,9,4,6,8,12,36,17
Georgios Papagiannis,C,20,SAC,16,0,118,17,41,.415,0,0,0,17,41,.415,.415,0,0,0,12,24,36,9,2,6,8,12,34,17
Georgios Papagiannis,C,20,POR,1,0,4,1,1,1.000,0,0,0,1,1,1.000,1.000,0,0,0,1,0,1,0,2,0,0,0,2,17
Jabari Parker,PF,22,MIL,31,3,743,160,332,.482,31,81,.383,129,251,.514,.529,40,54,.741,42,109,151,59,25,10,45,50,391,17
Tony Parker,PG,35,SAS,55,21,1071,178,388,.459,10,37,.270,168,351,.479,.472,55,78,.705,7,88,95,195,28,1,68,52,421,17
Chandler Parsons,SF,29,MEM,36,8,691,108,234,.462,51,121,.421,57,113,.504,.571,17,27,.630,14,76,90,69,18,11,35,53,284,17
Patrick Patterson,PF,28,OKC,82,3,1270,106,266,.398,66,171,.386,40,95,.421,.523,40,46,.870,32,161,193,57,48,23,33,87,318,17
Justin Patton,C,20,MIN,1,0,4,1,2,.500,0,0,0,1,2,.500,.500,0,0,0,0,0,0,0,1,0,0,1,2,17
Brandon Paul,SG,26,SAS,64,2,576,55,127,.433,15,54,.278,40,73,.548,.492,22,43,.512,6,62,68,37,25,7,29,58,147,17
Chris Paul,PG,32,HOU,58,58,1847,367,798,.460,144,379,.380,223,419,.532,.550,203,221,.919,37,276,313,457,96,14,128,141,1081,17
Adreian Payne,PF,26,ORL,5,0,43,7,10,.700,2,3,.667,5,7,.714,.800,5,6,.833,2,7,9,0,2,0,2,6,21,17
Cameron Payne,PG,23,CHI,25,14,582,87,215,.405,35,91,.385,52,124,.419,.486,12,16,.750,18,51,69,113,26,9,36,44,221,17
Elfrid Payton,PG,23,TOT,63,63,1808,329,667,.493,30,92,.326,299,575,.520,.516,109,168,.649,64,210,274,393,83,22,168,147,797,17
Elfrid Payton,PG,23,ORL,44,44,1257,238,458,.520,25,67,.373,213,391,.545,.547,72,114,.632,47,127,174,275,64,16,114,97,573,17
Elfrid Payton,PG,23,PHO,19,19,551,91,209,.435,5,25,.200,86,184,.467,.447,37,54,.685,17,83,100,118,19,6,54,50,224,17
Gary Payton II,PG,25,TOT,23,6,221,30,74,.405,6,25,.240,24,49,.490,.446,3,9,.333,13,31,44,21,7,3,7,30,69,17
Gary Payton II,PG,25,MIL,12,6,106,13,33,.394,2,12,.167,11,21,.524,.424,2,3,.667,4,13,17,9,3,1,3,17,30,17
Gary Payton II,PG,25,LAL,11,0,115,17,41,.415,4,13,.308,13,28,.464,.463,1,6,.167,9,18,27,12,4,2,4,13,39,17
Kendrick Perkins,C,33,CLE,1,0,15,1,2,.500,0,0,0,1,2,.500,.500,1,2,.500,0,1,1,2,1,0,1,1,3,17
London Perrantes,PG,23,CLE,14,0,66,2,13,.154,0,3,0,2,10,.200,.154,3,5,.600,1,3,4,5,2,1,1,6,7,17
Alec Peters,PF,22,PHO,20,0,225,28,74,.378,18,58,.310,10,16,.625,.500,8,10,.800,8,29,37,12,2,2,4,13,82,17
Marshall Plumlee,C,25,MIL,8,0,52,1,3,.333,0,0,0,1,3,.333,.333,12,16,.750,4,13,17,2,0,1,3,10,14,17
Mason Plumlee,C,27,DEN,74,26,1439,221,368,.601,0,1,0,221,367,.602,.601,82,179,.458,132,268,400,142,49,81,103,184,524,17
Miles Plumlee,C,29,ATL,55,35,918,105,180,.583,0,0,0,105,180,.583,.583,27,60,.450,77,151,228,45,17,30,63,79,237,17
Jakob Poeltl,C,22,TOR,82,0,1524,253,384,.659,1,2,.500,252,382,.660,.660,60,101,.594,165,228,393,57,39,100,85,212,567,17
Quincy Pondexter,SF,29,CHI,23,1,196,14,49,.286,3,22,.136,11,27,.407,.316,14,17,.824,8,19,27,9,8,2,11,24,45,17
Otto Porter Jr.,SF,24,WAS,77,77,2432,445,885,.503,138,313,.441,307,572,.537,.581,106,128,.828,103,389,492,157,116,41,75,151,1134,17
Bobby Portis,PF,22,CHI,73,4,1643,382,811,.471,80,223,.359,302,588,.514,.520,120,156,.769,159,339,498,123,50,23,103,130,964,17
Kristaps Porziņģis,PF,22,NYK,48,48,1553,390,889,.439,90,228,.395,300,661,.454,.489,218,275,.793,62,254,316,57,36,115,93,141,1088,17
Dwight Powell,C,26,DAL,79,25,1672,255,430,.593,28,84,.333,227,346,.656,.626,133,185,.719,135,309,444,91,67,32,59,186,671,17
Norman Powell,SG,24,TOR,70,18,1062,150,374,.401,53,186,.285,97,188,.516,.472,32,39,.821,14,105,119,89,37,16,66,111,385,17
Alex Poythress,PF,24,IND,25,0,104,11,26,.423,4,11,.364,7,15,.467,.500,0,0,0,7,10,17,2,3,1,2,16,26,17
Taurean Prince,SF,23,ATL,82,82,2464,415,975,.426,176,457,.385,239,518,.461,.516,152,180,.844,50,339,389,214,85,42,191,168,1158,17
Jacob Pullen,PG,28,PHI,3,0,6,1,2,.500,0,1,0,1,1,1.000,.500,0,0,0,0,0,0,0,0,0,1,0,2,17
Rodney Purvis,SG,23,ORL,16,2,290,35,107,.327,13,52,.250,22,55,.400,.388,13,15,.867,1,26,27,17,3,3,10,26,96,17
Zhou Qi,C,22,HOU,18,0,124,6,32,.188,2,19,.105,4,13,.308,.219,8,12,.667,6,16,22,2,2,14,10,14,22,17
Tim Quarterman,SG,23,HOU,3,0,13,1,3,.333,0,2,0,1,1,1.000,.333,2,2,1.000,0,3,3,1,0,0,2,1,4,17
Ivan Rabb,PF,20,MEM,36,5,516,86,152,.566,0,0,0,86,152,.566,.566,29,36,.806,53,105,158,32,12,13,35,55,201,17
Julius Randle,C,23,LAL,82,49,2190,504,904,.558,10,45,.222,494,859,.575,.563,305,425,.718,181,473,654,210,43,45,213,274,1323,17
Zach Randolph,PF,36,SAC,59,57,1508,361,763,.473,51,147,.347,310,616,.503,.507,84,107,.785,97,300,397,127,42,10,116,119,857,17
Xavier Rathan-Mayes,SG,23,MEM,5,0,118,12,42,.286,1,14,.071,11,28,.393,.298,4,9,.444,0,5,5,18,6,3,11,18,29,17
J.J. Redick,SG,33,PHI,70,70,2116,404,879,.460,193,460,.420,211,419,.504,.569,197,218,.904,9,169,178,210,35,6,103,123,1198,17
Davon Reed,SG,22,PHO,21,1,242,22,76,.289,11,38,.289,11,38,.289,.362,8,12,.667,2,37,39,13,10,2,10,17,63,17
Willie Reed,C,27,TOT,42,5,428,81,121,.669,1,2,.500,80,119,.672,.674,32,55,.582,35,86,121,10,9,22,19,56,195,17
Willie Reed,C,27,LAC,39,5,419,80,120,.667,1,2,.500,79,118,.669,.671,32,55,.582,35,85,120,9,9,22,19,53,193,17
Willie Reed,C,27,DET,3,0,9,1,1,1.000,0,0,0,1,1,1.000,1.000,0,0,0,0,1,1,1,0,0,0,3,2,17
Josh Richardson,SF,24,MIA,81,81,2689,399,885,.451,127,336,.378,272,549,.495,.523,120,142,.845,69,216,285,231,121,75,140,199,1045,17
Malachi Richardson,SG,22,TOT,26,4,324,30,90,.333,12,40,.300,18,50,.360,.400,17,22,.773,5,29,34,13,10,1,10,27,89,17
Malachi Richardson,SG,22,SAC,25,4,319,29,88,.330,12,39,.308,17,49,.347,.398,17,22,.773,5,28,33,13,10,1,10,27,87,17
Malachi Richardson,SG,22,TOR,1,0,5,1,2,.500,0,1,0,1,1,1.000,.500,0,0,0,0,1,1,0,0,0,0,0,2,17
Austin Rivers,SG,25,LAC,61,59,2057,341,805,.424,136,360,.378,205,445,.461,.508,102,159,.642,27,118,145,242,74,16,109,152,920,17
Andre Roberson,SG,26,OKC,39,39,1037,87,162,.537,8,36,.222,79,126,.627,.562,12,38,.316,75,110,185,46,45,35,30,89,194,17
Devin Robinson,SF,22,WAS,1,0,13,1,3,.333,0,0,0,1,3,.333,.333,0,0,0,2,3,5,0,1,0,0,2,2,17
Glenn Robinson III,SF,24,IND,23,1,338,36,85,.424,14,34,.412,22,51,.431,.506,9,11,.818,11,26,37,17,13,1,5,14,95,17
Rajon Rondo,PG,31,NOP,65,63,1705,231,494,.468,50,150,.333,181,344,.526,.518,25,46,.543,31,232,263,533,70,10,151,119,537,17
Derrick Rose,PG,29,TOT,25,7,420,81,186,.435,7,30,.233,74,156,.474,.454,40,46,.870,13,22,35,37,7,4,35,16,209,17
Derrick Rose,PG,29,CLE,16,7,308,58,132,.439,6,24,.250,52,108,.481,.462,35,41,.854,10,19,29,26,3,4,28,14,157,17
Derrick Rose,PG,29,MIN,9,0,112,23,54,.426,1,6,.167,22,48,.458,.435,5,5,1.000,3,3,6,11,4,0,7,2,52,17
Terrence Ross,SG,26,ORL,24,20,600,76,191,.398,30,93,.323,46,98,.469,.476,27,36,.750,10,63,73,38,27,11,29,45,209,17
Terry Rozier,PG,23,BOS,80,16,2068,316,800,.395,153,402,.381,163,398,.410,.491,115,149,.772,63,313,376,232,80,19,80,123,900,17
Ricky Rubio,PG,27,UTA,77,77,2254,346,827,.418,96,273,.352,250,554,.451,.476,220,254,.866,44,307,351,410,121,11,207,206,1008,17
D'Angelo Russell,PG,21,BRK,48,35,1234,278,672,.414,90,278,.324,188,394,.477,.481,97,131,.740,30,159,189,249,36,17,147,93,743,17
Domantas Sabonis,C,21,IND,74,19,1810,340,661,.514,13,37,.351,327,624,.524,.524,168,224,.750,165,407,572,151,40,32,137,220,861,17
JaKarr Sampson,SF,24,SAC,22,6,344,44,81,.543,5,10,.500,39,71,.549,.574,10,16,.625,21,57,78,9,8,22,8,48,103,17
Dario Šarić,PF,23,PHI,78,73,2310,403,890,.453,157,399,.393,246,491,.501,.541,178,207,.860,154,366,520,202,51,20,148,160,1141,17
Tomáš Satoranský,SG,26,WAS,73,30,1643,201,384,.523,47,101,.465,154,283,.544,.585,75,96,.781,72,161,233,286,52,15,83,131,524,17
Dennis Schröder,PG,24,ATL,67,67,2078,500,1146,.436,76,262,.290,424,884,.480,.469,225,265,.849,44,164,208,417,72,6,183,147,1301,17
Mike Scott,PF,29,WAS,76,1,1406,276,524,.527,66,163,.405,210,361,.582,.590,50,76,.658,50,197,247,80,23,10,79,148,668,17
Thabo Sefolosha,SF,33,UTA,38,6,806,118,240,.492,32,84,.381,86,156,.551,.558,44,54,.815,29,132,161,33,52,12,30,59,312,17
Wayne Selden,SG,23,MEM,35,9,692,116,269,.431,49,122,.402,67,147,.456,.522,44,59,.746,16,40,56,66,18,5,54,59,325,17
Ramon Sessions,PG,31,TOT,28,3,392,42,117,.359,8,26,.308,34,91,.374,.393,44,57,.772,6,32,38,77,14,2,30,29,136,17
Ramon Sessions,PG,31,NYK,13,3,167,17,53,.321,2,11,.182,15,42,.357,.340,12,15,.800,1,17,18,27,7,1,15,14,48,17
Ramon Sessions,PG,31,WAS,15,0,225,25,64,.391,6,15,.400,19,49,.388,.438,32,42,.762,5,15,20,50,7,1,15,15,88,17
Iman Shumpert,SG,27,CLE,14,6,276,22,58,.379,7,26,.269,15,32,.469,.440,11,15,.733,7,34,41,17,9,4,16,22,62,17
Pascal Siakam,PF,23,TOR,81,5,1679,253,498,.508,29,132,.220,224,366,.612,.537,54,87,.621,79,285,364,159,62,42,67,166,589,17
Xavier Silas,SG,30,BOS,2,0,7,0,3,0,0,2,0,0,1,0,0,0,0,0,1,1,2,0,1,0,0,1,0,17
Ben Simmons,PG,21,PHI,81,81,2732,544,998,.545,0,11,0,544,987,.551,.545,191,341,.560,145,514,659,661,140,70,278,211,1279,17
Jonathon Simmons,SG,28,ORL,69,50,2029,354,761,.465,69,204,.338,285,557,.512,.511,185,241,.768,61,178,239,171,58,16,146,175,962,17
Kobi Simmons,PG,20,MEM,32,12,643,80,189,.423,11,39,.282,69,150,.460,.452,25,25,1.000,14,36,50,68,18,5,44,61,196,17
Kyle Singler,SF,29,OKC,12,0,59,7,21,.333,2,5,.400,5,16,.313,.381,7,13,.538,1,9,10,2,1,0,3,4,23,17
Marcus Smart,SG,23,BOS,54,11,1614,189,515,.367,75,249,.301,114,266,.429,.440,97,133,.729,43,146,189,259,71,23,129,133,550,17
Dennis Smith Jr.,PG,20,DAL,69,69,2049,404,1024,.395,106,339,.313,298,685,.435,.446,134,193,.694,50,210,260,358,71,18,194,152,1048,17
Ish Smith,PG,29,DET,82,35,2043,389,801,.486,35,101,.347,354,700,.506,.507,81,116,.698,27,197,224,360,64,20,108,140,894,17
J.R. Smith,SG,32,CLE,80,61,2244,240,595,.403,143,381,.375,97,214,.453,.524,39,56,.696,29,206,235,141,68,11,81,161,662,17
Jason Smith,C,31,WAS,33,2,285,45,115,.391,4,32,.125,41,83,.494,.409,19,21,.905,18,35,53,14,3,13,16,44,113,17
Josh Smith,PF,32,NOP,3,0,12,1,4,.250,0,0,0,1,4,.250,.250,0,0,0,3,1,4,0,0,0,0,3,2,17
Tony Snell,SG,26,MIL,75,59,2053,185,425,.435,108,268,.403,77,157,.490,.562,38,48,.792,9,132,141,98,47,28,36,115,516,17
Marreese Speights,C,30,ORL,52,3,675,138,349,.395,86,233,.369,52,116,.448,.519,40,55,.727,21,112,133,40,8,22,40,106,402,17
Nik Stauskas,SG,24,TOT,41,0,523,60,154,.390,40,100,.400,20,54,.370,.519,21,29,.724,4,60,64,39,9,4,26,24,181,17
Nik Stauskas,SG,24,PHI,6,0,45,1,4,.250,0,1,0,1,3,.333,.250,2,2,1.000,0,1,1,1,4,0,4,3,4,17
Nik Stauskas,SG,24,BRK,35,0,478,59,150,.393,40,99,.404,19,51,.373,.527,19,27,.704,4,59,63,38,5,4,22,21,177,17
Lance Stephenson,SG,27,IND,82,7,1850,303,709,.427,67,232,.289,236,477,.495,.475,84,127,.661,62,362,424,235,46,17,131,177,757,17
David Stockton,PG,26,UTA,3,0,9,2,3,.667,2,3,.667,0,0,0,1.000,4,4,1.000,0,0,0,0,0,0,1,3,10,17
Julyan Stone,SG,29,CHO,23,0,175,6,13,.462,6,13,.462,0,0,0,.692,1,2,.500,1,28,29,26,4,2,7,21,19,17
Edmond Sumner,PG,22,IND,1,0,2,1,1,1.000,0,0,0,1,1,1.000,1.000,0,0,0,0,1,1,0,0,0,0,1,2,17
Caleb Swanigan,PF,20,POR,27,3,189,24,60,.400,1,8,.125,23,52,.442,.408,12,18,.667,15,39,54,14,5,3,18,37,61,17
Jayson Tatum,SF,19,BOS,80,80,2443,397,835,.475,105,242,.434,292,593,.492,.538,213,258,.826,50,352,402,128,83,58,114,170,1112,17
Isaiah Taylor,PG,23,ATL,67,9,1167,163,390,.418,20,80,.250,143,310,.461,.444,99,141,.702,22,72,94,206,34,10,84,116,445,17
Jeff Teague,PG,29,MIN,70,70,2311,354,794,.446,84,228,.368,270,566,.477,.499,202,239,.845,24,185,209,492,102,23,177,171,994,17
Marquis Teague,PG,24,MEM,3,0,74,4,16,.250,1,4,.250,3,12,.250,.281,2,5,.400,1,5,6,13,4,0,3,5,11,17
Mirza Teletović,PF,32,MIL,10,0,159,25,57,.439,21,45,.467,4,12,.333,.623,0,0,0,3,20,23,10,4,1,7,14,71,17
Garrett Temple,SG,31,SAC,65,35,1615,199,476,.418,89,227,.392,110,249,.442,.512,60,78,.769,22,130,152,124,57,27,79,135,547,17
Miloš Teodosić,PG,30,LAC,45,36,1134,151,360,.419,88,232,.379,63,128,.492,.542,39,46,.848,16,110,126,209,23,5,97,103,429,17
Jason Terry,SG,40,MIL,51,4,814,59,154,.383,40,115,.348,19,39,.487,.513,8,9,.889,5,43,48,59,42,13,25,52,166,17
Daniel Theis,C,25,BOS,63,3,936,126,233,.541,18,58,.310,108,175,.617,.579,61,81,.753,90,184,274,56,30,48,56,157,331,17
Isaiah Thomas,PG,28,TOT,32,15,862,157,421,.373,55,188,.293,102,233,.438,.438,117,131,.893,17,50,67,153,15,3,95,58,486,17
Isaiah Thomas,PG,28,CLE,15,14,406,70,194,.361,22,87,.253,48,107,.449,.418,59,68,.868,7,24,31,68,9,2,41,25,221,17
Isaiah Thomas,PG,28,LAL,17,1,456,87,227,.383,33,101,.327,54,126,.429,.456,58,63,.921,10,26,36,85,6,1,54,33,265,17
Lance Thomas,PF,29,NYK,73,31,1353,102,267,.382,50,124,.403,52,143,.364,.476,44,53,.830,44,131,175,44,30,14,40,134,298,17
Klay Thompson,SG,27,GSW,73,73,2506,575,1179,.488,229,521,.440,346,658,.526,.585,82,98,.837,31,246,277,185,55,34,128,117,1461,17
Tristan Thompson,C,26,CLE,53,22,1072,132,235,.562,0,0,0,132,235,.562,.562,43,79,.544,126,226,352,33,16,17,36,102,307,17
Sindarius Thornwell,SG,23,LAC,73,17,1156,100,233,.429,23,61,.377,77,172,.448,.479,59,88,.670,33,107,140,68,48,25,53,125,282,17
Anthony Tolliver,PF,32,DET,79,14,1757,219,472,.464,159,365,.436,60,107,.561,.632,106,133,.797,50,191,241,90,32,21,58,144,703,17
Karl-Anthony Towns,C,22,MIN,82,82,2918,639,1172,.545,120,285,.421,519,887,.585,.596,345,402,.858,238,774,1012,199,64,115,159,285,1743,17
P.J. Tucker,PF,32,HOU,82,34,2281,172,441,.390,115,310,.371,57,131,.435,.520,43,60,.717,93,364,457,77,78,26,74,205,502,17
Evan Turner,SF,29,POR,79,40,2034,258,577,.447,42,132,.318,216,445,.485,.484,91,107,.850,30,214,244,173,47,29,99,163,649,17
Myles Turner,C,21,IND,65,62,1836,306,639,.479,56,157,.357,250,482,.519,.523,160,206,.777,93,324,417,87,38,118,96,186,828,17
Ekpe Udoh,C,30,UTA,63,3,810,60,120,.500,0,1,0,60,119,.504,.500,42,56,.750,68,82,150,53,43,74,20,105,162,17
Tyler Ulis,PG,22,PHO,71,43,1658,214,551,.388,42,146,.288,172,405,.425,.426,84,101,.832,24,104,128,311,70,7,127,120,554,17
Jonas Valančiūnas,C,25,TOR,77,77,1727,390,687,.568,30,74,.405,360,613,.587,.590,170,211,.806,183,477,660,81,29,69,115,192,980,17
Denzel Valentine,SG,24,CHI,77,37,2095,301,721,.417,143,370,.386,158,351,.450,.517,38,51,.745,48,345,393,244,65,11,99,185,783,17
Fred VanVleet,PG,23,TOR,76,0,1520,232,545,.426,108,261,.414,124,284,.437,.525,84,101,.832,25,159,184,243,68,19,74,130,656,17
Rashad Vaughn,SG,21,TOT,28,0,212,23,56,.411,14,37,.378,9,19,.474,.536,4,6,.667,3,18,21,13,5,3,6,15,64,17
Rashad Vaughn,SG,21,MIL,22,0,173,21,50,.420,13,35,.371,8,15,.533,.550,4,6,.667,2,15,17,12,4,3,4,12,59,17
Rashad Vaughn,SG,21,BRK,1,0,4,0,0,0,0,0,0,0,0,0,0,0,0,0,0,0,0,1,0,0,0,1,0,17
Rashad Vaughn,SG,21,ORL,5,0,35,2,6,.333,1,2,.500,1,4,.250,.417,0,0,0,1,3,4,0,1,0,2,2,5,17
Noah Vonleh,PF,22,TOT,54,16,875,104,234,.444,20,66,.303,84,168,.500,.487,36,58,.621,70,241,311,34,19,17,31,68,264,17
Noah Vonleh,PF,22,POR,33,12,476,47,96,.490,2,6,.333,45,90,.500,.500,23,31,.742,35,132,167,13,6,11,15,42,119,17
Noah Vonleh,PF,22,CHI,21,4,399,57,138,.413,18,60,.300,39,78,.500,.478,13,27,.481,35,109,144,21,13,6,16,26,145,17
Nikola Vučević,C,27,ORL,57,57,1683,399,840,.475,64,204,.314,335,636,.527,.513,77,94,.819,101,422,523,191,56,62,109,144,939,17
Dwyane Wade,SG,36,TOT,67,3,1536,299,682,.438,32,111,.288,267,571,.468,.462,135,189,.714,50,202,252,228,61,47,140,124,765,17
Dwyane Wade,SG,36,CLE,46,3,1069,198,435,.455,23,70,.329,175,365,.479,.482,94,134,.701,39,142,181,163,42,32,92,84,513,17
Dwyane Wade,SG,36,MIA,21,0,467,101,247,.409,9,41,.220,92,206,.447,.427,41,55,.745,11,60,71,65,19,15,48,40,252,17
Dion Waiters,SG,26,MIA,30,30,918,163,410,.398,52,170,.306,111,240,.463,.461,51,69,.739,8,69,77,113,23,9,70,61,429,17
Kemba Walker,PG,27,CHO,80,80,2736,588,1363,.431,231,601,.384,357,762,.469,.516,363,420,.864,32,216,248,444,91,24,179,98,1770,17
John Wall,PG,27,WAS,41,41,1410,280,667,.420,62,167,.371,218,500,.436,.466,175,241,.726,22,128,150,393,57,45,158,80,797,17
Tyrone Wallace,PG,23,LAC,30,19,851,110,247,.445,10,40,.250,100,207,.483,.466,61,78,.782,21,84,105,71,27,13,46,83,291,17
Derrick Walton,PG,22,MIA,16,0,147,8,25,.320,7,17,.412,1,8,.125,.460,6,6,1.000,2,14,16,16,7,3,2,7,29,17
Jameel Warney,PF,24,DAL,3,0,27,7,12,.583,0,0,0,7,12,.583,.583,3,5,.600,4,5,9,0,0,0,1,2,17,17
T.J. Warren,SF,24,PHO,65,65,2142,529,1063,.498,20,90,.222,509,973,.523,.507,193,255,.757,125,208,333,85,65,41,85,149,1271,17
Travis Wear,SF,27,LAL,17,0,228,25,72,.347,17,47,.362,8,25,.320,.465,8,8,1.000,0,38,38,7,4,5,6,30,75,17
James Webb III,SF,24,BRK,10,0,120,6,24,.250,4,19,.211,2,5,.400,.333,0,0,0,8,16,24,4,1,0,4,10,16,17
Briante Weber,PG,25,TOT,18,0,237,19,43,.442,4,11,.364,15,32,.469,.488,8,10,.800,8,27,35,22,18,5,15,28,50,17
Briante Weber,PG,25,HOU,13,0,118,9,22,.409,4,9,.444,5,13,.385,.500,4,4,1.000,3,15,18,13,10,3,7,18,26,17
Briante Weber,PG,25,MEM,5,0,119,10,21,.476,0,2,0,10,19,.526,.476,4,6,.667,5,12,17,9,8,2,8,10,24,17
David West,C,37,GSW,73,0,999,216,378,.571,3,8,.375,213,370,.576,.575,60,79,.759,64,174,238,138,47,75,80,120,495,17
Russell Westbrook,PG,29,OKC,80,80,2914,757,1687,.449,97,326,.298,660,1361,.485,.477,417,566,.737,152,652,804,820,147,20,381,200,2028,17
Andrew White,SF,24,ATL,15,0,209,25,73,.342,18,49,.367,7,24,.292,.466,1,4,.250,4,30,34,6,3,1,8,12,69,17
Derrick White,PG,23,SAS,17,0,139,16,33,.485,8,13,.615,8,20,.400,.606,14,20,.700,5,21,26,9,4,3,6,8,54,17
Okaro White,PF,25,MIA,6,4,80,7,16,.438,4,11,.364,3,5,.600,.563,2,3,.667,3,8,11,2,1,1,1,6,20,17
Isaiah Whitehead,PG,22,BRK,16,0,180,40,86,.465,7,18,.389,33,68,.485,.506,13,19,.684,4,22,26,20,8,2,24,23,100,17
Hassan Whiteside,C,28,MIA,54,54,1364,312,578,.540,2,2,1.000,310,576,.538,.542,128,182,.703,174,444,618,54,37,94,92,131,754,17
Andrew Wiggins,SF,22,MIN,82,82,2979,569,1300,.438,112,338,.331,457,962,.475,.481,202,314,.643,82,276,358,160,91,51,138,163,1452,17
Jacob Wiley,PF,23,BRK,5,0,33,1,4,.250,1,2,.500,0,2,0,.375,1,2,.500,2,9,11,2,1,0,0,4,4,17
Damien Wilkins,SF,38,IND,19,1,152,13,39,.333,4,18,.222,9,21,.429,.385,3,4,.750,5,11,16,9,2,1,5,7,33,17
Alan Williams,PF,25,PHO,5,0,70,7,18,.389,0,0,0,7,18,.389,.389,6,9,.667,3,19,22,8,5,1,7,13,20,17
C.J. Williams,SG,27,LAC,38,17,707,87,197,.442,22,78,.282,65,119,.546,.497,13,16,.813,12,44,56,43,31,13,20,63,209,17
Derrick Williams,PF,26,LAL,2,0,9,1,4,.250,0,2,0,1,2,.500,.250,0,0,0,0,1,1,0,0,0,0,0,2,17
Lou Williams,SG,31,LAC,79,19,2589,582,1337,.435,186,518,.359,396,819,.484,.505,432,491,.880,40,158,198,417,85,19,234,106,1782,17
Marvin Williams,PF,31,CHO,78,78,2006,258,563,.458,126,305,.413,132,258,.512,.570,102,123,.829,74,296,370,96,56,38,66,116,744,17
Matt Williams,SG,24,MIA,3,0,11,2,6,.333,1,5,.200,1,1,1.000,.417,0,0,0,0,1,1,0,0,0,1,1,5,17
Troy Williams,SF,23,TOT,21,1,307,51,109,.468,11,38,.289,40,71,.563,.518,20,30,.667,22,41,63,16,20,4,19,34,133,17
Troy Williams,SF,23,HOU,4,0,17,2,9,.222,0,5,0,2,4,.500,.222,1,3,.333,1,3,4,1,1,0,1,2,5,17
Troy Williams,SF,23,NYK,17,1,290,49,100,.490,11,33,.333,38,67,.567,.545,19,27,.704,21,38,59,15,19,4,18,32,128,17
D.J. Wilson,PF,21,MIL,22,0,71,9,16,.563,2,5,.400,7,11,.636,.625,1,2,.500,2,8,10,3,3,1,4,7,21,17
Jamil Wilson,SF,27,LAC,15,10,274,38,81,.469,27,63,.429,11,18,.611,.636,2,4,.500,3,29,32,10,5,8,8,34,105,17
Justise Winslow,PF,21,MIA,68,25,1680,207,488,.424,49,129,.380,158,359,.440,.474,66,104,.635,64,306,370,148,54,33,77,140,529,17
Jeff Withey,C,27,DAL,9,0,39,6,16,.375,2,10,.200,4,6,.667,.438,1,2,.500,1,9,10,0,0,3,2,3,15,17
Nate Wolters,PG,26,UTA,5,0,19,1,6,.167,0,0,0,1,6,.167,.167,0,0,0,1,1,2,1,0,0,0,1,2,17
Brandan Wright,PF,30,TOT,28,1,381,59,102,.578,0,0,0,59,102,.578,.578,21,33,.636,33,62,95,13,13,26,8,32,139,17
Brandan Wright,PF,30,MEM,27,1,366,57,99,.576,0,0,0,57,99,.576,.576,21,33,.636,32,61,93,13,13,25,8,29,135,17
Brandan Wright,PF,30,HOU,1,0,15,2,3,.667,0,0,0,2,3,.667,.667,0,0,0,1,1,2,0,0,1,0,3,4,17
Delon Wright,PG,25,TOR,69,4,1433,201,432,.465,56,153,.366,145,279,.520,.530,97,117,.829,45,153,198,200,72,33,78,81,555,17
Guerschon Yabusele,PF,22,BOS,33,4,235,26,61,.426,12,37,.324,14,24,.583,.525,15,22,.682,17,35,52,16,4,5,12,23,79,17
James Young,SG,22,PHI,6,0,61,5,14,.357,3,10,.300,2,4,.500,.464,4,6,.667,0,2,2,2,0,0,1,4,17,17
Joe Young,PG,25,IND,53,1,558,80,186,.430,25,66,.379,55,120,.458,.497,22,29,.759,12,51,63,39,14,1,26,39,207,17
Nick Young,SG,32,GSW,80,8,1393,201,488,.412,123,326,.377,78,162,.481,.538,56,65,.862,20,105,125,36,38,7,39,100,581,17
Thaddeus Young,PF,29,IND,81,81,2607,421,864,.487,58,181,.320,363,683,.531,.521,55,92,.598,184,328,512,152,135,36,105,175,955,17
Cody Zeller,C,25,CHO,33,0,627,85,156,.545,2,3,.667,83,153,.542,.551,61,85,.718,67,110,177,31,14,21,33,81,233,17
Tyler Zeller,C,28,TOT,66,34,1109,187,334,.560,10,28,.357,177,306,.578,.575,57,79,.722,110,195,305,47,15,35,47,126,441,17
Tyler Zeller,C,28,BRK,42,33,703,125,229,.546,10,26,.385,115,203,.567,.568,40,60,.667,63,131,194,28,8,21,35,78,300,17
Tyler Zeller,C,28,MIL,24,1,406,62,105,.590,0,2,0,62,103,.602,.590,17,19,.895,47,64,111,19,7,14,12,48,141,17
Paul Zipser,SF,23,CHI,54,12,824,81,234,.346,37,110,.336,44,124,.355,.425,19,25,.760,13,118,131,46,20,15,43,86,218,17
Ante Žižić,C,21,CLE,32,2,214,49,67,.731,0,0,0,49,67,.731,.731,21,29,.724,24,36,60,5,2,13,11,30,119,17
Ivica Zubac,C,20,LAL,43,0,410,61,122,.500,0,1,0,61,121,.504,.500,39,51,.765,45,78,123,25,8,15,26,47,161,17
Álex Abrines,SG,25,OKC,31,2,588,56,157,.357,41,127,.323,15,30,.500,.487,12,13,.923,5,43,48,20,17,6,14,53,165,18
Quincy Acy,PF,28,PHO,10,0,123,4,18,.222,2,15,.133,2,3,.667,.278,7,10,.700,3,22,25,8,1,4,4,24,17,18
Jaylen Adams,PG,22,ATL,34,1,428,38,110,.345,25,74,.338,13,36,.361,.459,7,9,.778,11,49,60,65,14,5,28,45,108,18
Steven Adams,C,25,OKC,80,80,2669,481,809,.595,0,2,0,481,807,.596,.595,146,292,.500,391,369,760,124,117,76,135,204,1108,18
Bam Adebayo,C,21,MIA,82,28,1913,280,486,.576,3,15,.200,277,471,.588,.579,166,226,.735,165,432,597,184,71,65,121,203,729,18
Deng Adel,SF,21,CLE,19,3,194,11,36,.306,6,23,.261,5,13,.385,.389,4,4,1.000,3,16,19,5,1,4,6,13,32,18
DeVaughn Akoon-Purcell,SG,25,DEN,7,0,22,3,10,.300,0,4,0,3,6,.500,.300,1,2,.500,1,3,4,6,2,0,2,4,7,18
LaMarcus Aldridge,C,33,SAS,81,81,2687,684,1319,.519,10,42,.238,674,1277,.528,.522,349,412,.847,251,493,744,194,43,107,144,179,1727,18
Rawle Alkins,SG,21,CHI,10,1,120,13,39,.333,3,12,.250,10,27,.370,.372,8,12,.667,11,15,26,13,1,0,8,7,37,18
Grayson Allen,SG,23,UTA,38,2,416,67,178,.376,32,99,.323,35,79,.443,.466,45,60,.750,3,20,23,25,6,6,33,47,211,18
Jarrett Allen,C,20,BRK,80,80,2096,335,568,.590,6,45,.133,329,523,.629,.595,197,278,.709,191,481,672,110,43,120,103,184,873,18
Kadeem Allen,PG,26,NYK,19,1,416,65,141,.461,17,36,.472,48,105,.457,.521,42,54,.778,8,43,51,76,16,4,26,46,189,18
Al-Farouq Aminu,PF,28,POR,81,81,2292,257,593,.433,96,280,.343,161,313,.514,.514,150,173,.867,112,498,610,104,68,33,72,143,760,18
Justin Anderson,SF,25,ATL,48,4,463,64,157,.408,24,77,.312,40,80,.500,.484,26,35,.743,24,60,84,23,22,13,23,48,178,18
Kyle Anderson,SF,25,MEM,43,40,1281,150,276,.543,9,34,.265,141,242,.583,.560,37,64,.578,48,203,251,128,54,37,58,112,346,18
Ryan Anderson,PF,30,TOT,25,8,322,21,69,.304,9,40,.225,12,29,.414,.370,12,16,.750,18,36,54,19,4,1,14,25,63,18
Ryan Anderson,PF,30,PHO,15,8,278,19,60,.317,7,34,.206,12,26,.462,.375,11,14,.786,14,31,45,17,3,1,12,23,56,18
Ryan Anderson,PF,30,MIA,10,0,44,2,9,.222,2,6,.333,0,3,0,.333,1,2,.500,4,5,9,2,1,0,2,2,7,18
Ike Anigbogu,C,20,IND,3,0,6,0,3,0,0,0,0,0,3,0,0,0,0,0,1,2,3,1,0,1,1,0,0,18
Giannis Antetokounmpo,PF,24,MIL,72,72,2358,721,1247,.578,52,203,.256,669,1044,.641,.599,500,686,.729,159,739,898,424,92,110,268,232,1994,18
Kostas Antetokounmpo,PF,21,DAL,2,0,11,0,3,0,0,0,0,0,3,0,0,2,4,.500,0,1,1,0,2,0,1,0,2,18
Carmelo Anthony,PF,34,HOU,10,2,294,49,121,.405,21,64,.328,28,57,.491,.492,15,22,.682,9,45,54,5,4,7,8,32,134,18
OG Anunoby,SF,21,TOR,67,6,1352,183,404,.453,67,202,.332,116,202,.574,.536,36,62,.581,58,139,197,47,46,22,55,140,469,18
Ryan Arcidiacono,PG,24,CHI,81,32,1961,187,418,.447,81,217,.373,106,201,.527,.544,89,102,.873,27,192,219,269,65,4,63,171,544,18
Trevor Ariza,SF,33,TOT,69,69,2349,294,736,.399,145,434,.334,149,302,.493,.498,130,164,.793,50,321,371,252,91,21,106,130,863,18
Trevor Ariza,SF,33,PHO,26,26,884,86,227,.379,50,139,.360,36,88,.409,.489,36,43,.837,16,129,145,87,38,8,39,44,258,18
Trevor Ariza,SF,33,WAS,43,43,1465,208,509,.409,95,295,.322,113,214,.528,.502,94,121,.777,34,192,226,165,53,13,67,86,605,18
D.J. Augustin,PG,31,ORL,81,81,2269,318,677,.470,131,311,.421,187,366,.511,.566,181,209,.866,41,162,203,426,52,4,128,115,948,18
Deandre Ayton,C,20,PHO,71,70,2183,509,870,.585,0,4,0,509,866,.588,.585,141,189,.746,223,506,729,125,61,67,126,209,1159,18
Dwayne Bacon,SG,23,CHO,43,13,759,122,257,.475,38,87,.437,84,170,.494,.549,34,46,.739,8,81,89,47,12,5,18,72,316,18
Marvin Bagley III,PF,19,SAC,62,4,1567,356,706,.504,30,96,.313,326,610,.534,.525,181,262,.691,162,309,471,62,33,59,98,120,923,18
Ron Baker,SG,25,TOT,15,0,152,4,20,.200,1,13,.077,3,7,.429,.225,5,6,.833,1,10,11,15,6,1,5,18,14,18
Ron Baker,SG,25,NYK,11,0,107,4,16,.250,1,9,.111,3,7,.429,.281,5,6,.833,1,6,7,13,5,0,3,16,14,18
Ron Baker,SG,25,WAS,4,0,45,0,4,0,0,4,0,0,0,0,0,0,0,0,0,4,4,2,1,1,2,2,0,18
Wade Baldwin,PG,22,POR,16,0,94,10,33,.303,2,9,.222,8,24,.333,.333,8,11,.727,2,13,15,12,1,2,14,11,30,18
Lonzo Ball,PG,21,LAL,47,45,1423,185,456,.406,75,228,.329,110,228,.482,.488,20,48,.417,54,197,251,255,69,19,103,114,465,18
Mo Bamba,C,20,ORL,47,1,766,117,243,.481,21,70,.300,96,173,.555,.525,37,63,.587,64,169,233,39,13,64,43,102,292,18
J.J. Barea,PG,34,DAL,38,0,752,161,385,.418,38,128,.297,123,257,.479,.468,55,78,.705,13,82,95,211,22,1,72,50,415,18
Harrison Barnes,PF-SF,26,TOT,77,77,2533,431,1027,.420,174,441,.395,257,586,.439,.504,229,278,.824,57,304,361,115,50,13,98,122,1265,18
Harrison Barnes,PF,26,DAL,49,49,1584,290,717,.404,121,311,.389,169,406,.416,.489,165,198,.833,36,171,207,62,33,11,68,79,866,18
Harrison Barnes,SF,26,SAC,28,28,949,141,310,.455,53,130,.408,88,180,.489,.540,64,80,.800,21,133,154,53,17,2,30,43,399,18
Will Barton,SF,28,DEN,43,38,1189,185,460,.402,67,196,.342,118,264,.447,.475,57,74,.770,32,167,199,124,18,22,65,82,494,18
Keita Bates-Diop,SF,23,MIN,30,3,503,60,142,.423,13,52,.250,47,90,.522,.468,18,28,.643,16,67,83,17,18,14,14,29,151,18
Nicolas Batum,SF,30,CHO,75,72,2354,253,562,.450,116,298,.389,137,264,.519,.553,77,89,.865,71,319,390,247,71,43,117,140,699,18
Jerryd Bayless,PG,30,MIN,34,6,657,82,230,.357,29,98,.296,53,132,.402,.420,16,28,.571,11,51,62,119,18,2,32,56,209,18
Aron Baynes,C,32,BOS,51,18,821,105,223,.471,21,61,.344,84,162,.519,.518,53,62,.855,88,152,240,57,12,34,40,125,284,18
Kent Bazemore,SG,29,ATL,67,35,1643,278,691,.402,96,300,.320,182,391,.465,.472,127,175,.726,37,224,261,152,89,42,121,170,779,18
Bradley Beal,SG,25,WAS,82,82,3028,764,1609,.475,209,596,.351,555,1013,.548,.540,362,448,.808,89,322,411,448,121,58,224,226,2099,18
Malik Beasley,SG,22,DEN,81,18,1879,349,737,.474,163,405,.402,186,332,.560,.584,56,66,.848,35,165,200,97,55,10,55,116,917,18
Michael Beasley,PF,30,LAL,26,2,277,75,153,.490,3,17,.176,72,136,.529,.500,28,39,.718,13,47,60,25,9,10,27,42,181,18
Marco Belinelli,SG,32,SAS,79,1,1815,285,690,.413,147,395,.372,138,295,.468,.520,112,124,.903,16,182,198,132,35,8,72,121,829,18
Jordan Bell,C,24,GSW,68,3,788,99,192,.516,0,2,0,99,190,.521,.516,25,41,.610,55,129,184,76,20,51,42,80,223,18
DeAndre' Bembry,SG,24,ATL,82,15,1931,275,616,.446,50,173,.289,225,443,.508,.487,87,136,.640,54,304,358,202,105,41,142,190,687,18
Dragan Bender,PF,21,PHO,46,27,826,88,197,.447,22,101,.218,66,96,.688,.503,32,54,.593,34,149,183,56,18,22,37,90,230,18
Dairis Bertāns,SG,29,NOP,12,0,167,12,47,.255,10,34,.294,2,13,.154,.362,0,0,0,2,7,9,10,1,0,2,7,34,18
Dāvis Bertāns,PF,26,SAS,76,12,1632,204,453,.450,145,338,.429,59,115,.513,.610,53,60,.883,23,241,264,100,35,33,43,133,606,18
Patrick Beverley,PG,30,LAC,78,49,2137,194,477,.407,112,282,.397,82,195,.421,.524,96,123,.780,76,312,388,300,67,43,85,265,596,18
Khem Birch,C,26,ORL,50,1,643,91,151,.603,0,1,0,91,150,.607,.603,58,83,.699,79,111,190,38,18,29,20,72,240,18
Bismack Biyombo,C,26,CHO,54,32,783,89,156,.571,0,0,0,89,156,.571,.571,58,91,.637,81,166,247,33,11,41,34,103,236,18
Nemanja Bjelica,PF,30,SAC,77,70,1788,284,593,.479,103,257,.401,181,336,.539,.566,70,92,.761,125,319,444,147,54,56,82,197,741,18
Antonio Blakeney,SG,22,CHI,57,3,829,166,396,.419,36,91,.396,130,305,.426,.465,50,76,.658,7,99,106,42,12,9,35,41,418,18
Eric Bledsoe,PG,29,MIL,78,78,2272,470,971,.484,124,377,.329,346,594,.582,.548,177,236,.750,82,280,362,430,116,29,165,156,1241,18
Jaron Blossomgame,SF,25,CLE,27,4,439,47,106,.443,10,39,.256,37,67,.552,.491,10,13,.769,26,72,98,13,7,8,11,20,114,18
Bogdan Bogdanović,SG,26,SAC,70,17,1947,361,863,.418,134,372,.360,227,491,.462,.496,134,162,.827,40,203,243,267,72,15,117,142,990,18
Bojan Bogdanović,SF,29,IND,81,81,2573,522,1051,.497,164,386,.425,358,665,.538,.575,246,305,.807,33,300,333,161,69,1,134,138,1454,18
Andrew Bogut,C,34,GSW,11,5,134,18,36,.500,0,0,0,18,36,.500,.500,3,3,1.000,12,43,55,11,3,8,8,22,39,18
Jonah Bolden,PF,23,PHI,44,10,639,80,162,.494,34,96,.354,46,66,.697,.599,13,27,.481,47,118,165,40,17,39,36,99,207,18
Isaac Bonga,PG,19,LAL,22,0,120,5,33,.152,0,8,0,5,25,.200,.152,9,15,.600,9,16,25,15,9,4,6,9,19,18
Devin Booker,SG,22,PHO,64,64,2242,586,1255,.467,135,414,.326,451,841,.536,.521,393,454,.866,39,226,265,433,56,13,264,200,1700,18
Chris Boucher,PF,26,TOR,28,0,163,34,76,.447,12,37,.324,22,39,.564,.526,13,15,.867,16,40,56,2,6,24,7,31,93,18
Avery Bradley,SG,28,TOT,63,63,1905,248,608,.408,86,245,.351,162,363,.446,.479,43,50,.860,43,132,175,152,41,16,89,167,625,18
Avery Bradley,SG,28,LAC,49,49,1463,161,420,.383,58,172,.337,103,248,.415,.452,20,25,.800,35,96,131,96,27,16,61,133,400,18
Avery Bradley,SG,28,MEM,14,14,442,87,188,.463,28,73,.384,59,115,.513,.537,23,25,.920,8,36,44,56,14,0,28,34,225,18
Tony Bradley,C,21,UTA,3,0,36,8,16,.500,0,0,0,8,16,.500,.500,1,2,.500,9,6,15,1,2,2,3,6,17,18
Corey Brewer,SF,32,TOT,31,3,492,53,123,.431,14,44,.318,39,79,.494,.488,31,43,.721,26,50,76,39,32,7,19,63,151,18
Corey Brewer,SF,32,PHI,7,3,140,20,49,.408,4,14,.286,16,35,.457,.449,9,13,.692,4,13,17,10,12,2,8,16,53,18
Corey Brewer,SF,32,SAC,24,0,352,33,74,.446,10,30,.333,23,44,.523,.514,22,30,.733,22,37,59,29,20,5,11,47,98,18
Mikal Bridges,SF,22,PHO,82,56,2417,242,563,.430,105,313,.335,137,250,.548,.523,95,118,.805,56,208,264,173,129,38,70,201,684,18
Miles Bridges,SF,20,CHO,80,25,1696,237,511,.464,65,200,.325,172,311,.553,.527,58,77,.753,67,256,323,95,55,49,50,111,597,18
Isaiah Briscoe,PG,22,ORL,39,0,559,55,138,.399,11,34,.324,44,104,.423,.438,15,26,.577,5,69,74,87,11,2,31,66,136,18
Ryan Broekhoff,SG,28,DAL,42,0,453,57,126,.452,38,93,.409,19,33,.576,.603,15,19,.789,8,55,63,22,6,4,16,35,167,18
Malcolm Brogdon,SG,26,MIL,64,64,1832,378,748,.505,104,244,.426,274,504,.544,.575,141,152,.928,65,223,288,205,46,13,91,102,1001,18
Dillon Brooks,SF,23,MEM,18,0,330,49,122,.402,15,40,.375,34,82,.415,.463,22,30,.733,9,22,31,16,10,4,19,50,135,18
MarShon Brooks,SG,30,MEM,29,0,387,76,169,.450,15,54,.278,61,115,.530,.494,23,33,.697,12,33,45,25,9,4,21,33,190,18
Bruce Brown,SG,22,DET,74,56,1449,125,314,.398,24,93,.258,101,221,.457,.436,45,60,.750,48,137,185,91,40,36,46,178,319,18
Jaylen Brown,SG,22,BOS,74,25,1913,368,792,.465,95,276,.344,273,516,.529,.525,133,202,.658,65,248,313,100,69,32,99,186,964,18
Lorenzo Brown,PG,28,TOR,26,0,212,23,71,.324,6,28,.214,17,43,.395,.366,3,3,1.000,5,26,31,28,12,5,16,22,55,18
Sterling Brown,SG,23,MIL,58,7,1034,145,312,.465,53,147,.361,92,165,.558,.550,29,42,.690,29,155,184,84,25,8,46,88,372,18
Troy Brown Jr.,SF,19,WAS,52,10,730,97,234,.415,22,69,.319,75,165,.455,.462,32,47,.681,35,110,145,80,21,5,30,56,248,18
Jalen Brunson,PG,22,DAL,73,38,1591,264,565,.467,63,181,.348,201,384,.523,.523,87,120,.725,25,144,169,230,37,4,88,127,678,18
Thomas Bryant,C,21,WAS,72,53,1496,309,502,.616,33,99,.333,276,403,.685,.648,107,137,.781,113,341,454,92,25,67,60,126,758,18
Reggie Bullock,SG,27,TOT,63,60,1879,245,594,.412,148,393,.377,97,201,.483,.537,73,85,.859,22,151,173,129,40,12,65,109,711,18
Reggie Bullock,SG,27,DET,44,44,1355,182,441,.413,114,294,.388,68,147,.463,.542,56,64,.875,20,103,123,109,24,5,54,79,534,18
Reggie Bullock,SG,27,LAL,19,16,524,63,153,.412,34,99,.343,29,54,.537,.523,17,21,.810,2,48,50,20,16,7,11,30,177,18
Trey Burke,PG,26,TOT,58,8,1125,236,548,.431,56,159,.352,180,389,.463,.482,103,124,.831,28,71,99,159,33,7,49,58,631,18
Trey Burke,PG,26,NYK,33,7,689,148,358,.413,30,86,.349,118,272,.434,.455,62,75,.827,15,47,62,94,21,5,29,33,388,18
Trey Burke,PG,26,DAL,25,1,436,88,190,.463,26,73,.356,62,117,.530,.532,41,49,.837,13,24,37,65,12,2,20,25,243,18
Alec Burks,SG,27,TOT,64,24,1375,192,474,.405,61,168,.363,131,306,.428,.469,116,141,.823,30,205,235,128,39,21,65,91,561,18
Alec Burks,SG,27,UTA,17,0,269,47,114,.412,16,43,.372,31,71,.437,.482,33,38,.868,2,25,27,20,6,4,15,22,143,18
Alec Burks,SG,27,CLE,34,24,979,136,340,.400,45,119,.378,91,221,.412,.466,79,98,.806,26,160,186,98,25,16,46,62,396,18
Alec Burks,SG,27,SAC,13,0,127,9,20,.450,0,6,0,9,14,.643,.450,4,5,.800,2,20,22,10,8,1,4,7,22,18
Deonte Burton,SG,25,OKC,32,0,240,33,82,.402,8,27,.296,25,55,.455,.451,8,12,.667,4,24,28,9,6,8,9,31,82,18
Jimmy Butler,SF-SG,29,TOT,65,65,2185,418,904,.462,67,193,.347,351,711,.494,.499,312,365,.855,121,221,342,263,123,39,95,111,1215,18
Jimmy Butler,SG,29,MIN,10,10,361,74,157,.471,17,45,.378,57,112,.509,.525,48,61,.787,16,36,52,43,24,10,14,18,213,18
Jimmy Butler,SF,29,PHI,55,55,1824,344,747,.461,50,148,.338,294,599,.491,.494,264,304,.868,105,185,290,220,99,29,81,93,1002,18
Bruno Caboclo,PF,23,MEM,34,19,800,96,225,.427,48,130,.369,48,95,.505,.533,42,50,.840,42,116,158,50,14,33,38,81,282,18
José Calderón,PG,37,DET,49,0,632,45,120,.375,14,57,.246,31,63,.492,.433,9,11,.818,11,49,60,115,16,3,35,64,113,18
Kentavious Caldwell-Pope,SG,25,LAL,82,23,2035,325,756,.430,151,435,.347,174,321,.542,.530,137,158,.867,48,190,238,110,73,13,65,137,938,18
Isaiah Canaan,PG,27,TOT,30,16,629,64,164,.390,34,96,.354,30,68,.441,.494,19,24,.792,6,52,58,84,14,2,35,52,181,18
Isaiah Canaan,PG,27,PHO,19,15,503,51,129,.395,25,72,.347,26,57,.456,.492,15,20,.750,5,44,49,62,12,0,29,46,142,18
Isaiah Canaan,PG,27,MIN,7,1,95,11,29,.379,7,19,.368,4,10,.400,.500,4,4,1.000,0,5,5,19,2,1,4,4,33,18
Isaiah Canaan,PG,27,MIL,4,0,31,2,6,.333,2,5,.400,0,1,0,.500,0,0,0,1,3,4,3,0,1,2,2,6,18
Clint Capela,C,24,HOU,67,67,2249,474,732,.648,0,0,0,474,732,.648,.648,166,261,.636,298,550,848,96,44,102,94,168,1114,18
DeMarre Carroll,PF,32,BRK,67,8,1703,227,575,.395,106,310,.342,121,265,.457,.487,184,242,.760,68,281,349,85,31,10,73,114,744,18
Jevon Carter,PG,23,MEM,39,3,577,56,185,.303,34,102,.333,22,83,.265,.395,26,32,.813,14,52,66,69,26,11,33,55,172,18
Vince Carter,PF,42,ATL,76,9,1330,196,468,.419,123,316,.389,73,152,.480,.550,47,66,.712,31,163,194,87,44,27,48,141,562,18
Wendell Carter Jr.,C,19,CHI,44,44,1110,180,371,.485,6,32,.188,174,339,.513,.493,89,112,.795,87,220,307,78,26,58,65,152,455,18
Michael Carter-Williams,PG,27,TOT,28,1,372,46,123,.374,10,38,.263,36,85,.424,.415,32,53,.604,19,51,70,70,20,15,20,48,134,18
Michael Carter-Williams,PG,27,HOU,16,1,145,25,61,.410,7,19,.368,18,42,.429,.467,12,26,.462,3,10,13,21,9,6,10,27,69,18
Michael Carter-Williams,PG,27,ORL,12,0,227,21,62,.339,3,19,.158,18,43,.419,.363,20,27,.741,16,41,57,49,11,9,10,21,65,18
Alex Caruso,PG,24,LAL,25,4,531,77,173,.445,24,50,.480,53,123,.431,.514,51,64,.797,20,47,67,77,24,9,42,54,229,18
Omri Casspi,SF,30,MEM,36,0,520,86,161,.534,15,43,.349,71,118,.602,.581,39,58,.672,17,98,115,26,20,9,23,35,226,18
Willie Cauley-Stein,C,25,SAC,81,81,2213,412,741,.556,1,2,.500,411,739,.556,.557,140,254,.551,181,497,678,194,96,51,84,227,965,18
Troy Caupain,PG,23,ORL,4,0,16,4,8,.500,2,3,.667,2,5,.400,.625,0,0,0,1,2,3,4,1,0,0,0,10,18
Tyler Cavanaugh,PF,24,UTA,11,0,39,3,10,.300,1,5,.200,2,5,.400,.350,2,2,1.000,3,5,8,1,0,0,1,3,9,18
Tyson Chandler,C,36,TOT,55,6,875,61,99,.616,0,1,0,61,98,.622,.616,51,87,.586,92,215,307,37,21,23,42,110,173,18
Tyson Chandler,C,36,PHO,7,0,89,8,12,.667,0,0,0,8,12,.667,.667,10,18,.556,7,32,39,6,2,1,7,21,26,18
Tyson Chandler,C,36,LAL,48,6,786,53,87,.609,0,1,0,53,86,.616,.609,41,69,.594,85,183,268,31,19,22,35,89,147,18
Wilson Chandler,PF-SF,31,TOT,51,33,1177,114,273,.418,59,158,.373,55,115,.478,.526,18,25,.720,48,167,215,82,25,21,46,123,305,18
Wilson Chandler,PF,31,PHI,36,32,951,91,207,.440,46,118,.390,45,89,.506,.551,13,18,.722,44,124,168,72,22,18,39,94,241,18
Wilson Chandler,SF,31,LAC,15,1,226,23,66,.348,13,40,.325,10,26,.385,.447,5,7,.714,4,43,47,10,3,3,7,29,64,18
Joe Chealey,PG,23,CHO,1,0,8,1,3,.333,0,0,0,1,3,.333,.333,0,0,0,0,0,0,1,0,0,0,1,2,18
Chris Chiozza,PG,23,HOU,7,0,33,2,8,.250,2,5,.400,0,3,0,.375,0,0,0,1,3,4,4,1,1,1,2,6,18
Marquese Chriss,PF,21,TOT,43,2,499,67,180,.372,16,72,.222,51,108,.472,.417,32,45,.711,40,102,142,22,17,11,36,81,182,18
Marquese Chriss,PF,21,HOU,16,0,104,11,34,.324,1,15,.067,10,19,.526,.338,6,7,.857,7,21,28,6,2,4,12,17,29,18
Marquese Chriss,PF,21,CLE,27,2,395,56,146,.384,15,57,.263,41,89,.461,.435,26,38,.684,33,81,114,16,15,7,24,64,153,18
Gary Clark,PF,24,HOU,51,2,641,50,151,.331,41,138,.297,9,13,.692,.467,7,7,1.000,24,92,116,18,20,26,7,47,148,18
Ian Clark,SG,27,NOP,60,6,973,151,383,.394,66,202,.327,85,181,.470,.480,33,37,.892,13,76,89,94,22,8,58,95,401,18
Jordan Clarkson,SG,26,CLE,81,0,2214,529,1180,.448,144,445,.324,385,735,.524,.509,162,192,.844,82,188,270,196,57,13,135,112,1364,18
John Collins,PF,21,ATL,61,59,1829,465,831,.560,55,158,.348,410,673,.609,.593,203,266,.763,219,376,595,121,22,39,120,199,1188,18
Zach Collins,C,21,POR,77,0,1356,189,400,.473,40,121,.331,149,279,.534,.523,94,126,.746,109,215,324,71,25,66,77,174,512,18
Darren Collison,PG,31,IND,76,76,2143,308,659,.467,79,194,.407,229,465,.492,.527,158,190,.832,36,196,232,459,110,9,125,138,853,18
Bonzie Colson,SF,23,MIL,8,2,98,13,39,.333,5,21,.238,8,18,.444,.397,8,9,.889,8,22,30,3,5,1,3,3,39,18
Mike Conley,PG,31,MEM,70,70,2342,490,1120,.438,155,426,.364,335,694,.483,.507,343,406,.845,40,199,239,449,94,22,130,123,1478,18
Pat Connaughton,SG,26,MIL,61,2,1261,163,350,.466,66,200,.330,97,150,.647,.560,29,40,.725,61,197,258,122,33,25,33,81,421,18
Quinn Cook,PG,25,GSW,74,10,1059,204,439,.465,81,200,.405,123,239,.515,.557,20,26,.769,22,135,157,116,20,3,50,92,509,18
DeMarcus Cousins,C,28,GSW,30,30,771,178,371,.480,26,95,.274,152,276,.551,.515,106,144,.736,43,204,247,107,40,44,72,109,488,18
Robert Covington,SF,28,TOT,35,35,1203,156,362,.431,85,225,.378,71,137,.518,.548,68,89,.764,28,165,193,46,74,47,47,126,465,18
Robert Covington,SF,28,PHI,13,13,440,50,117,.427,30,77,.390,20,40,.500,.556,17,23,.739,7,60,67,14,24,23,22,45,147,18
Robert Covington,SF,28,MIN,22,22,763,106,245,.433,55,148,.372,51,97,.526,.545,51,66,.773,21,105,126,32,50,24,25,81,318,18
Allen Crabbe,SG,26,BRK,43,20,1133,137,373,.367,98,259,.378,39,114,.342,.499,41,56,.732,16,132,148,46,23,13,46,102,413,18
Torrey Craig,SF,28,DEN,75,37,1503,160,362,.442,61,188,.324,99,174,.569,.526,49,70,.700,89,174,263,72,37,46,44,175,430,18
Jamal Crawford,SG,38,PHO,64,0,1211,174,438,.397,67,202,.332,107,236,.453,.474,93,110,.845,8,77,85,229,33,12,99,75,508,18
Mitch Creek,SF,26,TOT,5,0,48,8,16,.500,0,2,0,8,14,.571,.500,5,7,.714,6,6,12,6,2,0,1,3,21,18
Mitch Creek,SF,26,BRK,4,0,36,5,10,.500,0,1,0,5,9,.556,.500,5,7,.714,5,5,10,5,1,0,0,3,15,18
Mitch Creek,SF,26,MIN,1,0,12,3,6,.500,0,1,0,3,5,.600,.500,0,0,0,1,1,2,1,1,0,1,0,6,18
Jae Crowder,SF,28,UTA,80,11,2166,318,797,.399,173,522,.331,145,275,.527,.508,142,197,.721,60,324,384,133,64,31,85,170,951,18
Dante Cunningham,PF,31,SAS,64,21,928,75,158,.475,30,65,.462,45,93,.484,.570,14,18,.778,48,140,188,50,27,13,22,71,194,18
Seth Curry,SG,28,POR,74,2,1399,212,465,.456,113,251,.450,99,214,.463,.577,44,52,.846,27,93,120,66,36,12,61,97,581,18
Stephen Curry,PG,30,GSW,69,69,2331,632,1340,.472,354,810,.437,278,530,.525,.604,263,287,.916,45,324,369,361,92,25,192,166,1881,18
Troy Daniels,SG,27,PHO,51,1,760,113,275,.411,74,194,.381,39,81,.481,.545,18,23,.783,13,60,73,26,26,5,27,79,318,18
Anthony Davis,C,25,NOP,56,56,1850,530,1026,.517,48,145,.331,482,881,.547,.540,344,433,.794,174,498,672,218,88,135,112,132,1452,18
Deyonta Davis,C,22,ATL,9,0,118,15,22,.682,0,1,0,15,21,.714,.682,6,10,.600,10,26,36,5,3,5,3,12,36,18
Ed Davis,C,29,BRK,81,1,1446,186,302,.616,0,2,0,186,300,.620,.616,100,162,.617,216,478,694,61,35,33,64,226,472,18
Tyler Davis,C,21,OKC,1,0,1,0,1,0,0,0,0,0,1,0,0,0,0,0,1,0,1,0,0,0,0,0,0,18
Dewayne Dedmon,C,29,ATL,64,52,1609,259,526,.492,83,217,.382,176,309,.570,.571,92,113,.814,105,375,480,90,69,71,84,214,693,18
Sam Dekker,PF,24,TOT,47,5,788,120,256,.469,19,62,.306,101,194,.521,.506,28,46,.609,53,95,148,46,38,7,24,47,287,18
Sam Dekker,PF,24,CLE,9,5,169,22,48,.458,5,13,.385,17,35,.486,.510,8,10,.800,9,24,33,9,11,0,5,13,57,18
Sam Dekker,PF,24,WAS,38,0,619,98,208,.471,14,49,.286,84,159,.528,.505,20,36,.556,44,71,115,37,27,7,19,34,230,18
Ángel Delgado,C,24,LAC,2,0,15,1,5,.200,0,0,0,1,5,.200,.200,1,2,.500,2,2,4,0,1,0,0,2,3,18
Matthew Dellavedova,PG,28,TOT,48,0,812,98,242,.405,44,130,.338,54,112,.482,.496,42,52,.808,6,71,77,181,14,2,68,75,282,18
Matthew Dellavedova,PG,28,MIL,12,0,97,6,19,.316,4,11,.364,2,8,.250,.421,4,4,1.000,0,10,10,29,2,0,11,9,20,18
Matthew Dellavedova,PG,28,CLE,36,0,715,92,223,.413,40,119,.336,52,104,.500,.502,38,48,.792,6,61,67,152,12,2,57,66,262,18
Luol Deng,SF,33,MIN,22,2,392,59,118,.500,14,44,.318,45,74,.608,.559,25,35,.714,20,53,73,18,15,8,14,24,157,18
DeMar DeRozan,SG,29,SAS,77,77,2688,631,1313,.481,7,45,.156,624,1268,.492,.483,366,441,.830,54,408,462,475,86,36,199,177,1635,18
Marcus Derrickson,PF,22,GSW,11,0,67,16,33,.485,10,20,.500,6,13,.462,.636,4,5,.800,8,5,13,1,0,1,3,9,46,18
Cheick Diallo,PF,22,NOP,64,1,896,168,271,.620,1,4,.250,167,267,.625,.622,50,67,.746,75,257,332,33,29,33,49,113,387,18
Hamidou Diallo,SG,20,OKC,51,3,526,75,165,.455,4,24,.167,71,141,.504,.467,36,59,.610,38,59,97,17,21,10,23,77,190,18
Gorgui Dieng,C,29,MIN,76,2,1031,189,377,.501,19,56,.339,170,321,.530,.527,88,106,.830,81,230,311,72,48,41,57,134,485,18
Spencer Dinwiddie,PG,25,BRK,68,4,1914,366,828,.442,124,370,.335,242,458,.528,.517,287,356,.806,26,140,166,311,40,17,152,187,1143,18
Donte DiVincenzo,SG,22,MIL,27,0,411,50,124,.403,22,83,.265,28,41,.683,.492,9,12,.750,16,49,65,31,13,6,19,38,131,18
Luka Dončić,SG,19,DAL,72,72,2318,506,1186,.427,168,514,.327,338,672,.503,.497,346,485,.713,86,477,563,429,77,25,247,137,1526,18
Tyler Dorsey,SG,22,TOT,48,11,698,107,264,.405,44,132,.333,63,132,.477,.489,38,61,.623,27,86,113,56,14,2,27,53,296,18
Tyler Dorsey,SG,22,ATL,27,0,251,32,89,.360,10,39,.256,22,50,.440,.416,16,26,.615,9,34,43,17,7,1,10,20,90,18
Tyler Dorsey,SG,22,MEM,21,11,447,75,175,.429,34,93,.366,41,82,.500,.526,22,35,.629,18,52,70,39,7,1,17,33,206,18
Damyean Dotson,SG,24,NYK,73,40,2004,290,698,.415,126,342,.368,164,356,.461,.506,73,98,.745,34,228,262,135,58,10,71,135,779,18
PJ Dozier,SG,22,BOS,6,0,51,8,21,.381,2,8,.250,6,13,.462,.429,1,2,.500,6,11,17,5,2,0,0,2,19,18
Goran Dragić,PG,32,MIA,36,22,991,179,433,.413,57,164,.348,122,269,.454,.479,79,101,.782,20,91,111,174,30,5,71,81,494,18
Andre Drummond,C,25,DET,79,79,2647,561,1052,.533,5,38,.132,556,1014,.548,.536,243,412,.590,423,809,1232,112,136,138,175,272,1370,18
Jared Dudley,PF,33,BRK,59,25,1220,101,239,.423,53,151,.351,48,88,.545,.533,32,46,.696,34,121,155,83,36,16,43,131,287,18
Kris Dunn,PG,24,CHI,46,44,1389,215,506,.425,34,96,.354,181,410,.441,.458,55,69,.797,19,168,187,277,68,21,104,166,519,18
Kevin Durant,SF,30,GSW,78,78,2702,721,1383,.521,137,388,.353,584,995,.587,.571,448,506,.885,33,464,497,457,58,84,225,155,2027,18
Trevon Duval,PG,20,MIL,3,0,6,2,3,.667,1,1,1.000,1,2,.500,.833,0,0,0,0,1,1,2,0,0,0,0,5,18
Vince Edwards,SF,22,HOU,2,0,16,1,4,.250,1,4,.250,0,0,0,.375,0,0,0,1,1,2,0,0,0,0,0,3,18
Henry Ellenson,PF,22,TOT,19,0,259,39,95,.411,17,38,.447,22,57,.386,.500,19,25,.760,5,61,66,16,7,2,9,27,114,18
Henry Ellenson,PF,22,DET,2,0,25,4,10,.400,2,4,.500,2,6,.333,.500,2,2,1.000,0,9,9,1,0,0,0,2,12,18
Henry Ellenson,PF,22,NYK,17,0,234,35,85,.412,15,34,.441,20,51,.392,.500,17,23,.739,5,52,57,15,7,2,9,25,102,18
Wayne Ellington,SG,31,TOT,53,38,1297,184,457,.403,138,372,.371,46,85,.541,.554,39,49,.796,14,93,107,72,54,6,40,92,545,18
Wayne Ellington,SG,31,MIA,25,12,533,69,184,.375,57,155,.368,12,29,.414,.530,14,16,.875,6,41,47,29,24,3,14,40,209,18
Wayne Ellington,SG,31,DET,28,26,764,115,273,.421,81,217,.373,34,56,.607,.570,25,33,.758,8,52,60,43,30,3,26,52,336,18
Joel Embiid,C,24,PHI,64,64,2154,580,1199,.484,79,263,.300,501,936,.535,.517,522,649,.804,160,711,871,234,46,122,226,211,1761,18
James Ennis III,SF,28,TOT,58,27,1230,138,294,.469,55,156,.353,83,138,.601,.563,58,81,.716,60,122,182,41,41,23,34,150,389,18
James Ennis III,SF,28,HOU,40,25,949,104,211,.493,44,120,.367,60,91,.659,.597,42,58,.724,37,80,117,27,38,16,23,111,294,18
James Ennis III,SF,28,PHI,18,2,281,34,83,.410,11,36,.306,23,47,.489,.476,16,23,.696,23,42,65,14,3,7,11,39,95,18
Drew Eubanks,PF,21,SAS,23,0,113,15,26,.577,0,0,0,15,26,.577,.577,11,13,.846,6,28,34,7,2,5,8,11,41,18
Jacob Evans,SG,21,GSW,30,1,204,18,53,.340,4,15,.267,14,38,.368,.377,0,1,0,6,19,25,23,5,3,11,28,40,18
Jawun Evans,PG,22,TOT,8,0,65,3,14,.214,0,3,0,3,11,.273,.214,0,0,0,1,11,12,10,3,0,6,8,6,18
Jawun Evans,PG,22,PHO,7,0,64,3,13,.231,0,2,0,3,11,.273,.231,0,0,0,1,11,12,10,3,0,6,8,6,18
Jawun Evans,PG,22,OKC,1,0,1,0,1,0,0,1,0,0,0,0,0,0,0,0,0,0,0,0,0,0,0,0,0,18
Tyreke Evans,SG,29,IND,69,18,1402,257,660,.389,77,216,.356,180,444,.405,.448,115,160,.719,33,168,201,166,58,18,118,117,706,18
Dante Exum,PG,23,UTA,42,1,664,101,241,.419,18,62,.290,83,179,.464,.456,68,86,.791,16,52,68,110,14,5,52,69,288,18
Kenneth Faried,C,29,TOT,37,13,728,156,265,.589,8,25,.320,148,240,.617,.604,64,99,.646,97,153,250,20,17,23,33,82,384,18
Kenneth Faried,C,29,BRK,12,0,118,25,42,.595,1,5,.200,24,37,.649,.607,10,16,.625,15,29,44,2,2,4,6,8,61,18
Kenneth Faried,C,29,HOU,25,13,610,131,223,.587,7,20,.350,124,203,.611,.603,54,83,.651,82,124,206,18,15,19,27,74,323,18
Derrick Favors,C,27,UTA,76,70,1766,363,619,.586,17,78,.218,346,541,.640,.600,154,228,.675,207,353,560,89,56,106,84,163,897,18
Cristiano Felício,C,26,CHI,60,0,746,95,179,.531,0,4,0,95,175,.543,.531,50,73,.685,79,139,218,37,11,7,33,69,240,18
Raymond Felton,PG,34,OKC,33,0,379,55,135,.407,20,61,.328,35,74,.473,.481,12,13,.923,4,30,34,52,10,6,14,29,142,18
Terrance Ferguson,SG,20,OKC,74,74,1931,185,431,.429,106,290,.366,79,141,.560,.552,37,51,.725,33,108,141,72,40,16,47,231,513,18
Yogi Ferrell,PG,25,SAC,71,3,1067,153,352,.435,54,149,.362,99,203,.488,.511,60,67,.896,13,96,109,137,36,4,40,64,420,18
Dorian Finney-Smith,SF,25,DAL,81,26,1985,228,528,.432,79,254,.311,149,274,.544,.507,73,103,.709,138,251,389,95,69,36,74,186,608,18
Bryn Forbes,SG,25,SAS,82,81,2293,361,791,.456,176,413,.426,185,378,.489,.568,69,78,.885,18,221,239,175,45,4,80,159,967,18
Evan Fournier,SG,26,ORL,81,81,2553,468,1069,.438,153,450,.340,315,619,.509,.509,137,170,.806,38,220,258,295,71,12,154,225,1226,18
De'Aaron Fox,PG,21,SAC,81,81,2546,505,1102,.458,86,232,.371,419,870,.482,.497,303,417,.727,43,261,304,590,133,45,227,204,1399,18
Melvin Frazier,SG,22,ORL,10,0,44,7,21,.333,0,6,0,7,15,.467,.333,1,4,.250,3,2,5,1,1,0,1,6,15,18
Tim Frazier,PG,28,TOT,59,19,1120,116,261,.444,37,101,.366,79,160,.494,.515,41,54,.759,41,127,168,248,30,5,76,112,310,18
Tim Frazier,PG,28,NOP,47,17,909,88,195,.451,27,77,.351,61,118,.517,.521,32,41,.780,32,105,137,206,25,4,60,93,235,18
Tim Frazier,PG,28,MIL,12,2,211,28,66,.424,10,24,.417,18,42,.429,.500,9,13,.692,9,22,31,42,5,1,16,19,75,18
Jimmer Fredette,SG,29,PHO,6,0,65,8,29,.276,0,13,0,8,16,.500,.276,6,6,1.000,1,6,7,8,3,0,5,5,22,18
Enes Freedom,C,26,TOT,67,31,1640,375,683,.549,10,34,.294,365,649,.562,.556,155,197,.787,257,402,659,116,32,26,118,167,915,18
Enes Freedom,C,26,NYK,44,23,1128,251,468,.536,7,22,.318,244,446,.547,.544,105,129,.814,171,290,461,84,18,17,79,106,614,18
Enes Freedom,C,26,POR,23,8,512,124,215,.577,3,12,.250,121,203,.596,.584,50,68,.735,86,112,198,32,14,9,39,61,301,18
Channing Frye,C,35,CLE,36,6,341,43,117,.368,32,79,.405,11,38,.289,.504,11,14,.786,4,48,52,20,6,5,13,44,129,18
Markelle Fultz,SG,20,PHI,19,15,427,65,155,.419,4,14,.286,61,141,.433,.432,21,37,.568,26,44,70,59,17,5,25,52,155,18
Danilo Gallinari,SF,30,LAC,68,68,2059,409,884,.463,161,372,.433,248,512,.484,.554,367,406,.904,54,363,417,178,49,23,99,129,1346,18
Langston Galloway,SG,27,DET,80,4,1745,228,587,.388,135,380,.355,93,207,.449,.503,81,96,.844,49,122,171,85,37,8,24,135,672,18
Billy Garrett,SG,24,NYK,4,0,63,11,27,.407,0,8,0,11,19,.579,.407,4,4,1.000,0,3,3,7,1,1,2,3,26,18
Marc Gasol,C,34,TOT,79,72,2436,390,870,.448,99,273,.363,291,597,.487,.505,192,253,.759,80,547,627,349,84,86,155,217,1071,18
Marc Gasol,C,34,MEM,53,53,1788,303,683,.444,76,221,.344,227,462,.491,.499,152,201,.756,56,399,455,248,60,63,119,147,834,18
Marc Gasol,C,34,TOR,26,19,648,87,187,.465,23,52,.442,64,135,.474,.527,40,52,.769,24,148,172,101,24,23,36,70,237,18
Pau Gasol,C,38,TOT,30,6,360,42,94,.447,6,13,.462,36,81,.444,.479,28,40,.700,22,115,137,52,5,15,16,29,118,18
Pau Gasol,C,38,SAS,27,6,330,41,88,.466,5,10,.500,36,78,.462,.494,27,38,.711,22,105,127,50,5,14,14,28,114,18
Pau Gasol,C,38,MIL,3,0,30,1,6,.167,1,3,.333,0,3,0,.250,1,2,.500,0,10,10,2,0,1,2,1,4,18
Rudy Gay,PF,32,SAS,69,51,1842,376,746,.504,74,184,.402,302,562,.537,.554,120,147,.816,63,407,470,182,54,34,114,159,946,18
Paul George,SF,28,OKC,77,77,2841,707,1614,.438,292,757,.386,415,857,.484,.529,453,540,.839,105,523,628,318,170,34,205,214,2159,18
Taj Gibson,PF,33,MIN,70,57,1686,304,537,.566,11,34,.324,293,503,.583,.576,134,177,.757,172,286,458,84,53,39,73,186,753,18
Harry Giles,PF,20,SAC,58,0,820,175,348,.503,0,6,0,175,342,.512,.503,58,91,.637,66,156,222,85,31,22,73,150,408,18
Shai Gilgeous-Alexander,PG,20,LAC,82,73,2174,341,716,.476,51,139,.367,290,577,.503,.512,156,195,.800,57,175,232,270,96,45,141,175,889,18
Rudy Gobert,C,26,UTA,81,80,2577,476,712,.669,0,0,0,476,712,.669,.669,332,522,.636,309,732,1041,161,66,187,130,231,1284,18
Brandon Goodwin,PG,23,DEN,16,0,57,6,23,.261,2,6,.333,4,17,.235,.304,9,11,.818,1,2,3,14,0,0,3,7,23,18
Aaron Gordon,PF,23,ORL,78,78,2633,470,1046,.449,121,347,.349,349,699,.499,.507,185,253,.731,129,445,574,289,57,56,162,172,1246,18
Eric Gordon,SG,30,HOU,68,53,2158,384,938,.409,216,600,.360,168,338,.497,.525,119,152,.783,17,131,148,129,41,27,90,143,1103,18
Marcin Gortat,C,34,LAC,47,43,751,99,186,.532,0,0,0,99,186,.532,.532,35,48,.729,67,194,261,65,6,24,50,92,233,18
Devonte' Graham,PG,23,CHO,46,3,676,74,216,.343,34,121,.281,40,95,.421,.421,35,46,.761,10,53,63,121,23,2,30,48,217,18
Treveon Graham,SG,25,BRK,35,21,715,64,191,.335,38,128,.297,26,63,.413,.435,18,22,.818,23,84,107,34,13,7,17,68,184,18
Jerami Grant,PF,24,OKC,80,77,2612,409,823,.497,115,293,.392,294,530,.555,.567,157,221,.710,96,321,417,79,61,100,67,214,1090,18
Jerian Grant,PG,26,ORL,60,1,939,92,220,.418,40,110,.364,52,110,.473,.509,26,40,.650,19,79,98,156,44,6,51,78,250,18
Donte Grantham,SF,23,OKC,3,0,2,0,2,0,0,2,0,0,0,0,0,0,0,0,0,0,0,0,0,0,0,0,0,18
Danny Green,SG,31,TOR,80,80,2216,293,630,.465,198,435,.455,95,195,.487,.622,37,44,.841,60,257,317,126,73,53,75,171,821,18
Draymond Green,PF,28,GSW,66,66,2065,188,422,.445,47,165,.285,141,257,.549,.501,63,91,.692,60,421,481,454,95,70,169,197,486,18
Gerald Green,SG,33,HOU,73,0,1473,231,578,.400,156,441,.354,75,137,.547,.535,57,68,.838,30,152,182,40,33,27,55,126,675,18
JaMychal Green,PF,28,TOT,65,6,1371,230,476,.483,71,176,.403,159,300,.530,.558,80,101,.792,104,305,409,50,45,34,87,193,611,18
JaMychal Green,PF,28,MEM,41,4,900,151,312,.484,38,96,.396,113,216,.523,.545,63,80,.788,72,180,252,36,33,26,64,123,403,18
JaMychal Green,PF,28,LAC,24,2,471,79,164,.482,33,80,.413,46,84,.548,.582,17,21,.810,32,125,157,14,12,8,23,70,208,18
Jeff Green,PF,32,WAS,77,44,2097,326,687,.475,111,320,.347,215,367,.586,.555,183,206,.888,57,252,309,137,43,39,101,160,946,18
Blake Griffin,PF,29,DET,75,75,2622,619,1341,.462,189,522,.362,430,819,.525,.532,414,550,.753,100,465,565,402,52,28,253,199,1841,18
Daniel Hamilton,SG,23,ATL,19,3,204,23,60,.383,8,23,.348,15,37,.405,.450,3,6,.500,10,37,47,22,6,1,16,19,57,18
Dusty Hannahs,SG,25,MEM,2,0,26,3,12,.250,0,5,0,3,7,.429,.250,2,2,1.000,0,1,1,5,1,0,1,1,8,18
Tim Hardaway Jr.,SG,26,TOT,65,63,2057,390,993,.393,162,477,.340,228,516,.442,.474,232,276,.841,33,189,222,159,54,8,105,141,1174,18
Tim Hardaway Jr.,SG,26,NYK,46,46,1499,282,726,.388,117,337,.347,165,389,.424,.469,199,233,.854,26,135,161,122,42,6,81,106,880,18
Tim Hardaway Jr.,SG,26,DAL,19,17,558,108,267,.404,45,140,.321,63,127,.496,.489,33,43,.767,7,54,61,37,12,2,24,35,294,18
James Harden,PG,29,HOU,78,78,2867,843,1909,.442,378,1028,.368,465,881,.528,.541,754,858,.879,66,452,518,586,158,58,387,244,2818,18
Maurice Harkless,SF,25,POR,60,53,1415,189,388,.487,33,120,.275,156,268,.582,.530,49,73,.671,77,192,269,74,67,53,45,163,460,18
Montrezl Harrell,C,25,LAC,82,5,2158,546,888,.615,3,17,.176,543,871,.623,.617,266,414,.643,184,351,535,162,71,110,132,255,1361,18
Devin Harris,PG,35,DAL,68,2,1071,132,347,.380,62,200,.310,70,147,.476,.470,102,134,.761,12,100,112,122,35,16,56,133,428,18
Gary Harris,SG,24,DEN,57,48,1639,270,637,.424,82,242,.339,188,395,.476,.488,115,144,.799,41,119,160,127,55,19,68,113,737,18
Joe Harris,SG,27,BRK,76,76,2293,374,748,.500,183,386,.474,191,362,.528,.622,110,133,.827,52,239,291,181,38,17,121,182,1041,18
Tobias Harris,PF,26,TOT,82,82,2847,611,1254,.487,156,393,.397,455,861,.528,.549,266,307,.866,69,576,645,229,51,37,151,184,1644,18
Tobias Harris,PF,26,LAC,55,55,1903,424,855,.496,112,258,.434,312,597,.523,.561,192,219,.877,37,395,432,150,40,24,109,123,1152,18
Tobias Harris,PF,26,PHI,27,27,944,187,399,.469,44,135,.326,143,264,.542,.524,74,88,.841,32,181,213,79,11,13,42,61,492,18
Andrew Harrison,PG,24,TOT,17,0,187,16,53,.302,5,25,.200,11,28,.393,.349,17,18,.944,6,14,20,24,4,2,12,34,54,18
Andrew Harrison,PG,24,MEM,1,0,5,1,2,.500,0,1,0,1,1,1.000,.500,0,0,0,0,0,0,0,0,0,0,1,2,18
Andrew Harrison,PG,24,CLE,10,0,144,12,39,.308,3,14,.214,9,25,.360,.346,16,16,1.000,4,11,15,17,4,2,10,26,43,18
Andrew Harrison,PG,24,NOP,6,0,38,3,12,.250,2,10,.200,1,2,.500,.333,1,2,.500,2,3,5,7,0,0,2,7,9,18
Shaquille Harrison,SG,25,CHI,73,11,1430,184,426,.432,24,89,.270,160,337,.475,.460,82,123,.667,33,189,222,139,89,30,60,124,474,18
Josh Hart,SG,23,LAL,67,22,1715,189,464,.407,92,274,.336,97,190,.511,.506,55,80,.688,35,213,248,93,64,40,58,147,525,18
Isaiah Hartenstein,PF,20,HOU,28,0,221,20,41,.488,2,6,.333,18,35,.514,.512,11,14,.786,21,26,47,15,7,12,13,56,53,18
Udonis Haslem,C,38,MIA,10,1,74,11,33,.333,0,12,0,11,21,.524,.333,3,4,.750,3,24,27,2,0,0,3,9,25,18
Gordon Hayward,PF,28,BOS,72,18,1863,296,635,.466,77,231,.333,219,404,.542,.527,156,187,.834,51,271,322,244,62,23,105,104,825,18
John Henson,C,28,MIL,14,0,188,31,67,.463,11,31,.355,20,36,.556,.545,6,10,.600,16,55,71,14,7,11,12,16,79,18
Juancho Hernangómez,PF,23,DEN,70,25,1358,138,314,.439,66,181,.365,72,133,.541,.545,66,86,.767,64,201,265,55,27,24,37,94,408,18
Willy Hernangómez,C,24,CHO,58,3,812,153,295,.519,15,39,.385,138,256,.539,.544,100,144,.694,117,194,311,60,16,20,58,98,421,18
Mario Hezonja,SF,23,NYK,58,24,1206,191,464,.412,42,152,.276,149,312,.478,.457,87,114,.763,28,211,239,88,57,8,88,110,511,18
Isaiah Hicks,PF,24,NYK,3,0,32,4,8,.500,0,0,0,4,8,.500,.500,4,5,.800,2,5,7,2,1,3,1,5,12,18
Buddy Hield,SG,26,SAC,82,82,2615,623,1360,.458,278,651,.427,345,709,.487,.560,171,193,.886,106,306,412,205,58,33,146,202,1695,18
Haywood Highsmith,SF,22,PHI,5,0,40,4,10,.400,1,5,.200,3,5,.600,.450,0,2,0,0,5,5,2,1,0,1,1,9,18
Nenê,C,36,HOU,42,2,546,60,116,.517,0,3,0,60,113,.531,.517,31,47,.660,34,89,123,26,18,15,11,87,151,18
George Hill,PG,32,TOT,60,13,1302,170,376,.452,48,153,.314,122,223,.547,.516,70,85,.824,39,109,148,135,52,8,51,102,458,18
George Hill,PG,32,CLE,13,13,344,55,107,.514,13,28,.464,42,79,.532,.575,17,20,.850,12,15,27,36,12,1,20,35,140,18
George Hill,PG,32,MIL,47,0,958,115,269,.428,35,125,.280,80,144,.556,.493,53,65,.815,27,94,121,99,40,7,31,67,318,18
Solomon Hill,SF,27,NOP,44,15,878,68,178,.382,32,101,.317,36,77,.468,.472,23,32,.719,34,99,133,55,23,10,31,80,191,18
Aaron Holiday,PG,22,IND,50,0,646,105,262,.401,43,127,.339,62,135,.459,.483,41,50,.820,5,62,67,87,21,13,40,71,294,18
Jrue Holiday,SG,28,NOP,67,67,2402,547,1159,.472,118,363,.325,429,796,.539,.523,208,271,.768,75,259,334,518,109,54,210,148,1420,18
Justin Holiday,SG,29,TOT,82,77,2607,300,777,.386,162,465,.348,138,312,.442,.490,95,106,.896,46,277,323,146,121,36,104,164,857,18
Justin Holiday,SG,29,CHI,38,38,1325,151,394,.383,97,270,.359,54,124,.435,.506,41,46,.891,19,150,169,85,67,21,47,79,440,18
Justin Holiday,SG,29,MEM,44,39,1282,149,383,.389,65,195,.333,84,188,.447,.474,54,60,.900,27,127,154,61,54,15,57,85,417,18
John Holland,SF,30,CLE,1,0,1,0,0,0,0,0,0,0,0,0,0,0,0,0,0,0,0,0,0,0,0,0,0,18
Rondae Hollis-Jefferson,SF,24,BRK,59,21,1234,200,487,.411,9,49,.184,191,438,.436,.420,118,183,.645,83,227,310,96,44,27,68,107,527,18
Richaun Holmes,C,25,PHO,70,4,1184,222,365,.608,0,0,0,222,365,.608,.608,128,175,.731,115,216,331,60,42,79,52,194,572,18
Rodney Hood,SG,26,TOT,72,49,1893,292,671,.435,84,236,.356,208,435,.478,.498,137,155,.884,25,132,157,126,59,12,55,146,805,18
Rodney Hood,SG,26,CLE,45,45,1234,194,454,.427,55,152,.362,139,302,.460,.488,104,114,.912,18,94,112,92,38,5,36,101,547,18
Rodney Hood,SG,26,POR,27,4,659,98,217,.452,29,84,.345,69,133,.519,.518,33,41,.805,7,38,45,34,21,7,19,45,258,18
Al Horford,C,32,BOS,68,68,1973,387,723,.535,73,203,.360,314,520,.604,.586,78,95,.821,120,338,458,283,59,86,102,126,925,18
Danuel House Jr.,SF,25,HOU,39,13,979,118,252,.468,74,178,.416,44,74,.595,.615,56,71,.789,25,115,140,40,21,11,35,80,366,18
Dwight Howard,C,33,WAS,9,9,230,43,69,.623,0,0,0,43,69,.623,.623,29,48,.604,24,59,83,4,7,4,16,34,115,18
Kevin Huerter,SG,20,ATL,75,59,2048,275,657,.419,136,353,.385,139,304,.457,.522,41,56,.732,60,185,245,214,65,25,109,155,727,18
Isaac Humphries,C,21,ATL,5,1,56,6,21,.286,3,11,.273,3,10,.300,.357,0,0,0,4,7,11,0,1,0,0,7,15,18
R.J. Hunter,SG,25,BOS,1,0,26,6,13,.462,4,10,.400,2,3,.667,.615,1,2,.500,1,2,3,3,1,0,0,3,17,18
Chandler Hutchison,SF,22,CHI,44,14,895,96,209,.459,14,50,.280,82,159,.516,.493,23,38,.605,31,154,185,34,23,6,25,59,229,18
Serge Ibaka,C,29,TOR,74,51,2010,464,877,.529,49,169,.290,415,708,.586,.557,135,177,.763,156,445,601,99,29,103,114,211,1112,18
Andre Iguodala,SF,35,GSW,68,13,1578,151,302,.500,48,144,.333,103,158,.652,.579,39,67,.582,48,204,252,216,61,51,52,95,389,18
Ersan İlyasova,PF,31,MIL,67,7,1231,167,381,.438,58,160,.363,109,221,.493,.514,61,74,.824,94,208,302,52,32,20,48,172,453,18
Joe Ingles,PF,31,UTA,82,82,2568,359,802,.448,189,483,.391,170,319,.533,.565,87,123,.707,35,295,330,469,98,20,193,180,994,18
Andre Ingram,SG,33,LAL,4,0,15,0,6,0,0,3,0,0,3,0,0,0,0,0,1,1,2,0,1,0,1,0,0,18
Brandon Ingram,SF,21,LAL,52,52,1760,362,729,.497,31,94,.330,331,635,.521,.518,195,289,.675,41,226,267,154,28,31,129,149,950,18
Kyrie Irving,PG,26,BOS,67,67,2214,604,1241,.487,174,434,.401,430,807,.533,.557,214,245,.873,71,264,335,464,103,34,172,167,1596,18
Jonathan Isaac,PF,21,ORL,75,64,1996,262,611,.429,86,266,.323,176,345,.510,.499,110,135,.815,99,312,411,80,59,98,75,143,720,18
Wes Iwundu,SF,24,ORL,68,13,1233,113,274,.412,29,79,.367,84,195,.431,.465,84,103,.816,37,147,184,73,28,22,44,123,339,18
Demetrius Jackson,PG,24,PHI,6,0,39,8,15,.533,2,6,.333,6,9,.667,.600,4,4,1.000,2,1,3,5,2,0,1,4,22,18
Frank Jackson,PG,20,NOP,61,16,1169,194,447,.434,53,169,.314,141,278,.507,.493,54,73,.740,25,109,134,69,25,2,48,92,495,18
Jaren Jackson Jr.,PF,19,MEM,58,56,1515,298,589,.506,51,142,.359,247,447,.553,.549,151,197,.766,73,199,272,64,52,82,98,220,798,18
Josh Jackson,SG,21,PHO,79,29,1988,347,841,.413,73,225,.324,274,616,.445,.456,143,213,.671,66,281,347,183,74,56,173,209,910,18
Justin Jackson,SF,23,TOT,81,14,1614,217,485,.447,87,245,.355,130,240,.542,.537,62,79,.785,44,168,212,96,32,14,29,99,583,18
Justin Jackson,SF,23,SAC,52,3,1083,125,295,.424,55,159,.346,70,136,.515,.517,41,50,.820,25,121,146,68,23,13,22,67,346,18
Justin Jackson,SF,23,DAL,29,11,531,92,190,.484,32,86,.372,60,104,.577,.568,21,29,.724,19,47,66,28,9,1,7,32,237,18
Reggie Jackson,PG,28,DET,82,82,2289,441,1047,.421,174,471,.369,267,576,.464,.504,204,236,.864,45,171,216,344,55,9,148,208,1260,18
LeBron James,SF,34,LAL,55,55,1937,558,1095,.510,111,327,.339,447,768,.582,.560,278,418,.665,57,408,465,454,72,33,197,94,1505,18
Amile Jefferson,PF,25,ORL,12,0,68,10,16,.625,0,0,0,10,16,.625,.625,7,8,.875,6,15,21,3,3,3,1,8,27,18
John Jenkins,SG,27,TOT,26,0,333,42,105,.400,22,58,.379,20,47,.426,.505,15,18,.833,6,31,37,22,0,2,9,10,121,18
John Jenkins,SG,27,WAS,4,0,14,2,2,1.000,2,2,1.000,0,0,0,1.500,0,0,0,0,1,1,1,0,0,0,0,6,18
John Jenkins,SG,27,NYK,22,0,319,40,103,.388,20,56,.357,20,47,.426,.485,15,18,.833,6,30,36,21,0,2,9,10,115,18
Jonas Jerebko,PF,31,GSW,73,6,1218,163,355,.459,69,188,.367,94,167,.563,.556,64,80,.800,72,216,288,96,27,18,43,137,459,18
Alize Johnson,PF,22,IND,14,0,64,4,16,.250,1,2,.500,3,14,.214,.281,4,8,.500,4,15,19,1,1,3,0,7,13,18
Amir Johnson,C,31,PHI,51,6,529,79,157,.503,12,40,.300,67,117,.573,.541,31,41,.756,47,100,147,60,16,13,45,99,201,18
B.J. Johnson,SF,23,TOT,7,0,49,9,18,.500,3,7,.429,6,11,.545,.583,2,2,1.000,2,6,8,0,2,0,2,4,23,18
B.J. Johnson,SF,23,ATL,6,0,43,8,16,.500,3,6,.500,5,10,.500,.594,2,2,1.000,2,6,8,0,2,0,2,3,21,18
B.J. Johnson,SF,23,SAC,1,0,6,1,2,.500,0,1,0,1,1,1.000,.500,0,0,0,0,0,0,0,0,0,0,1,2,18
James Johnson,PF,31,MIA,55,33,1164,164,379,.433,50,149,.336,114,230,.496,.499,50,70,.714,22,154,176,135,35,27,74,114,428,18
Stanley Johnson,SF,22,TOT,66,7,1208,171,440,.389,62,215,.288,109,225,.484,.459,50,64,.781,34,183,217,88,60,14,81,114,454,18
Stanley Johnson,SF,22,DET,48,7,961,133,349,.381,51,181,.282,82,168,.488,.454,41,51,.804,25,150,175,60,48,13,55,92,358,18
Stanley Johnson,SF,22,NOP,18,0,247,38,91,.418,11,34,.324,27,57,.474,.478,9,13,.692,9,33,42,28,12,1,26,22,96,18
Tyler Johnson,PG,26,TOT,57,22,1529,217,526,.413,90,260,.346,127,266,.477,.498,95,127,.748,34,139,173,166,54,27,77,97,619,18
Tyler Johnson,PG,26,MIA,44,10,1123,171,401,.426,72,204,.353,99,197,.503,.516,61,88,.693,19,102,121,112,40,21,63,72,475,18
Tyler Johnson,PG,26,PHO,13,12,406,46,125,.368,18,56,.321,28,69,.406,.440,34,39,.872,15,37,52,54,14,6,14,25,144,18
Wesley Johnson,SF,31,TOT,38,13,534,45,128,.352,25,76,.329,20,52,.385,.449,13,19,.684,12,60,72,23,14,12,18,63,128,18
Wesley Johnson,SF,31,NOP,26,13,377,35,88,.398,19,50,.380,16,38,.421,.506,6,9,.667,10,44,54,16,12,7,12,45,95,18
Wesley Johnson,SF,31,WAS,12,0,157,10,40,.250,6,26,.231,4,14,.286,.325,7,10,.700,2,16,18,7,2,5,6,18,33,18
Nikola Jokić,C,23,DEN,80,80,2504,616,1206,.511,83,270,.307,533,936,.569,.545,289,352,.821,228,637,865,580,108,55,248,228,1604,18
Damian Jones,C,23,GSW,24,22,410,53,74,.716,0,0,0,53,74,.716,.716,24,37,.649,31,44,75,28,12,25,16,63,130,18
Derrick Jones Jr.,SF,21,MIA,60,14,1153,160,324,.494,28,91,.308,132,233,.567,.537,74,122,.607,96,144,240,37,46,42,43,123,422,18
Jalen Jones,SF,25,CLE,16,0,214,26,62,.419,10,28,.357,16,34,.471,.500,19,27,.704,11,23,34,7,9,2,8,27,81,18
Jemerrio Jones,SF,23,LAL,6,2,143,12,33,.364,2,10,.200,10,23,.435,.394,1,2,.500,16,33,49,13,7,5,5,10,27,18
Terrence Jones,PF,27,HOU,2,0,5,1,4,.250,0,2,0,1,2,.500,.250,0,1,0,0,4,4,0,0,0,1,1,2,18
Tyus Jones,PG,22,MIN,68,23,1560,185,446,.415,40,126,.317,145,320,.453,.460,58,69,.841,23,111,134,327,81,5,47,78,468,18
DeAndre Jordan,C,30,TOT,69,69,2047,286,446,.641,0,0,0,286,446,.641,.641,186,264,.705,225,677,902,156,42,73,153,167,758,18
DeAndre Jordan,C,30,DAL,50,50,1554,208,323,.644,0,0,0,208,323,.644,.644,135,198,.682,161,525,686,99,33,53,111,125,551,18
DeAndre Jordan,C,30,NYK,19,19,493,78,123,.634,0,0,0,78,123,.634,.634,51,66,.773,64,152,216,57,9,20,42,42,207,18
Cory Joseph,PG,27,IND,82,9,2063,226,548,.412,55,171,.322,171,377,.454,.463,30,43,.698,39,240,279,321,94,22,80,131,537,18
Frank Kaminsky,C,25,CHO,47,0,755,138,298,.463,50,139,.360,88,159,.553,.547,79,107,.738,39,124,163,63,12,12,41,68,405,18
Luke Kennard,SG,22,DET,63,10,1437,228,520,.438,106,269,.394,122,251,.486,.540,51,61,.836,12,171,183,114,26,10,57,92,613,18
Michael Kidd-Gilchrist,PF,25,CHO,64,3,1179,158,332,.476,16,47,.340,142,285,.498,.500,95,123,.772,88,158,246,61,32,39,43,156,427,18
George King,SF,25,PHO,1,0,6,0,0,0,0,0,0,0,0,0,0,0,0,0,0,1,1,0,0,0,0,0,0,18
Maxi Kleber,PF,27,DAL,71,18,1502,175,386,.453,77,218,.353,98,168,.583,.553,58,74,.784,90,239,329,70,36,78,54,143,485,18
Brandon Knight,PG,27,TOT,39,26,736,99,260,.381,41,129,.318,58,131,.443,.460,27,34,.794,10,49,59,71,21,2,30,62,266,18
Brandon Knight,PG,27,HOU,12,0,118,11,47,.234,5,32,.156,6,15,.400,.287,9,11,.818,1,8,9,9,2,0,5,14,36,18
Brandon Knight,PG,27,CLE,27,26,618,88,213,.413,36,97,.371,52,116,.448,.498,18,23,.783,9,41,50,62,19,2,25,48,230,18
Kevin Knox,PF,19,NYK,75,57,2158,338,914,.370,125,364,.343,213,550,.387,.438,162,226,.717,61,274,335,82,43,24,114,175,963,18
Furkan Korkmaz,SG,21,PHI,48,7,679,98,245,.400,47,144,.326,51,101,.505,.496,36,44,.818,16,91,107,52,29,2,25,62,279,18
Luke Kornet,PF,23,NYK,46,18,784,107,283,.378,70,193,.363,37,90,.411,.502,38,46,.826,28,107,135,54,27,42,25,41,322,18
Kyle Korver,SG-PF,37,TOT,70,0,1334,201,483,.416,138,348,.397,63,135,.467,.559,60,73,.822,9,153,162,81,25,12,59,106,600,18
Kyle Korver,PF,37,CLE,16,0,251,35,76,.461,25,54,.463,10,22,.455,.625,13,16,.813,0,29,29,17,3,2,17,22,108,18
Kyle Korver,SG,37,UTA,54,0,1083,166,407,.408,113,294,.384,53,113,.469,.547,47,57,.825,9,124,133,64,22,10,42,84,492,18
Kosta Koufos,C,29,SAC,42,1,502,73,153,.477,0,0,0,73,153,.477,.477,10,24,.417,52,125,177,36,15,18,27,68,156,18
Rodions Kurucs,SF,20,BRK,63,46,1294,202,449,.450,58,184,.315,144,265,.543,.514,72,92,.783,56,190,246,52,41,25,77,146,534,18
Kyle Kuzma,PF,23,LAL,70,68,2314,496,1087,.456,128,422,.303,368,665,.553,.515,188,250,.752,60,322,382,178,41,26,133,170,1308,18
Skal Labissière,PF,22,TOT,22,1,176,26,49,.531,6,13,.462,20,36,.556,.592,9,17,.529,9,34,43,11,5,6,11,29,67,18
Skal Labissière,PF,22,SAC,13,0,113,13,30,.433,4,11,.364,9,19,.474,.500,6,11,.545,4,20,24,6,2,3,7,21,36,18
Skal Labissière,PF,22,POR,9,1,63,13,19,.684,2,2,1.000,11,17,.647,.737,3,6,.500,5,14,19,5,3,3,4,8,31,18
Jeremy Lamb,SG,26,CHO,79,55,2250,431,979,.440,115,330,.348,316,649,.487,.499,231,260,.888,65,369,434,172,88,32,80,140,1208,18
Zach LaVine,SG,23,CHI,63,62,2171,530,1135,.467,120,321,.374,410,814,.504,.520,312,375,.832,40,254,294,283,60,26,215,140,1492,18
Jake Layman,SF,24,POR,71,33,1327,216,424,.509,59,181,.326,157,243,.646,.579,50,71,.704,56,161,217,53,31,30,46,116,541,18
T.J. Leaf,PF,21,IND,58,1,522,99,183,.541,8,31,.258,91,152,.599,.563,19,31,.613,43,82,125,24,9,19,12,35,225,18
Courtney Lee,SG,33,TOT,34,6,428,53,129,.411,16,55,.291,37,74,.500,.473,14,21,.667,9,45,54,37,21,3,14,32,136,18
Courtney Lee,SG,33,NYK,12,2,160,21,47,.447,5,16,.313,16,31,.516,.500,9,14,.643,6,21,27,16,8,2,5,13,56,18
Courtney Lee,SG,33,DAL,22,4,268,32,82,.390,11,39,.282,21,43,.488,.457,5,7,.714,3,24,27,21,13,1,9,19,80,18
Damion Lee,SG,26,GSW,32,0,375,56,127,.441,27,68,.397,29,59,.492,.547,19,22,.864,8,56,64,13,13,0,11,28,158,18
Walt Lemon Jr.,PG,26,CHI,6,3,167,38,87,.437,2,5,.400,36,82,.439,.448,8,11,.727,4,23,27,30,11,1,10,14,86,18
Alex Len,C,25,ATL,77,31,1544,320,648,.494,74,204,.363,246,444,.554,.551,140,216,.648,158,266,424,86,27,69,97,200,854,18
Kawhi Leonard,SF,27,TOR,60,60,2040,560,1129,.496,112,302,.371,448,827,.542,.546,364,426,.854,78,361,439,199,106,24,121,87,1596,18
Meyers Leonard,C,26,POR,61,2,878,132,242,.545,50,111,.450,82,131,.626,.649,43,51,.843,49,184,233,75,13,9,43,105,357,18
Jon Leuer,PF,29,DET,41,1,402,66,113,.584,1,11,.091,65,102,.637,.588,23,31,.742,27,70,97,14,12,4,23,60,156,18
Caris LeVert,SF,24,BRK,40,25,1063,207,483,.429,48,154,.312,159,329,.483,.478,85,123,.691,35,116,151,156,42,14,69,77,547,18
Damian Lillard,PG,28,POR,80,80,2838,681,1533,.444,237,643,.369,444,890,.499,.522,468,513,.912,68,303,371,551,88,34,212,148,2067,18
Jeremy Lin,PG,30,TOT,74,4,1436,238,541,.440,55,187,.294,183,354,.517,.491,176,210,.838,22,157,179,231,47,13,124,144,707,18
Jeremy Lin,PG,30,ATL,51,1,1003,180,386,.466,44,132,.333,136,254,.535,.523,142,168,.845,16,103,119,181,38,7,98,96,546,18
Jeremy Lin,PG,30,TOR,23,3,433,58,155,.374,11,55,.200,47,100,.470,.410,34,42,.810,6,54,60,50,9,6,26,48,161,18
Shaun Livingston,PG,33,GSW,64,0,967,109,210,.519,0,2,0,109,208,.524,.519,40,51,.784,42,75,117,114,31,27,38,74,258,18
Zach Lofton,SG,26,DET,1,0,4,0,1,0,0,1,0,0,0,0,0,0,0,0,0,0,0,0,1,0,1,0,0,18
Kevon Looney,C,22,GSW,80,24,1481,217,347,.625,1,10,.100,216,337,.641,.627,65,105,.619,194,223,417,123,46,53,51,211,500,18
Brook Lopez,C,30,MIL,81,81,2322,355,786,.452,187,512,.365,168,274,.613,.571,112,133,.842,33,363,396,98,51,179,82,189,1009,18
Robin Lopez,C,30,CHI,74,36,1606,304,535,.568,7,31,.226,297,504,.589,.575,89,123,.724,140,146,286,89,11,78,96,124,704,18
Kevin Love,PF,30,CLE,22,21,598,109,283,.385,53,147,.361,56,136,.412,.479,103,114,.904,33,206,239,48,6,5,42,54,374,18
Kyle Lowry,PG,32,TOR,65,65,2213,304,739,.411,157,453,.347,147,286,.514,.518,161,194,.830,41,271,312,564,91,31,182,166,926,18
Jordan Loyd,PG,25,TOR,12,0,55,8,18,.444,4,8,.500,4,10,.400,.556,9,11,.818,1,8,9,6,0,0,2,5,29,18
Kalin Lucas,PG,29,DET,1,0,6,0,1,0,0,1,0,0,0,0,0,2,2,1.000,0,3,3,1,0,0,0,1,2,18
Timothé Luwawu-Cabarrot,SF,23,TOT,50,7,669,82,218,.376,36,116,.310,46,102,.451,.459,31,41,.756,11,86,97,26,19,8,21,73,231,18
Timothé Luwawu-Cabarrot,SF,23,OKC,21,1,123,13,43,.302,5,22,.227,8,21,.381,.360,4,6,.667,4,14,18,4,4,1,5,14,35,18
Timothé Luwawu-Cabarrot,SF,23,CHI,29,6,546,69,175,.394,31,94,.330,38,81,.469,.483,27,35,.771,7,72,79,22,15,7,16,59,196,18
Tyler Lydon,PF,22,DEN,25,0,94,9,18,.500,4,10,.400,5,8,.625,.611,1,3,.333,7,11,18,6,2,0,4,10,23,18
Trey Lyles,PF,23,DEN,64,2,1120,207,495,.418,51,200,.255,156,295,.529,.470,81,116,.698,44,202,246,87,30,23,68,93,546,18
Scott Machado,PG,28,LAL,4,0,19,4,6,.667,1,1,1.000,3,5,.600,.750,1,1,1.000,0,0,0,3,1,0,0,2,10,18
Shelvin Mack,PG,28,TOT,57,3,1246,163,403,.404,46,130,.354,117,273,.429,.462,58,84,.690,18,86,104,183,47,4,66,84,430,18
Shelvin Mack,PG,28,MEM,53,3,1204,161,389,.414,46,128,.359,115,261,.441,.473,53,75,.707,18,84,102,182,45,4,62,81,421,18
Shelvin Mack,PG,28,CHO,4,0,42,2,14,.143,0,2,0,2,12,.167,.143,5,9,.556,0,2,2,1,2,0,4,3,9,18
Daryl Macon,SG,23,DAL,8,0,90,10,27,.370,5,11,.455,5,16,.313,.463,4,7,.571,2,10,12,7,1,0,6,8,29,18
J.P. Macura,SG,23,CHO,2,0,17,3,9,.333,0,4,0,3,5,.600,.333,0,0,0,0,3,3,2,0,0,0,0,6,18
Ian Mahinmi,C,32,WAS,34,6,498,47,104,.452,3,16,.188,44,88,.500,.466,42,61,.689,48,80,128,25,25,16,21,84,139,18
Thon Maker,C-PF,21,TOT,64,5,972,109,268,.407,49,153,.320,60,115,.522,.498,56,84,.667,41,161,202,45,21,51,33,105,323,18
Thon Maker,C,21,MIL,35,0,409,59,134,.440,26,78,.333,33,56,.589,.537,20,37,.541,17,79,96,18,10,18,9,55,164,18
Thon Maker,PF,21,DET,29,5,563,50,134,.373,23,75,.307,27,59,.458,.459,36,47,.766,24,82,106,27,11,33,24,50,159,18
Boban Marjanović,C,30,TOT,58,12,681,160,260,.615,4,10,.400,156,250,.624,.623,98,131,.748,87,178,265,54,16,27,59,90,422,18
Boban Marjanović,C,30,LAC,36,9,376,85,140,.607,0,2,0,85,138,.616,.607,72,95,.758,55,97,152,22,11,17,37,57,242,18
Boban Marjanović,C,30,PHI,22,3,305,75,120,.625,4,8,.500,71,112,.634,.642,26,36,.722,32,81,113,32,5,10,22,33,180,18
Lauri Markkanen,PF,21,CHI,52,51,1682,342,795,.430,120,332,.361,222,463,.479,.506,170,195,.872,74,396,470,75,37,33,85,122,974,18
Jarell Martin,PF,24,ORL,42,1,328,43,104,.413,20,57,.351,23,47,.489,.510,9,11,.818,11,62,73,18,3,8,11,51,115,18
Frank Mason III,PG,24,SAC,38,0,435,71,169,.420,14,64,.219,57,105,.543,.462,39,57,.684,6,37,43,84,16,4,36,34,195,18
Yante Maten,PF,22,MIA,2,0,13,1,4,.250,0,1,0,1,3,.333,.250,0,0,0,1,2,3,0,1,0,0,0,2,18
Wesley Matthews,SF-SG,32,TOT,69,68,2091,279,698,.400,150,403,.372,129,295,.437,.507,132,163,.810,32,138,170,160,54,17,91,160,840,18
Wesley Matthews,SF,32,DAL,44,44,1312,194,469,.414,100,263,.380,94,206,.456,.520,87,110,.791,20,82,102,100,33,12,58,102,575,18
Wesley Matthews,SG,32,NYK,2,1,54,4,19,.211,2,10,.200,2,9,.222,.263,4,5,.800,1,2,3,5,1,1,2,2,14,18
Wesley Matthews,SG,32,IND,23,23,725,81,210,.386,48,130,.369,33,80,.413,.500,41,48,.854,11,54,65,55,20,4,31,56,251,18
Luc Mbah a Moute,PF,32,LAC,4,0,61,8,18,.444,2,6,.333,6,12,.500,.500,2,5,.400,2,5,7,2,1,1,2,8,20,18
Tahjere McCall,SG,24,BRK,1,0,8,2,3,.667,0,1,0,2,2,1.000,.667,0,1,0,0,1,1,0,0,0,0,2,4,18
Patrick McCaw,SG,23,TOT,29,1,397,26,63,.413,9,28,.321,17,35,.486,.484,13,15,.867,7,41,48,29,23,2,17,38,74,18
Patrick McCaw,SG,23,CLE,3,0,53,2,9,.222,1,4,.250,1,5,.200,.278,0,0,0,0,3,3,2,2,0,3,1,5,18
Patrick McCaw,SG,23,TOR,26,1,344,24,54,.444,8,24,.333,16,30,.533,.519,13,15,.867,7,38,45,27,21,2,14,37,69,18
CJ McCollum,SG,27,POR,70,70,2375,571,1243,.459,167,445,.375,404,798,.506,.527,159,192,.828,62,220,282,207,55,28,106,172,1468,18
T.J. McConnell,PG,26,PHI,76,3,1470,220,419,.525,14,42,.333,206,377,.546,.542,29,37,.784,28,146,174,258,79,17,91,105,483,18
Doug McDermott,SF,27,IND,77,1,1340,207,422,.491,84,206,.408,123,216,.569,.590,66,79,.835,17,92,109,67,18,8,42,104,564,18
JaVale McGee,C,31,LAL,75,62,1671,400,641,.624,1,12,.083,399,629,.634,.625,96,152,.632,195,371,566,52,47,148,108,208,897,18
Rodney McGruder,SG,27,MIA,66,45,1550,186,461,.403,79,225,.351,107,236,.453,.489,52,72,.722,60,178,238,112,36,12,64,115,503,18
Alfonzo McKinnie,SF,26,GSW,72,5,1003,134,275,.487,42,118,.356,92,157,.586,.564,27,48,.563,81,166,247,31,18,15,30,134,337,18
Ben McLemore,SG,25,SAC,19,0,158,25,64,.391,17,41,.415,8,23,.348,.523,8,12,.667,3,14,17,4,6,3,5,22,75,18
Jordan McRae,SG,27,WAS,27,0,333,61,130,.469,10,35,.286,51,95,.537,.508,28,35,.800,6,34,40,30,13,7,15,26,160,18
Jodie Meeks,SG,31,TOR,8,0,104,21,39,.538,8,18,.444,13,21,.619,.641,1,1,1.000,1,11,12,8,1,1,2,5,51,18
Salah Mejri,C,32,DAL,36,4,399,55,112,.491,11,34,.324,44,78,.564,.540,20,32,.625,36,95,131,35,10,26,21,55,141,18
De'Anthony Melton,PG,20,PHO,50,31,984,100,256,.391,29,95,.305,71,161,.441,.447,21,28,.750,25,109,134,159,68,23,75,113,250,18
Chimezie Metu,PF,21,SAS,29,0,145,19,58,.328,0,2,0,19,56,.339,.328,13,17,.765,9,27,36,13,6,2,15,14,51,18
Khris Middleton,SF,27,MIL,77,77,2393,506,1148,.441,179,474,.378,327,674,.485,.519,216,258,.837,50,411,461,331,80,7,174,172,1407,18
C.J. Miles,SF,31,TOT,53,1,856,112,311,.360,67,203,.330,45,108,.417,.468,48,58,.828,13,82,95,36,26,15,30,79,339,18
C.J. Miles,SF,31,TOR,40,1,562,70,206,.340,43,137,.314,27,69,.391,.444,35,44,.795,12,56,68,22,18,10,21,62,218,18
C.J. Miles,SF,31,MEM,13,0,294,42,105,.400,24,66,.364,18,39,.462,.514,13,14,.929,1,26,27,14,8,5,9,17,121,18
Darius Miller,SF,28,NOP,69,15,1757,189,484,.390,133,364,.365,56,120,.467,.528,56,71,.789,14,114,128,146,40,23,59,165,567,18
Malcolm Miller,SF,25,TOR,10,0,67,11,26,.423,10,21,.476,1,5,.200,.615,3,4,.750,1,4,5,1,1,1,1,5,35,18
Patty Mills,PG,30,SAS,82,1,1908,282,663,.425,159,404,.394,123,259,.475,.545,88,103,.854,24,158,182,245,49,10,93,129,811,18
Paul Millsap,PF,33,DEN,70,65,1895,322,665,.484,58,159,.365,264,506,.522,.528,181,249,.727,153,352,505,141,83,54,95,183,883,18
Shake Milton,SG,22,PHI,20,0,268,34,87,.391,14,44,.318,20,43,.465,.471,5,7,.714,9,26,35,18,8,8,6,29,87,18
Nikola Mirotić,PF,27,TOT,46,25,1245,238,542,.439,116,318,.365,122,224,.545,.546,105,124,.847,60,279,339,55,31,34,48,107,697,18
Nikola Mirotić,PF,27,NOP,32,22,925,182,407,.447,85,231,.368,97,176,.551,.552,85,101,.842,46,218,264,35,21,25,37,86,534,18
Nikola Mirotić,PF,27,MIL,14,3,320,56,135,.415,31,87,.356,25,48,.521,.530,20,23,.870,14,61,75,20,10,9,11,21,163,18
Donovan Mitchell,SG,22,UTA,77,77,2598,661,1530,.432,188,519,.362,473,1011,.468,.493,319,396,.806,59,257,316,322,106,31,218,208,1829,18
Naz Mitrou-Long,SG,25,UTA,14,0,84,6,20,.300,2,11,.182,4,9,.444,.350,2,2,1.000,1,5,6,15,1,1,8,10,16,18
Malik Monk,SG,20,CHO,73,0,1258,227,586,.387,109,330,.330,118,256,.461,.480,90,102,.882,16,121,137,117,37,19,86,106,653,18
Greg Monroe,C,28,TOT,43,2,480,92,189,.487,1,5,.200,91,184,.495,.489,45,72,.625,67,105,172,24,14,8,32,66,230,18
Greg Monroe,C,28,TOR,38,2,423,74,161,.460,0,4,0,74,157,.471,.460,35,61,.574,60,96,156,16,13,8,31,61,183,18
Greg Monroe,C,28,BOS,2,0,5,3,5,.600,0,0,0,3,5,.600,.600,0,0,0,3,0,3,1,0,0,0,0,6,18
Greg Monroe,C,28,PHI,3,0,52,15,23,.652,1,1,1.000,14,22,.636,.674,10,11,.909,4,9,13,7,1,0,1,5,41,18
E'Twaun Moore,SG,29,NOP,53,36,1463,256,532,.481,76,176,.432,180,356,.506,.553,45,59,.763,35,92,127,102,40,8,59,112,633,18
Eric Moreland,PF,27,TOT,5,0,43,3,7,.429,1,1,1.000,2,6,.333,.500,0,0,0,4,16,20,4,1,1,5,9,7,18
Eric Moreland,PF,27,PHO,1,0,5,0,0,0,0,0,0,0,0,0,0,0,0,0,0,3,3,0,0,0,0,1,0,18
Eric Moreland,PF,27,TOR,4,0,38,3,7,.429,1,1,1.000,2,6,.333,.500,0,0,0,4,13,17,4,1,1,5,8,7,18
Jaylen Morris,SG,23,MIL,4,0,29,4,10,.400,1,3,.333,3,7,.429,.450,1,2,.500,0,5,5,4,2,0,1,1,10,18
Marcus Morris,PF,29,BOS,75,53,2091,377,844,.447,146,389,.375,231,455,.508,.533,146,173,.844,76,382,458,109,43,25,92,181,1046,18
Markieff Morris,PF,29,TOT,58,16,1270,204,484,.421,68,203,.335,136,281,.484,.492,71,92,.772,61,204,265,79,36,22,54,175,547,18
Markieff Morris,PF,29,WAS,34,15,883,143,328,.436,48,144,.333,95,184,.516,.509,57,73,.781,41,133,174,60,25,20,47,117,391,18
Markieff Morris,PF,29,OKC,24,1,387,61,156,.391,20,59,.339,41,97,.423,.455,14,19,.737,20,71,91,19,11,2,7,58,156,18
Monte Morris,PG,23,DEN,82,6,1970,346,702,.493,94,227,.414,252,475,.531,.560,65,81,.802,35,159,194,297,73,4,52,102,851,18
Donatas Motiejūnas,PF,28,SAS,3,0,13,3,6,.500,0,0,0,3,6,.500,.500,0,2,0,2,1,3,1,0,1,3,6,6,18
Johnathan Motley,PF,23,LAC,22,0,156,39,73,.534,0,3,0,39,70,.557,.534,24,40,.600,18,33,51,11,5,3,16,27,102,18
Emmanuel Mudiay,PG,22,NYK,59,42,1607,330,740,.446,69,210,.329,261,530,.492,.493,144,186,.774,33,163,196,228,43,19,140,103,873,18
Jamal Murray,PG,21,DEN,75,74,2447,513,1173,.437,152,414,.367,361,759,.476,.502,189,223,.848,65,252,317,363,67,27,158,153,1367,18
Džanan Musa,SG,19,BRK,9,0,39,9,22,.409,1,10,.100,8,12,.667,.432,0,2,0,1,4,5,2,2,0,4,1,19,18
Mike Muscala,PF,27,TOT,64,10,1306,145,361,.402,89,256,.348,56,105,.533,.525,70,85,.824,57,187,244,76,22,38,48,130,449,18
Mike Muscala,PF,27,PHI,47,6,1041,109,278,.392,68,199,.342,41,79,.519,.514,63,77,.818,51,149,200,62,18,27,43,112,349,18
Mike Muscala,PF,27,LAL,17,4,265,36,83,.434,21,57,.368,15,26,.577,.560,7,8,.875,6,38,44,14,4,11,5,18,100,18
Svi Mykhailiuk,SF,21,TOT,42,0,440,46,140,.329,29,89,.326,17,51,.333,.432,12,20,.600,9,27,36,37,14,1,21,25,133,18
Svi Mykhailiuk,SF,21,LAL,39,0,420,44,132,.333,27,85,.318,17,47,.362,.436,12,20,.600,8,26,34,33,13,1,20,25,127,18
Svi Mykhailiuk,SF,21,DET,3,0,20,2,8,.250,2,4,.500,0,4,0,.375,0,0,0,1,1,2,4,1,0,1,0,6,18
Abdel Nader,SF,25,OKC,61,1,694,91,215,.423,32,100,.320,59,115,.513,.498,27,36,.750,14,102,116,20,20,12,26,68,241,18
Larry Nance Jr.,C,26,CLE,67,30,1795,249,479,.520,33,98,.337,216,381,.567,.554,96,134,.716,168,384,552,214,100,40,97,192,627,18
Shabazz Napier,PG,27,BRK,56,2,983,169,435,.389,76,228,.333,93,207,.449,.476,115,138,.833,18,82,100,143,41,16,66,67,529,18
Raul Neto,PG,26,UTA,37,1,474,74,161,.460,20,60,.333,54,101,.535,.522,28,33,.848,6,56,62,93,14,4,35,49,196,18
Georges Niang,PF,25,UTA,59,0,516,86,181,.475,43,105,.410,43,76,.566,.594,20,24,.833,11,76,87,35,10,6,23,57,235,18
Joakim Noah,C,33,MEM,42,1,693,110,213,.516,0,1,0,110,212,.519,.516,78,109,.716,58,180,238,89,20,31,50,96,298,18
Nerlens Noel,C,24,OKC,77,2,1055,162,276,.587,0,0,0,162,276,.587,.587,54,79,.684,127,198,325,45,66,96,48,166,378,18
Dirk Nowitzki,PF,40,DAL,51,20,795,135,376,.359,64,205,.312,71,171,.415,.444,39,50,.780,5,153,158,35,9,18,18,76,373,18
Frank Ntilikina,PG,20,NYK,43,16,904,95,282,.337,33,115,.287,62,167,.371,.395,23,30,.767,12,75,87,121,30,14,56,104,246,18
James Nunnally,SF,28,TOT,15,0,102,12,34,.353,8,25,.320,4,9,.444,.471,4,4,1.000,0,5,5,7,1,0,1,10,36,18
James Nunnally,SF,28,MIN,13,0,64,9,21,.429,5,13,.385,4,8,.500,.548,4,4,1.000,0,4,4,5,1,0,1,4,27,18
James Nunnally,SF,28,HOU,2,0,38,3,13,.231,3,12,.250,0,1,0,.346,0,0,0,0,1,1,2,0,0,0,6,9,18
Jusuf Nurkić,C,24,POR,72,72,1974,420,826,.508,3,29,.103,417,797,.523,.510,282,365,.773,243,505,748,233,71,103,168,250,1125,18
David Nwaba,SF,26,CLE,51,14,984,126,262,.481,24,75,.320,102,187,.545,.527,58,85,.682,41,122,163,54,36,17,29,106,334,18
Royce O'Neale,SF,25,UTA,82,16,1671,163,343,.475,68,176,.386,95,167,.569,.574,32,42,.762,22,263,285,124,54,24,70,172,426,18
Kyle O'Quinn,C,28,IND,45,3,371,69,136,.507,1,12,.083,68,124,.548,.511,17,21,.810,29,90,119,56,9,25,31,68,156,18
Semi Ojeleye,PF,24,BOS,56,3,594,67,158,.424,28,89,.315,39,69,.565,.513,24,39,.615,24,62,86,23,10,4,19,43,186,18
Jahlil Okafor,C,23,NOP,59,24,935,212,362,.586,1,5,.200,211,357,.591,.587,59,89,.663,82,196,278,40,15,40,52,96,484,18
Elie Okobo,PG,21,PHO,53,16,958,114,290,.393,39,132,.295,75,158,.475,.460,37,47,.787,12,86,98,127,32,7,69,109,304,18
Josh Okogie,SG,20,MIN,74,52,1757,196,508,.386,60,215,.279,136,293,.464,.445,118,162,.728,41,177,218,91,88,33,63,166,570,18
Victor Oladipo,SG,26,IND,36,36,1147,249,588,.423,74,216,.343,175,372,.470,.486,103,141,.730,21,181,202,186,60,11,82,72,675,18
Kelly Olynyk,PF,27,MIA,79,36,1812,261,564,.463,113,319,.354,148,245,.604,.563,152,185,.822,72,303,375,140,53,37,114,183,787,18
Cedi Osman,SF,23,CLE,76,75,2444,360,844,.427,130,374,.348,230,470,.489,.504,141,181,.779,45,312,357,195,60,11,114,195,991,18
Kelly Oubre Jr.,SF,23,TOT,69,19,1935,375,842,.445,108,338,.320,267,504,.530,.510,189,244,.775,71,254,325,84,84,59,103,181,1047,18
Kelly Oubre Jr.,SF,23,WAS,29,7,755,132,305,.433,41,132,.311,91,173,.526,.500,68,85,.800,24,105,129,20,27,20,30,71,373,18
Kelly Oubre Jr.,SF,23,PHO,40,12,1180,243,537,.453,67,206,.325,176,331,.532,.515,121,159,.761,47,149,196,64,57,39,73,110,674,18
Zaza Pachulia,C,34,DET,68,3,878,85,193,.440,0,4,0,85,189,.450,.440,97,124,.782,99,166,265,91,31,17,57,151,267,18
Jabari Parker,PF,23,TOT,64,17,1724,369,749,.493,61,195,.313,308,554,.556,.533,131,184,.712,79,342,421,152,46,30,151,145,930,18
Jabari Parker,PF,23,CHI,39,17,1042,220,464,.474,37,114,.325,183,350,.523,.514,79,108,.731,41,200,241,84,23,14,84,87,556,18
Jabari Parker,PF,23,WAS,25,0,682,149,285,.523,24,81,.296,125,204,.613,.565,52,76,.684,38,142,180,68,23,16,67,58,374,18
Tony Parker,PG,36,CHO,56,0,1003,213,463,.460,13,51,.255,200,412,.485,.474,91,124,.734,14,69,83,207,21,7,75,53,530,18
Chandler Parsons,SF,30,MEM,25,3,496,68,182,.374,29,94,.309,39,88,.443,.453,22,25,.880,4,66,70,43,19,5,32,45,187,18
Patrick Patterson,PF,29,OKC,63,5,861,82,219,.374,46,137,.336,36,82,.439,.479,19,30,.633,42,105,147,31,16,13,22,46,229,18
Justin Patton,C,21,PHI,3,0,21,2,7,.286,0,2,0,2,5,.400,.286,1,2,.500,2,4,6,3,2,0,0,5,5,18
Chris Paul,PG,33,HOU,58,58,1857,302,720,.419,127,355,.358,175,365,.479,.508,175,203,.862,36,229,265,473,114,18,152,146,906,18
Cameron Payne,PG,24,TOT,40,13,712,96,223,.430,25,84,.298,71,139,.511,.487,33,41,.805,13,59,72,106,28,9,45,64,250,18
Cameron Payne,PG,24,CHI,31,12,536,69,168,.411,16,59,.271,53,109,.486,.458,22,25,.880,10,43,53,83,20,6,34,49,176,18
Cameron Payne,PG,24,CLE,9,1,176,27,55,.491,9,25,.360,18,30,.600,.573,11,16,.688,3,16,19,23,8,3,11,15,74,18
Elfrid Payton,PG,24,NOP,42,42,1250,179,412,.434,33,105,.314,146,307,.476,.475,55,74,.743,49,171,220,320,44,17,112,81,446,18
Gary Payton II,PG,26,WAS,3,0,16,5,8,.625,1,2,.500,4,6,.667,.688,0,0,0,1,1,2,4,3,1,1,2,11,18
Theo Pinson,SG,23,BRK,18,0,211,25,73,.342,12,46,.261,13,27,.481,.425,19,22,.864,4,32,36,21,6,0,18,15,81,18
Mason Plumlee,C,28,DEN,82,17,1731,262,442,.593,2,10,.200,260,432,.602,.595,111,198,.561,165,359,524,243,66,76,126,252,637,18
Miles Plumlee,C,30,ATL,18,0,173,32,48,.667,0,0,0,32,48,.667,.667,16,30,.533,16,23,39,17,6,4,10,14,80,18
Jakob Poeltl,C,23,SAS,77,24,1273,187,290,.645,0,0,0,187,290,.645,.645,49,92,.533,178,232,410,93,29,68,48,124,423,18
Quincy Pondexter,SF,30,SAS,53,0,292,29,58,.500,6,18,.333,23,40,.575,.552,34,42,.810,8,38,46,24,11,1,13,24,98,18
Otto Porter Jr.,SF,25,TOT,56,43,1683,299,643,.465,104,256,.406,195,387,.504,.546,78,96,.813,54,260,314,120,82,31,65,108,780,18
Otto Porter Jr.,SF,25,WAS,41,28,1191,202,442,.457,65,176,.369,137,266,.515,.531,49,64,.766,40,191,231,80,64,22,40,79,518,18
Otto Porter Jr.,SF,25,CHI,15,15,492,97,201,.483,39,80,.488,58,121,.479,.580,29,32,.906,14,69,83,40,18,9,25,29,262,18
Bobby Portis,PF,23,TOT,50,28,1299,279,628,.444,75,191,.393,204,437,.467,.504,77,97,.794,109,294,403,72,35,20,74,145,710,18
Bobby Portis,PF,23,CHI,22,6,531,122,271,.450,27,72,.375,95,199,.477,.500,39,50,.780,46,115,161,29,11,8,29,61,310,18
Bobby Portis,PF,23,WAS,28,22,768,157,357,.440,48,119,.403,109,238,.458,.507,38,47,.809,63,179,242,43,24,12,45,84,400,18
Dwight Powell,C,27,DAL,77,22,1662,290,486,.597,39,127,.307,251,359,.699,.637,196,254,.772,140,271,411,112,44,50,67,201,815,18
Norman Powell,SG,25,TOR,60,3,1126,193,400,.483,68,170,.400,125,230,.543,.568,62,75,.827,16,123,139,91,39,13,65,96,516,18
Alex Poythress,PF,25,ATL,21,1,305,40,81,.494,9,23,.391,31,58,.534,.549,18,29,.621,29,47,76,17,4,10,13,47,107,18
Taurean Prince,SF,24,ATL,55,47,1552,262,594,.441,123,315,.390,139,279,.498,.545,95,116,.819,22,177,199,118,53,19,100,141,742,18
Zhou Qi,PF,23,HOU,1,0,1,1,1,1.000,0,0,0,1,1,1.000,1.000,0,0,0,0,0,0,0,0,0,0,0,2,18
Ivan Rabb,PF,21,MEM,49,13,721,116,212,.547,3,15,.200,113,197,.574,.554,49,69,.710,70,136,206,54,17,14,35,90,284,18
Chasson Randle,PG,25,WAS,49,2,743,91,217,.419,46,115,.400,45,102,.441,.525,43,62,.694,10,46,56,97,25,3,43,91,271,18
Julius Randle,PF,24,NOP,73,49,2232,571,1089,.524,67,195,.344,504,894,.564,.555,356,487,.731,162,472,634,229,52,45,208,246,1565,18
J.J. Redick,SG,34,PHI,76,63,2379,452,1027,.440,240,605,.397,212,422,.502,.557,228,255,.894,20,166,186,206,32,17,101,129,1372,18
Davon Reed,SG,23,IND,10,0,47,5,12,.417,2,4,.500,3,8,.375,.500,0,0,0,2,4,6,3,1,0,1,3,12,18
Cameron Reynolds,SG,23,MIN,19,0,259,33,78,.423,21,51,.412,12,27,.444,.558,8,9,.889,4,27,31,13,6,2,5,26,95,18
Josh Richardson,SG,25,MIA,73,73,2539,423,1026,.412,164,460,.357,259,566,.458,.492,199,231,.861,54,209,263,298,79,34,113,200,1209,18
Malachi Richardson,SG,23,TOR,22,0,103,9,29,.310,8,25,.320,1,4,.250,.448,4,5,.800,2,11,13,0,1,0,8,13,30,18
Austin Rivers,SG,26,TOT,76,15,2028,232,572,.406,104,327,.318,128,245,.522,.497,50,95,.526,25,137,162,167,47,23,68,207,618,18
Austin Rivers,SG,26,WAS,29,2,683,76,194,.392,33,106,.311,43,88,.489,.477,25,46,.543,10,61,71,58,18,10,36,72,210,18
Austin Rivers,SG,26,HOU,47,13,1345,156,378,.413,71,221,.321,85,157,.541,.507,25,49,.510,15,76,91,109,29,13,32,135,408,18
Devin Robinson,SF,23,WAS,7,0,95,19,32,.594,0,2,0,19,30,.633,.594,9,14,.643,6,14,20,6,4,6,2,11,47,18
Duncan Robinson,SF,24,MIA,15,1,161,18,46,.391,10,35,.286,8,11,.727,.500,4,6,.667,2,17,19,5,5,0,4,11,50,18
Glenn Robinson III,SF,25,DET,47,18,610,74,176,.420,18,62,.290,56,114,.491,.472,32,40,.800,17,54,71,21,14,8,18,45,198,18
Jerome Robinson,SG,21,LAC,33,0,320,44,110,.400,18,57,.316,26,53,.491,.482,6,9,.667,3,38,41,19,11,3,13,46,112,18
Mitchell Robinson,C,20,NYK,66,19,1360,202,291,.694,0,0,0,202,291,.694,.694,81,135,.600,177,246,423,37,52,161,35,217,485,18
Rajon Rondo,PG,32,LAL,46,29,1369,175,432,.405,51,142,.359,124,290,.428,.464,23,36,.639,34,209,243,367,57,7,127,100,424,18
Derrick Rose,PG,30,MIN,51,13,1392,363,753,.482,54,146,.370,309,607,.509,.518,137,160,.856,33,107,140,220,31,12,82,57,917,18
Terrence Ross,SG,27,ORL,81,0,2150,440,1027,.428,217,566,.383,223,461,.484,.534,126,144,.875,27,253,280,135,72,29,90,119,1223,18
Terry Rozier,PG,24,BOS,79,14,1791,258,666,.387,119,337,.353,139,329,.422,.477,73,93,.785,32,275,307,231,68,21,68,101,708,18
Ricky Rubio,PG,28,UTA,68,67,1899,295,730,.404,79,254,.311,216,476,.454,.458,195,228,.855,33,210,243,416,91,10,180,180,864,18
D'Angelo Russell,PG,22,BRK,81,81,2448,659,1517,.434,234,635,.369,425,882,.482,.512,160,205,.780,53,262,315,563,100,20,253,141,1712,18
Domantas Sabonis,C,22,IND,74,5,1838,413,700,.590,9,17,.529,404,683,.592,.596,208,291,.715,186,504,690,212,48,30,160,239,1043,18
Brandon Sampson,SG,21,CHI,14,2,214,28,60,.467,11,29,.379,17,31,.548,.558,4,6,.667,3,13,16,10,8,3,12,19,71,18
JaKarr Sampson,SF,25,CHI,4,0,127,29,54,.537,5,14,.357,24,40,.600,.583,17,21,.810,5,27,32,4,4,3,4,8,80,18
Dario Šarić,PF,24,TOT,81,41,2023,304,696,.437,118,323,.365,186,373,.499,.522,132,150,.880,126,331,457,127,45,9,97,182,858,18
Dario Šarić,PF,24,PHI,13,13,396,48,132,.364,21,70,.300,27,62,.435,.443,27,30,.900,21,65,86,26,4,3,25,39,144,18
Dario Šarić,PF,24,MIN,68,28,1627,256,564,.454,97,253,.383,159,311,.511,.540,105,120,.875,105,266,371,101,41,6,72,143,714,18
Tomáš Satoranský,PG,27,WAS,80,54,2164,257,530,.485,64,162,.395,193,368,.524,.545,131,160,.819,82,197,279,399,82,13,120,172,709,18
Dennis Schröder,PG,25,OKC,79,14,2314,457,1104,.414,124,364,.341,333,740,.450,.470,186,227,.819,38,246,284,323,65,12,172,189,1224,18
Mike Scott,PF,30,TOT,79,3,1395,168,420,.400,101,252,.401,67,168,.399,.520,22,33,.667,43,233,276,66,26,13,44,156,459,18
Mike Scott,PF,30,LAC,52,0,748,92,230,.400,52,133,.391,40,97,.412,.513,12,18,.667,24,150,174,44,17,8,27,88,248,18
Mike Scott,PF,30,PHI,27,3,647,76,190,.400,49,119,.412,27,71,.380,.529,10,15,.667,19,83,102,22,9,5,17,68,211,18
Thabo Sefolosha,SF,34,UTA,50,2,609,71,149,.477,34,78,.436,37,71,.521,.591,14,22,.636,8,115,123,27,43,5,25,41,190,18
Wayne Selden,SG,24,TOT,75,13,1439,196,483,.406,55,174,.316,141,309,.456,.463,67,92,.728,37,143,180,109,33,13,79,131,514,18
Wayne Selden,SG,24,MEM,32,0,455,65,161,.404,20,63,.317,45,98,.459,.466,22,29,.759,16,28,44,36,10,6,23,48,172,18
Wayne Selden,SG,24,CHI,43,13,984,131,322,.407,35,111,.315,96,211,.455,.461,45,63,.714,21,115,136,73,23,7,56,83,342,18
Collin Sexton,PG,20,CLE,82,72,2605,519,1206,.430,119,296,.402,400,910,.440,.480,214,255,.839,57,179,236,243,44,6,185,186,1371,18
Landry Shamet,SG,21,TOT,79,27,1802,240,557,.431,167,396,.422,73,161,.453,.581,75,93,.806,21,113,134,117,37,10,45,155,722,18
Landry Shamet,SG,21,PHI,54,4,1108,153,347,.441,99,245,.404,54,102,.529,.584,44,54,.815,14,64,78,59,24,8,26,106,449,18
Landry Shamet,SG,21,LAC,25,23,694,87,210,.414,68,151,.450,19,59,.322,.576,31,39,.795,7,49,56,58,13,2,19,49,273,18
Iman Shumpert,SG,28,TOT,62,41,1481,167,446,.374,95,273,.348,72,173,.416,.481,36,45,.800,27,156,183,112,59,24,50,127,465,18
Iman Shumpert,SG,28,SAC,42,40,1099,133,348,.382,74,202,.366,59,146,.404,.489,34,41,.829,19,110,129,91,47,20,38,92,374,18
Iman Shumpert,SG,28,HOU,20,1,382,34,98,.347,21,71,.296,13,27,.481,.454,2,4,.500,8,46,54,21,12,4,12,35,91,18
Pascal Siakam,PF,24,TOR,80,79,2548,519,945,.549,79,214,.369,440,731,.602,.591,237,302,.785,124,425,549,248,73,52,154,241,1354,18
Jordan Sibert,SG,26,ATL,1,0,4,1,1,1.000,1,1,1.000,0,0,0,1.500,0,0,0,0,0,0,0,0,0,0,0,3,18
Ben Simmons,PG,22,PHI,79,79,2700,540,960,.563,0,6,0,540,954,.566,.563,257,428,.600,172,525,697,610,112,61,274,209,1337,18
Jonathon Simmons,SG-SF,29,TOT,56,9,1064,133,350,.380,28,104,.269,105,246,.427,.420,72,97,.742,27,99,126,128,29,15,68,89,366,18
Jonathon Simmons,SG,29,ORL,41,9,845,104,286,.364,19,83,.229,85,203,.419,.397,56,72,.778,23,77,100,95,18,14,56,68,283,18
Jonathon Simmons,SF,29,PHI,15,0,219,29,64,.453,9,21,.429,20,43,.465,.523,16,25,.640,4,22,26,33,11,1,12,21,83,18
Kobi Simmons,PG,21,CLE,1,0,2,0,0,0,0,0,0,0,0,0,0,0,0,0,0,0,0,0,0,0,0,0,0,18
Anfernee Simons,SG,19,POR,20,1,141,28,63,.444,10,29,.345,18,34,.529,.524,9,16,.563,3,10,13,13,1,0,11,9,75,18
Marcus Smart,SG,24,BOS,80,60,2200,239,567,.422,126,346,.364,113,221,.511,.533,104,129,.806,57,177,234,321,143,28,123,201,708,18
Dennis Smith Jr.,PG,21,TOT,53,50,1508,278,650,.428,67,208,.322,211,442,.477,.479,99,156,.635,32,123,155,252,67,20,154,129,722,18
Dennis Smith Jr.,PG,21,DAL,32,32,908,157,357,.440,43,125,.344,114,232,.491,.500,57,82,.695,18,79,97,138,40,11,100,82,414,18
Dennis Smith Jr.,PG,21,NYK,21,18,600,121,293,.413,24,83,.289,97,210,.462,.454,42,74,.568,14,44,58,114,27,9,54,47,308,18
Ish Smith,PG,30,DET,56,0,1251,205,489,.419,44,135,.326,161,354,.455,.464,47,62,.758,23,122,145,203,28,11,61,109,501,18
J.R. Smith,SG,33,CLE,11,4,222,27,79,.342,12,39,.308,15,40,.375,.418,8,10,.800,0,18,18,21,11,3,11,19,74,18
Jason Smith,C-PF,32,TOT,20,1,190,21,59,.356,9,26,.346,12,33,.364,.432,14,16,.875,16,36,52,14,3,7,13,30,65,18
Jason Smith,C,32,WAS,12,1,130,15,37,.405,4,10,.400,11,27,.407,.459,10,12,.833,11,26,37,12,1,5,7,21,44,18
Jason Smith,PF,32,MIL,6,0,40,4,13,.308,3,9,.333,1,4,.250,.423,2,2,1.000,3,8,11,1,2,2,5,6,13,18
Jason Smith,C,32,NOP,2,0,20,2,9,.222,2,7,.286,0,2,0,.333,2,2,1.000,2,2,4,1,0,0,1,3,8,18
Zhaire Smith,SG,19,PHI,6,2,111,14,34,.412,6,16,.375,8,18,.444,.500,6,8,.750,3,10,13,10,2,2,6,8,40,18
Tony Snell,SF,27,MIL,74,12,1304,163,361,.452,81,204,.397,82,157,.522,.564,37,42,.881,29,128,157,68,26,18,23,90,444,18
Ray Spalding,PF,21,TOT,14,3,148,25,47,.532,0,3,0,25,44,.568,.532,4,12,.333,15,33,48,5,9,8,9,23,54,18
Ray Spalding,PF,21,DAL,1,0,1,0,0,0,0,0,0,0,0,0,0,0,0,0,0,0,0,0,0,0,0,0,0,18
Ray Spalding,PF,21,PHO,13,3,147,25,47,.532,0,3,0,25,44,.568,.532,4,12,.333,15,33,48,5,9,8,9,23,54,18
Omari Spellman,PF,21,ATL,46,11,805,98,244,.402,44,128,.344,54,116,.466,.492,32,45,.711,72,122,194,47,26,25,31,67,272,18
Nik Stauskas,SG,25,TOT,68,0,1015,136,338,.402,70,188,.372,66,150,.440,.506,57,64,.891,18,109,127,81,21,7,51,50,399,18
Nik Stauskas,SG,25,POR,44,0,673,96,229,.419,43,125,.344,53,104,.510,.513,32,36,.889,10,70,80,62,14,4,40,31,267,18
Nik Stauskas,SG,25,CLE,24,0,342,40,109,.367,27,63,.429,13,46,.283,.491,25,28,.893,8,39,47,19,7,3,11,19,132,18
D.J. Stephens,SG,28,MEM,1,0,7,1,2,.500,0,0,0,1,2,.500,.500,0,0,0,0,0,0,0,1,0,1,0,2,18
Lance Stephenson,SG,28,LAL,68,3,1123,184,432,.426,73,197,.371,111,235,.472,.510,50,73,.685,32,183,215,140,41,7,86,111,491,18
Edmond Sumner,PG,23,IND,23,2,210,22,64,.344,7,27,.259,15,37,.405,.398,15,24,.625,9,15,24,10,12,5,10,26,66,18
Caleb Swanigan,PF,21,TOT,21,0,178,18,53,.340,1,7,.143,17,46,.370,.349,6,9,.667,17,47,64,11,6,1,18,28,43,18
Caleb Swanigan,PF,21,POR,18,0,145,14,44,.318,1,5,.200,13,39,.333,.330,6,7,.857,13,39,52,7,4,0,16,22,35,18
Caleb Swanigan,PF,21,SAC,3,0,33,4,9,.444,0,2,0,4,7,.571,.444,0,2,0,4,8,12,4,2,1,2,6,8,18
Jayson Tatum,SF,20,BOS,79,79,2455,466,1036,.450,116,311,.373,350,725,.483,.506,195,228,.855,70,407,477,168,84,57,122,168,1243,18
Jeff Teague,PG,30,MIN,42,41,1264,176,416,.423,35,105,.333,141,311,.453,.465,123,153,.804,16,90,106,343,43,18,97,90,510,18
Garrett Temple,SG,32,TOT,75,55,2040,208,493,.422,90,264,.341,118,229,.515,.513,80,107,.748,28,188,216,106,76,30,70,204,586,18
Garrett Temple,SG,32,MEM,49,49,1530,166,387,.429,74,210,.352,92,177,.520,.525,57,76,.750,18,134,152,69,50,25,54,134,463,18
Garrett Temple,SG,32,LAC,26,6,510,42,106,.396,16,54,.296,26,52,.500,.472,23,31,.742,10,54,64,37,26,5,16,70,123,18
Miloš Teodosić,PG,31,LAC,15,0,150,17,40,.425,10,27,.370,7,13,.538,.550,4,7,.571,3,13,16,32,3,1,21,27,48,18
Jared Terrell,SG,23,MIN,14,0,111,12,39,.308,4,17,.235,8,22,.364,.359,3,6,.500,1,5,6,12,3,2,10,16,31,18
Emanuel Terry,PF,22,TOT,3,0,23,4,7,.571,0,0,0,4,7,.571,.571,2,4,.500,3,4,7,2,3,0,2,4,10,18
Emanuel Terry,PF,22,PHO,2,0,20,4,6,.667,0,0,0,4,6,.667,.667,1,2,.500,2,4,6,1,3,0,2,4,9,18
Emanuel Terry,PF,22,MIA,1,0,3,0,1,0,0,0,0,0,1,0,0,1,2,.500,1,0,1,1,0,0,0,0,1,18
Daniel Theis,C,26,BOS,66,2,908,146,266,.549,26,67,.388,120,199,.603,.598,56,76,.737,87,138,225,68,21,42,33,161,374,18
Isaiah Thomas,SG,29,DEN,12,0,181,34,99,.343,12,43,.279,22,56,.393,.404,17,27,.630,5,8,13,23,5,1,18,17,97,18
Khyri Thomas,SG,22,DET,26,0,195,22,69,.319,10,35,.286,12,34,.353,.391,7,11,.636,4,16,20,8,7,5,4,22,61,18
Lance Thomas,PF,30,NYK,46,17,783,78,197,.396,22,79,.278,56,118,.475,.452,27,36,.750,21,96,117,27,17,7,24,83,205,18
Klay Thompson,SG,28,GSW,78,78,2652,655,1402,.467,241,599,.402,414,803,.516,.553,129,158,.816,37,262,299,186,84,47,115,157,1680,18
Tristan Thompson,C,27,CLE,43,40,1198,201,380,.529,0,0,0,201,380,.529,.529,68,106,.642,173,265,438,86,28,16,59,89,470,18
Sindarius Thornwell,SG,24,LAC,64,1,313,17,49,.347,3,15,.200,14,34,.412,.378,25,34,.735,5,39,44,18,14,7,20,41,62,18
Anthony Tolliver,PF,33,MIN,65,0,1079,99,259,.382,81,215,.377,18,44,.409,.539,47,60,.783,15,162,177,46,17,21,36,91,326,18
Karl-Anthony Towns,C,23,MIN,77,77,2545,681,1314,.518,142,355,.400,539,959,.562,.572,376,450,.836,263,691,954,259,67,125,240,292,1880,18
Gary Trent Jr.,SG,20,POR,15,1,111,16,50,.320,5,21,.238,11,29,.379,.370,3,7,.429,1,10,11,5,1,2,4,4,40,18
Allonzo Trier,SG,23,NYK,64,3,1459,232,518,.448,52,132,.394,180,386,.466,.498,179,223,.803,31,166,197,119,28,14,116,117,695,18
P.J. Tucker,PF,33,HOU,82,82,2802,207,523,.396,146,387,.377,61,136,.449,.535,41,59,.695,121,358,479,96,132,39,63,252,601,18
Evan Turner,PG,30,POR,73,2,1605,204,443,.460,11,52,.212,193,391,.494,.473,75,106,.708,37,291,328,283,33,18,114,110,494,18
Myles Turner,C,22,IND,74,74,2119,380,780,.487,76,196,.388,304,584,.521,.536,148,201,.736,101,430,531,115,60,199,100,195,984,18
Ekpe Udoh,C,31,UTA,51,1,320,50,72,.694,0,0,0,50,72,.694,.694,19,30,.633,27,63,90,28,10,31,13,36,119,18
Tyler Ulis,PG,23,CHI,1,0,1,0,0,0,0,0,0,0,0,0,0,0,0,0,0,0,0,0,0,0,0,0,0,18
Jonas Valančiūnas,C,26,TOT,49,27,1091,301,538,.559,14,48,.292,287,490,.586,.572,147,185,.795,106,313,419,70,19,53,90,146,763,18
Jonas Valančiūnas,C,26,TOR,30,10,564,149,259,.575,9,30,.300,140,229,.611,.593,77,94,.819,54,162,216,29,13,23,39,82,384,18
Jonas Valančiūnas,C,26,MEM,19,17,527,152,279,.545,5,18,.278,147,261,.563,.554,70,91,.769,52,151,203,41,6,30,51,64,379,18
Jarred Vanderbilt,PF,19,DEN,17,0,69,9,19,.474,0,1,0,9,18,.500,.474,6,10,.600,7,16,23,3,6,1,8,8,24,18
Fred VanVleet,PG,24,TOR,64,28,1760,246,600,.410,112,296,.378,134,304,.441,.503,97,115,.843,21,146,167,307,57,20,82,110,701,18
Noah Vonleh,PF,23,NYK,68,57,1722,207,440,.470,46,137,.336,161,303,.531,.523,111,156,.712,113,415,528,129,46,51,88,174,571,18
Nikola Vučević,C,28,ORL,80,80,2510,701,1354,.518,84,231,.364,617,1123,.549,.549,179,227,.789,224,736,960,307,81,89,159,157,1665,18
Dwyane Wade,SG,37,MIA,72,2,1885,416,960,.433,86,261,.330,330,699,.472,.478,165,233,.708,69,216,285,301,59,38,166,118,1083,18
Moritz Wagner,C,21,LAL,43,5,446,71,171,.415,22,77,.286,49,94,.521,.480,43,53,.811,17,68,85,24,11,13,39,57,207,18
Dion Waiters,SG,27,MIA,44,28,1138,198,478,.414,109,289,.377,89,189,.471,.528,22,44,.500,7,109,116,121,29,9,64,72,527,18
Kemba Walker,PG,28,CHO,82,82,2863,731,1684,.434,260,731,.356,471,953,.494,.511,380,450,.844,52,309,361,484,102,34,211,131,2102,18
Lonnie Walker IV,SG,20,SAS,17,0,118,16,46,.348,5,13,.385,11,33,.333,.402,8,10,.800,0,17,17,9,7,3,4,7,45,18
John Wall,PG,28,WAS,32,32,1104,245,552,.444,51,169,.302,194,383,.507,.490,122,175,.697,15,101,116,279,49,29,121,71,663,18
Tyrone Wallace,PG,24,LAC,62,0,628,92,217,.424,4,19,.211,88,198,.444,.433,30,57,.526,20,81,101,42,21,7,36,83,218,18
Brad Wanamaker,PG,29,BOS,36,0,343,50,105,.476,16,39,.410,34,66,.515,.552,24,28,.857,3,38,41,56,12,2,19,34,140,18
T.J. Warren,SF,25,PHO,43,36,1360,297,611,.486,77,180,.428,220,431,.510,.549,101,124,.815,31,143,174,64,51,29,52,119,772,18
Julian Washburn,SF,27,MEM,18,3,254,16,48,.333,5,24,.208,11,24,.458,.385,3,4,.750,8,33,41,14,13,2,7,16,40,18
Yuta Watanabe,SF,24,MEM,15,0,174,15,51,.294,2,16,.125,13,35,.371,.314,7,10,.700,4,27,31,8,4,1,6,11,39,18
Thomas Welsh,C,22,DEN,11,0,36,7,13,.538,3,7,.429,4,6,.667,.654,1,2,.500,0,4,4,5,0,0,1,3,18,18
Russell Westbrook,PG,30,OKC,73,73,2630,630,1473,.428,119,411,.290,511,1062,.481,.468,296,451,.656,109,698,807,784,142,33,325,245,1675,18
Derrick White,PG,24,SAS,67,55,1728,260,543,.479,48,142,.338,212,401,.529,.523,95,123,.772,35,212,247,263,67,47,97,145,663,18
Okaro White,PF,26,WAS,3,0,6,0,2,0,0,2,0,0,0,0,0,0,0,0,1,1,2,0,0,0,0,0,0,18
Hassan Whiteside,C,29,MIA,72,53,1674,388,680,.571,2,16,.125,386,664,.581,.572,109,243,.449,257,560,817,56,46,136,97,192,887,18
Andrew Wiggins,SF,23,MIN,73,73,2543,498,1209,.412,118,348,.339,380,861,.441,.461,207,296,.699,83,269,352,184,70,48,138,153,1321,18
Alan Williams,PF,26,BRK,5,0,26,8,13,.615,0,1,0,8,12,.667,.615,2,4,.500,4,15,19,3,1,0,1,2,18,18
C.J. Williams,SG,28,MIN,15,0,128,17,35,.486,5,16,.313,12,19,.632,.557,0,1,0,1,7,8,12,6,0,5,16,39,18
Johnathan Williams,C,23,LAL,24,0,372,65,110,.591,0,2,0,65,108,.602,.591,27,48,.563,48,51,99,13,8,7,16,62,157,18
Kenrich Williams,SF,24,NOP,46,29,1079,107,279,.384,52,156,.333,55,123,.447,.477,13,19,.684,55,164,219,83,45,19,36,95,279,18
Lou Williams,SG,32,LAC,75,1,1993,484,1138,.425,105,291,.361,379,847,.447,.471,425,485,.876,40,182,222,402,57,11,181,80,1498,18
Marvin Williams,PF,32,CHO,75,75,2133,275,652,.422,140,382,.366,135,270,.500,.529,66,86,.767,76,331,407,92,71,61,47,156,756,18
Robert Williams,C,21,BOS,32,2,283,36,51,.706,0,0,0,36,51,.706,.706,9,15,.600,27,54,81,7,9,40,10,36,81,18
Troy Williams,SF,24,SAC,21,0,312,44,98,.449,14,44,.318,30,54,.556,.520,9,15,.600,12,47,59,11,10,8,9,37,111,18
D.J. Wilson,PF,22,MIL,48,3,882,104,251,.414,46,127,.362,58,124,.468,.506,26,47,.553,45,177,222,52,18,20,32,85,280,18
Justise Winslow,SF,22,MIA,66,52,1959,324,749,.433,96,256,.375,228,493,.462,.497,86,137,.628,63,292,355,282,72,19,142,177,830,18
Christian Wood,PF,23,TOT,21,2,251,61,117,.521,9,26,.346,52,91,.571,.560,41,56,.732,17,66,83,8,7,10,17,17,172,18
Christian Wood,PF,23,MIL,13,0,62,12,25,.480,3,5,.600,9,20,.450,.540,10,15,.667,4,16,20,2,0,0,3,3,37,18
Christian Wood,PF,23,NOP,8,2,189,49,92,.533,6,21,.286,43,71,.606,.565,31,41,.756,13,50,63,6,7,10,14,14,135,18
Delon Wright,PG,26,TOT,75,13,1699,242,558,.434,50,168,.298,192,390,.492,.478,119,150,.793,68,198,266,248,88,30,77,103,653,18
Delon Wright,PG,26,TOR,49,2,897,127,293,.433,30,90,.333,97,203,.478,.485,53,61,.869,39,86,125,110,46,15,37,53,337,18
Delon Wright,PG,26,MEM,26,11,802,115,265,.434,20,78,.256,95,187,.508,.472,66,89,.742,29,112,141,138,42,15,40,50,316,18
Guerschon Yabusele,PF,23,BOS,41,1,251,35,77,.455,9,28,.321,26,49,.531,.513,15,22,.682,23,30,53,15,8,7,15,32,94,18
Nick Young,SG,33,DEN,4,0,37,3,9,.333,3,8,.375,0,1,0,.500,0,0,0,0,1,1,2,0,1,2,4,9,18
Thaddeus Young,PF,30,IND,81,81,2489,443,841,.527,51,146,.349,392,695,.564,.557,87,135,.644,192,331,523,204,123,36,123,194,1024,18
Trae Young,PG,20,ATL,81,81,2503,525,1256,.418,156,482,.324,369,774,.477,.480,343,414,.829,64,237,301,653,72,15,308,140,1549,18
Cody Zeller,C,26,CHO,49,47,1243,190,345,.551,6,22,.273,184,323,.570,.559,111,141,.787,110,223,333,102,38,41,62,164,497,18
Tyler Zeller,C,29,TOT,6,1,93,16,30,.533,0,1,0,16,29,.552,.533,14,18,.778,11,13,24,4,1,3,4,20,46,18
Tyler Zeller,C,29,ATL,2,0,11,0,2,0,0,1,0,0,1,0,0,0,0,0,2,4,6,1,0,0,0,4,0,18
Tyler Zeller,C,29,MEM,4,1,82,16,28,.571,0,0,0,16,28,.571,.571,14,18,.778,9,9,18,3,1,3,4,16,46,18
Ante Žižić,C,22,CLE,59,25,1082,183,331,.553,0,0,0,183,331,.553,.553,93,132,.705,108,212,320,53,13,22,61,113,459,18
Ivica Zubac,C,21,TOT,59,37,1040,212,379,.559,0,0,0,212,379,.559,.559,101,126,.802,115,247,362,63,14,51,70,137,525,18
Ivica Zubac,C,21,LAL,33,12,516,112,193,.580,0,0,0,112,193,.580,.580,57,66,.864,54,108,162,25,4,27,33,73,281,18
Ivica Zubac,C,21,LAC,26,25,524,100,186,.538,0,0,0,100,186,.538,.538,44,60,.733,61,139,200,38,10,24,37,64,244,18
Steven Adams,C,26,OKC,63,63,1680,283,478,.592,1,3,.333,282,475,.594,.593,117,201,.582,207,376,583,146,51,67,94,122,684,19
Bam Adebayo,PF,22,MIA,72,72,2417,440,790,.557,2,14,.143,438,776,.564,.558,264,382,.691,176,559,735,368,82,93,204,182,1146,19
LaMarcus Aldridge,C,34,SAS,53,53,1754,391,793,.493,61,157,.389,330,636,.519,.532,158,191,.827,103,289,392,129,36,87,74,128,1001,19
Kyle Alexander,C,23,MIA,2,0,13,1,2,.500,0,0,0,1,2,.500,.500,0,0,0,2,1,3,0,0,0,1,1,2,19
Nickeil Alexander-Walker,SG,21,NOP,47,1,591,98,266,.368,46,133,.346,52,133,.391,.455,25,37,.676,9,75,84,89,17,8,54,57,267,19
Grayson Allen,SG,24,MEM,38,0,718,117,251,.466,57,141,.404,60,110,.545,.580,39,45,.867,8,77,85,52,10,2,33,53,330,19
Jarrett Allen,C,21,BRK,70,64,1852,302,465,.649,0,6,0,302,459,.658,.649,171,270,.633,216,455,671,110,40,92,77,162,775,19
Kadeem Allen,PG,27,NYK,10,0,117,19,44,.432,5,16,.313,14,28,.500,.489,7,11,.636,2,7,9,21,5,2,8,7,50,19
Al-Farouq Aminu,PF,29,ORL,18,2,380,25,86,.291,9,36,.250,16,50,.320,.343,19,29,.655,24,63,87,21,18,8,17,27,78,19
Justin Anderson,SG,26,BRK,10,1,107,10,38,.263,6,29,.207,4,9,.444,.342,2,4,.500,1,20,21,8,0,6,4,13,28,19
Kyle Anderson,SF,26,MEM,67,28,1330,157,331,.474,24,85,.282,133,246,.541,.511,52,78,.667,58,227,285,162,54,37,66,111,390,19
Ryan Anderson,C,31,HOU,2,0,14,2,7,.286,1,5,.200,1,2,.500,.357,0,0,0,0,7,7,2,1,0,1,1,5,19
Giannis Antetokounmpo,PF,25,MIL,63,63,1917,685,1238,.553,89,293,.304,596,945,.631,.589,398,629,.633,140,716,856,354,61,66,230,195,1857,19
Kostas Antetokounmpo,PF,22,LAL,5,0,20,3,3,1.000,0,0,0,3,3,1.000,1.000,1,2,.500,2,1,3,2,0,0,1,2,7,19
Thanasis Antetokounmpo,SF,27,MIL,20,2,129,24,48,.500,0,10,0,24,38,.632,.500,7,17,.412,12,12,24,15,7,2,12,18,55,19
Carmelo Anthony,PF,35,POR,58,58,1902,336,782,.430,87,226,.385,249,556,.448,.485,136,161,.845,71,297,368,85,49,27,100,171,895,19
OG Anunoby,SF,22,TOR,69,68,2066,286,566,.505,89,228,.390,197,338,.583,.584,72,102,.706,80,284,364,108,96,45,79,167,733,19
Ryan Arcidiacono,PG,25,CHI,58,4,930,90,220,.409,54,138,.391,36,82,.439,.532,27,38,.711,20,90,110,96,27,3,37,96,261,19
Trevor Ariza,SF,34,TOT,53,21,1493,142,324,.438,77,207,.372,65,117,.556,.557,62,74,.838,34,212,246,91,69,15,56,111,423,19
Trevor Ariza,SF,34,SAC,32,0,791,64,165,.388,43,122,.352,21,43,.488,.518,21,27,.778,21,125,146,50,35,7,28,63,192,19
Trevor Ariza,SF,34,POR,21,21,702,78,159,.491,34,85,.400,44,74,.595,.597,41,47,.872,13,87,100,41,34,8,28,48,231,19
D.J. Augustin,PG,32,ORL,57,13,1420,184,461,.399,70,201,.348,114,260,.438,.475,161,181,.890,22,100,122,262,34,1,86,72,599,19
Deandre Ayton,C,21,PHO,38,32,1236,310,568,.546,3,13,.231,307,555,.553,.548,67,89,.753,147,289,436,72,26,58,80,117,690,19
Dwayne Bacon,SG,24,CHO,39,11,687,85,244,.348,19,67,.284,66,177,.373,.387,35,53,.660,15,85,100,52,23,2,37,52,224,19
Marvin Bagley III,C,20,SAC,13,6,334,78,167,.467,4,22,.182,74,145,.510,.479,25,31,.806,29,68,97,10,6,12,18,43,185,19
Lonzo Ball,PG,22,NOP,63,54,2025,277,687,.403,148,395,.375,129,292,.442,.511,43,76,.566,71,312,383,438,88,38,193,128,745,19
Mo Bamba,C,21,ORL,62,0,878,132,286,.462,37,107,.346,95,179,.531,.526,31,46,.674,100,202,302,42,23,86,42,116,332,19
J.J. Barea,PG,35,DAL,29,6,450,85,207,.411,32,85,.376,53,122,.434,.488,20,22,.909,10,43,53,112,5,2,38,27,222,19
Harrison Barnes,PF,27,SAC,72,72,2482,365,793,.460,102,268,.381,263,525,.501,.525,214,267,.801,77,278,355,159,43,12,88,93,1046,19
RJ Barrett,SG,19,NYK,56,55,1704,292,727,.402,63,197,.320,229,530,.432,.445,156,254,.614,50,229,279,143,55,17,124,122,803,19
Will Barton,SF,29,DEN,58,58,1916,332,738,.450,108,288,.375,224,450,.498,.523,102,133,.767,76,289,365,212,61,29,88,121,874,19
Keita Bates-Diop,PF-SF,24,TOT,44,0,744,100,234,.427,34,103,.330,66,131,.504,.500,54,75,.720,25,102,127,30,19,24,17,43,288,19
Keita Bates-Diop,PF,24,MIN,37,0,646,87,206,.422,31,94,.330,56,112,.500,.498,46,65,.708,21,89,110,30,17,20,14,36,251,19
Keita Bates-Diop,SF,24,DEN,7,0,98,13,28,.464,3,9,.333,10,19,.526,.518,8,10,.800,4,13,17,0,2,4,3,7,37,19
Nicolas Batum,SF,31,CHO,22,3,505,28,81,.346,14,49,.286,14,32,.438,.432,9,10,.900,25,75,100,66,17,8,22,41,79,19
Aron Baynes,C,33,PHO,42,28,934,183,381,.480,59,168,.351,124,213,.582,.558,56,75,.747,71,166,237,67,10,23,50,141,481,19
Kent Bazemore,SF,30,TOT,68,21,1688,200,534,.375,84,244,.344,116,290,.400,.453,113,147,.769,27,267,294,93,74,40,91,196,597,19
Kent Bazemore,SF,30,POR,43,21,1111,113,326,.347,56,171,.327,57,155,.368,.433,58,72,.806,13,159,172,61,45,31,60,121,340,19
Kent Bazemore,SF,30,SAC,25,0,577,87,208,.418,28,73,.384,59,135,.437,.486,55,75,.733,14,108,122,32,29,9,31,75,257,19
Darius Bazley,PF,19,OKC,61,9,1130,125,317,.394,49,141,.348,76,176,.432,.472,43,62,.694,30,216,246,41,23,41,45,55,342,19
Bradley Beal,SG,26,WAS,57,57,2053,593,1303,.455,170,481,.353,423,822,.515,.520,385,457,.842,52,190,242,347,71,23,194,126,1741,19
Malik Beasley,SG,23,TOT,55,14,1209,227,534,.425,107,276,.388,120,258,.465,.525,54,66,.818,18,130,148,75,40,8,57,77,615,19
Malik Beasley,SG,23,DEN,41,0,746,117,301,.389,58,161,.360,59,140,.421,.485,33,38,.868,9,68,77,48,31,6,36,50,325,19
Malik Beasley,SG,23,MIN,14,14,463,110,233,.472,49,115,.426,61,118,.517,.577,21,28,.750,9,62,71,27,9,2,21,27,290,19
Marco Belinelli,SG,33,SAS,57,0,883,123,314,.392,67,178,.376,56,136,.412,.498,48,58,.828,7,92,99,69,12,1,19,45,361,19
Jordan Bell,C,25,TOT,29,0,256,35,67,.522,4,12,.333,31,55,.564,.552,19,31,.613,30,51,81,16,3,10,21,19,93,19
Jordan Bell,C,25,MIN,27,0,235,32,60,.533,2,9,.222,30,51,.588,.550,17,29,.586,28,50,78,14,2,10,18,17,83,19
Jordan Bell,C,25,MEM,2,0,21,3,7,.429,2,3,.667,1,4,.250,.571,2,2,1.000,2,1,3,2,1,0,3,2,10,19
DeAndre' Bembry,SG,25,ATL,43,4,915,104,228,.456,15,65,.231,89,163,.546,.489,26,48,.542,34,118,152,81,55,19,60,84,249,19
Dragan Bender,PF-C,22,TOT,16,3,286,41,92,.446,15,43,.349,26,49,.531,.527,10,14,.714,16,57,73,28,4,9,21,42,107,19
Dragan Bender,C,22,MIL,7,0,91,10,21,.476,4,9,.444,6,12,.500,.571,2,3,.667,0,20,20,9,0,5,5,16,26,19
Dragan Bender,PF,22,GSW,9,3,195,31,71,.437,11,34,.324,20,37,.541,.514,8,11,.727,16,37,53,19,4,4,16,26,81,19
Dāvis Bertāns,PF,27,WAS,54,4,1583,265,610,.434,200,472,.424,65,138,.471,.598,104,122,.852,35,210,245,92,37,33,59,139,834,19
Patrick Beverley,PG,31,LAC,51,50,1342,147,341,.431,80,206,.388,67,135,.496,.548,31,47,.660,57,209,266,183,54,25,66,156,405,19
Khem Birch,C,27,ORL,48,24,922,73,143,.510,0,1,0,73,142,.514,.510,66,101,.653,91,129,220,50,20,23,31,91,212,19
Goga Bitadze,C,20,IND,54,2,471,70,150,.467,8,42,.190,62,108,.574,.493,24,33,.727,25,81,106,23,10,37,28,65,172,19
Bismack Biyombo,C,27,CHO,53,29,1029,151,278,.543,0,0,0,151,278,.543,.543,91,151,.603,120,188,308,50,10,49,48,116,393,19
Nemanja Bjelica,PF,31,SAC,72,67,2011,314,653,.481,134,320,.419,180,333,.541,.583,69,84,.821,111,347,458,203,62,40,99,216,831,19
Eric Bledsoe,PG,30,MIL,61,61,1646,334,703,.475,74,215,.344,260,488,.533,.528,169,214,.790,43,239,282,328,57,26,148,128,911,19
Bogdan Bogdanović,SG,27,SAC,61,28,1766,337,766,.440,164,441,.372,173,325,.532,.547,86,116,.741,26,181,207,207,64,15,102,133,924,19
Bojan Bogdanović,SF,30,UTA,63,63,2083,418,935,.447,189,457,.414,229,478,.479,.548,250,277,.903,39,220,259,131,34,7,159,110,1275,19
Bol Bol,PF,20,DEN,7,0,87,14,28,.500,4,9,.444,10,19,.526,.571,8,10,.800,5,14,19,6,2,6,10,11,40,19
Jonah Bolden,C,24,TOT,7,0,47,4,11,.364,0,4,0,4,7,.571,.364,2,4,.500,3,6,9,0,3,2,2,10,10,19
Jonah Bolden,C,24,PHI,4,0,14,2,3,.667,0,1,0,2,2,1.000,.667,0,2,0,0,1,1,0,1,0,2,4,4,19
Jonah Bolden,C,24,PHO,3,0,33,2,8,.250,0,3,0,2,5,.400,.250,2,2,1.000,3,5,8,0,2,2,0,6,6,19
Marques Bolden,C,21,CLE,1,0,3,0,0,0,0,0,0,0,0,0,0,0,0,0,0,2,2,0,1,0,0,1,0,19
Jordan Bone,PG,22,DET,10,0,53,5,20,.250,2,10,.200,3,10,.300,.300,0,0,0,0,4,4,8,1,0,2,6,12,19
Isaac Bonga,SF,20,WAS,66,49,1250,118,234,.504,25,71,.352,93,163,.571,.558,69,85,.812,71,151,222,76,45,22,58,156,330,19
Devin Booker,SG,23,PHO,70,70,2512,627,1283,.489,141,398,.354,486,885,.549,.544,468,509,.919,29,268,297,456,49,18,264,213,1863,19
Chris Boucher,C,27,TOR,62,0,819,141,299,.472,38,118,.322,103,181,.569,.535,91,116,.784,107,170,277,26,22,61,28,114,411,19
Brian Bowen,SF,21,IND,6,1,31,3,10,.300,0,2,0,3,8,.375,.300,0,0,0,1,6,7,0,0,1,1,3,6,19
Ky Bowman,PG,22,GSW,45,12,1015,134,321,.417,33,107,.308,101,214,.472,.469,34,41,.829,24,97,121,131,44,10,70,102,335,19
Avery Bradley,SG,29,LAL,49,44,1186,170,383,.444,63,173,.364,107,210,.510,.526,20,24,.833,18,97,115,63,43,5,47,110,423,19
Tony Bradley,C,22,UTA,58,3,663,126,189,.667,3,3,1.000,123,186,.661,.675,30,46,.652,111,156,267,23,14,33,30,115,285,19
Jarrell Brantley,PF,23,UTA,9,0,96,10,28,.357,3,13,.231,7,15,.467,.411,1,2,.500,2,18,20,11,3,5,7,7,24,19
Ignas Brazdeikis,SF,21,NYK,9,0,53,6,22,.273,1,9,.111,5,13,.385,.295,4,5,.800,2,3,5,4,0,1,2,3,17,19
Corey Brewer,PF,33,SAC,5,0,33,2,4,.500,0,1,0,2,3,.667,.500,1,3,.333,2,6,8,2,4,0,2,7,5,19
Mikal Bridges,SF,23,PHO,73,32,2042,247,484,.510,70,194,.361,177,290,.610,.583,103,122,.844,66,226,292,129,102,46,73,163,667,19
Miles Bridges,SF,21,CHO,65,64,1995,319,753,.424,99,300,.330,220,453,.486,.489,106,131,.809,88,274,362,114,40,48,95,132,843,19
Oshae Brissett,SF,21,TOR,19,0,135,13,36,.361,3,15,.200,10,21,.476,.403,8,10,.800,9,17,26,7,4,1,7,18,37,19
Ryan Broekhoff,SF,29,DAL,17,1,180,22,59,.373,20,51,.392,2,8,.250,.542,7,8,.875,5,38,43,11,5,4,6,15,71,19
Malcolm Brogdon,PG,27,IND,54,54,1666,326,744,.438,75,230,.326,251,514,.488,.489,166,186,.892,46,216,262,381,35,10,131,98,893,19
Dillon Brooks,SG,24,MEM,73,73,2112,435,1068,.407,147,411,.358,288,657,.438,.476,164,203,.808,68,175,243,150,63,27,124,278,1181,19
Bruce Brown,PG,23,DET,58,43,1634,198,447,.443,33,96,.344,165,351,.470,.480,88,119,.739,61,213,274,230,63,29,100,162,517,19
Charlie Brown Jr.,SG,22,ATL,10,0,40,6,19,.316,3,9,.333,3,10,.300,.395,5,5,1.000,2,2,4,2,2,2,3,3,20,19
Jaylen Brown,SG,23,BOS,57,57,1934,427,887,.481,129,338,.382,298,549,.543,.554,176,243,.724,62,302,364,118,65,20,125,167,1159,19
Moses Brown,C,20,POR,9,0,33,4,10,.400,0,0,0,4,10,.400,.400,3,8,.375,3,11,14,1,1,1,3,7,11,19
Sterling Brown,SF,24,MIL,52,1,767,95,256,.371,44,136,.324,51,120,.425,.457,32,40,.800,31,152,183,51,29,7,42,54,266,19
Troy Brown Jr.,SF,20,WAS,69,22,1782,273,622,.439,61,179,.341,212,443,.479,.488,109,139,.784,76,307,383,178,85,7,79,132,716,19
Jalen Brunson,PG,23,DAL,57,16,1022,181,388,.466,43,120,.358,138,268,.515,.522,61,75,.813,22,112,134,188,22,4,66,74,466,19
Thomas Bryant,C,22,WAS,46,36,1147,243,418,.581,37,91,.407,206,327,.630,.626,86,116,.741,98,233,331,83,25,49,53,103,609,19
Reggie Bullock,SG,28,NYK,29,19,684,90,224,.402,37,111,.333,53,113,.469,.484,17,21,.810,13,55,68,42,25,3,19,56,234,19
Trey Burke,PG,27,TOT,33,1,520,94,209,.450,32,75,.427,62,134,.463,.526,23,29,.793,16,34,50,83,16,2,21,33,243,19
Trey Burke,PG,27,PHI,25,0,329,59,127,.465,16,38,.421,43,89,.483,.528,13,18,.722,15,20,35,53,7,1,12,21,147,19
Trey Burke,PG,27,DAL,8,1,191,35,82,.427,16,37,.432,19,45,.422,.524,10,11,.909,1,14,15,30,9,1,9,12,96,19
Alec Burks,SF-SG,28,TOT,66,19,1754,321,768,.418,116,301,.385,205,467,.439,.493,235,265,.887,48,234,282,189,62,17,91,128,993,19
Alec Burks,SF,28,GSW,48,18,1390,244,601,.406,84,224,.375,160,377,.424,.476,201,224,.897,37,189,226,151,50,17,76,107,773,19
Alec Burks,SG,28,PHI,18,1,364,77,167,.461,32,77,.416,45,90,.500,.557,34,41,.829,11,45,56,38,12,0,15,21,220,19
Deonte Burton,SF,26,OKC,39,0,356,43,125,.344,10,53,.189,33,72,.458,.384,8,14,.571,7,50,57,17,7,10,19,34,104,19
Jimmy Butler,SF,30,MIA,58,58,1959,345,758,.455,29,119,.244,316,639,.495,.474,438,525,.834,106,280,386,350,103,32,127,81,1157,19
Bruno Caboclo,C,24,TOT,30,0,244,38,89,.427,6,33,.182,32,56,.571,.461,8,9,.889,23,37,60,12,15,17,13,31,90,19
Bruno Caboclo,C,24,MEM,22,0,192,28,69,.406,4,25,.160,24,44,.545,.435,2,3,.667,17,27,44,10,10,12,7,23,62,19
Bruno Caboclo,C,24,HOU,8,0,52,10,20,.500,2,8,.250,8,12,.667,.550,6,6,1.000,6,10,16,2,5,5,6,8,28,19
Devontae Cacok,C,23,LAL,1,0,9,3,6,.500,0,0,0,3,6,.500,.500,0,0,0,2,3,5,1,0,0,0,0,6,19
Kentavious Caldwell-Pope,SG,26,LAL,69,26,1762,237,507,.467,92,239,.385,145,268,.541,.558,79,102,.775,38,104,142,111,57,14,62,128,645,19
Vlatko Čančar,PF,22,DEN,14,0,45,6,15,.400,1,6,.167,5,9,.556,.433,4,4,1.000,5,5,10,3,1,1,3,7,17,19
Clint Capela,C,25,HOU,39,39,1279,244,388,.629,0,0,0,244,388,.629,.629,55,104,.529,168,369,537,48,33,72,63,102,543,19
DeMarre Carroll,SF-C,33,TOT,24,0,290,25,66,.379,8,33,.242,17,33,.515,.439,29,42,.690,12,43,55,25,8,5,17,32,87,19
DeMarre Carroll,SF,33,SAS,15,0,135,9,29,.310,3,13,.231,6,16,.375,.362,12,20,.600,7,24,31,11,2,2,10,20,33,19
DeMarre Carroll,C,33,HOU,9,0,155,16,37,.432,5,20,.250,11,17,.647,.500,17,22,.773,5,19,24,14,6,3,7,12,54,19
Jevon Carter,PG,24,PHO,58,2,945,101,243,.416,62,146,.425,39,97,.402,.543,23,27,.852,30,88,118,84,47,17,32,86,287,19
Vince Carter,PF,43,ATL,60,0,876,107,304,.352,61,202,.302,46,102,.451,.452,23,29,.793,18,106,124,48,23,25,33,90,298,19
Wendell Carter Jr.,C,20,CHI,43,43,1256,183,343,.534,6,29,.207,177,314,.564,.542,112,152,.737,139,266,405,51,33,36,72,162,484,19
Michael Carter-Williams,SG,28,ORL,45,0,833,111,260,.427,22,75,.293,89,185,.481,.469,79,95,.832,46,101,147,109,49,22,52,87,323,19
Alex Caruso,PG,25,LAL,64,2,1175,120,291,.412,40,120,.333,80,171,.468,.481,69,94,.734,17,106,123,124,70,18,53,98,349,19
Willie Cauley-Stein,C,26,TOT,54,39,1097,175,302,.579,0,1,0,175,301,.581,.579,40,66,.606,84,231,315,70,49,61,40,121,390,19
Willie Cauley-Stein,C,26,GSW,41,37,940,144,257,.560,0,0,0,144,257,.560,.560,35,57,.614,71,184,255,60,45,50,35,102,323,19
Willie Cauley-Stein,C,26,DAL,13,2,157,31,45,.689,0,1,0,31,44,.705,.689,5,9,.556,13,47,60,10,4,11,5,19,67,19
Tyson Chandler,C,37,HOU,26,5,219,14,18,.778,0,0,0,14,18,.778,.778,6,13,.462,25,41,66,6,6,8,8,32,34,19
Wilson Chandler,PF,32,BRK,35,3,734,74,183,.404,37,121,.306,37,62,.597,.505,20,23,.870,11,134,145,39,16,12,34,79,205,19
Joe Chealey,PG,24,CHO,4,0,33,0,7,0,0,4,0,0,3,0,0,2,2,1.000,0,0,0,1,4,0,2,2,2,19
Zylan Cheatham,PF,24,NOP,4,0,51,6,9,.667,0,1,0,6,8,.750,.667,0,0,0,3,6,9,3,1,1,4,10,12,19
Chris Chiozza,PG,24,TOT,28,2,401,55,140,.393,27,72,.375,28,68,.412,.489,5,5,1.000,9,44,53,83,21,4,32,37,142,19
Chris Chiozza,PG,24,WAS,10,0,123,10,34,.294,7,16,.438,3,18,.167,.397,0,0,0,0,15,15,28,10,2,9,12,27,19
Chris Chiozza,PG,24,BRK,18,2,278,45,106,.425,20,56,.357,25,50,.500,.519,5,5,1.000,9,29,38,55,11,2,23,25,115,19
Marquese Chriss,PF,22,GSW,59,21,1196,210,385,.545,8,39,.205,202,346,.584,.556,120,156,.769,114,251,365,114,39,62,78,122,548,19
Gary Clark,SF-PF,25,TOT,42,5,567,54,133,.406,39,111,.351,15,22,.682,.553,9,10,.900,37,73,110,17,6,22,10,46,156,19
Gary Clark,PF,25,HOU,18,0,212,23,59,.390,18,51,.353,5,8,.625,.542,6,7,.857,11,29,40,12,2,7,2,21,70,19
Gary Clark,SF,25,ORL,24,5,355,31,74,.419,21,60,.350,10,14,.714,.561,3,3,1.000,26,44,70,5,4,15,8,25,86,19
Brandon Clarke,PF,23,MEM,58,4,1300,296,479,.618,23,64,.359,273,415,.658,.642,85,112,.759,92,253,345,81,32,48,55,100,700,19
Jordan Clarkson,SG,27,TOT,71,2,1705,394,867,.454,152,413,.368,242,454,.533,.542,138,165,.836,50,137,187,136,46,16,97,108,1078,19
Jordan Clarkson,SG,27,CLE,29,0,666,144,326,.442,59,159,.371,85,167,.509,.532,76,86,.884,21,48,69,70,17,8,39,33,423,19
Jordan Clarkson,SG,27,UTA,42,2,1039,250,541,.462,93,254,.366,157,287,.547,.548,62,79,.785,29,89,118,66,29,8,58,75,655,19
Nic Claxton,C,20,BRK,15,0,187,27,48,.563,1,7,.143,26,41,.634,.573,11,21,.524,19,25,44,16,1,8,9,14,66,19
Chris Clemons,SG,22,HOU,33,0,291,57,142,.401,37,107,.346,20,35,.571,.532,10,11,.909,4,26,30,27,9,6,19,26,161,19
Antonius Cleveland,SG,25,DAL,11,0,46,4,14,.286,0,3,0,4,11,.364,.286,3,5,.600,2,5,7,1,1,3,2,8,11,19
Amir Coffey,SG,22,LAC,18,1,159,23,54,.426,6,19,.316,17,35,.486,.481,6,11,.545,4,12,16,14,5,2,8,20,58,19
John Collins,PF,22,ATL,41,41,1363,353,605,.583,59,147,.401,294,458,.642,.632,120,150,.800,116,300,416,60,31,66,75,138,885,19
Zach Collins,PF,22,POR,11,11,290,32,68,.471,7,19,.368,25,49,.510,.522,6,8,.750,25,44,69,16,5,5,14,36,77,19
Mike Conley,PG,32,UTA,47,41,1363,232,567,.409,96,256,.375,136,311,.437,.494,115,139,.827,33,118,151,208,36,5,92,104,675,19
Pat Connaughton,SG,27,MIL,67,4,1243,137,301,.455,55,166,.331,82,135,.607,.547,31,40,.775,60,224,284,107,25,31,52,70,360,19
Quinn Cook,PG,26,LAL,44,1,508,91,214,.425,31,85,.365,60,129,.465,.498,11,14,.786,11,40,51,49,12,2,33,27,224,19
Tyler Cook,PF-SF,22,TOT,13,0,54,8,12,.667,0,0,0,8,12,.667,.667,7,8,.875,6,8,14,1,3,0,3,5,23,19
Tyler Cook,PF,22,CLE,11,0,35,7,10,.700,0,0,0,7,10,.700,.700,5,6,.833,4,6,10,1,1,0,1,4,19,19
Tyler Cook,SF,22,DEN,2,0,19,1,2,.500,0,0,0,1,2,.500,.500,2,2,1.000,2,2,4,0,2,0,2,1,4,19
Robert Covington,PF-C,29,TOT,70,68,2137,305,723,.422,161,480,.335,144,243,.593,.533,99,124,.798,63,400,463,88,115,93,103,220,870,19
Robert Covington,PF,29,MIN,48,47,1411,216,496,.435,108,312,.346,108,184,.587,.544,75,94,.798,36,251,287,56,80,45,73,148,615,19
Robert Covington,C,29,HOU,22,21,726,89,227,.392,53,168,.315,36,59,.610,.509,24,30,.800,27,149,176,32,35,48,30,72,255,19
Allen Crabbe,SG-SF,27,TOT,37,1,653,63,177,.356,36,119,.303,27,58,.466,.458,10,14,.714,11,66,77,33,15,4,17,47,172,19
Allen Crabbe,SG,27,ATL,28,1,522,52,143,.364,30,93,.323,22,50,.440,.469,9,12,.750,10,55,65,28,15,4,12,36,143,19
Allen Crabbe,SF,27,MIN,9,0,131,11,34,.324,6,26,.231,5,8,.625,.412,1,2,.500,1,11,12,5,0,0,5,11,29,19
Torrey Craig,SF,29,DEN,58,27,1072,124,269,.461,45,138,.326,79,131,.603,.545,22,36,.611,63,126,189,47,23,36,25,135,315,19
Jamal Crawford,SG,39,BRK,1,0,6,2,4,.500,1,2,.500,1,2,.500,.625,0,0,0,0,0,0,3,0,0,0,1,5,19
Jae Crowder,SF-PF,29,TOT,65,53,1875,226,563,.401,135,394,.343,91,169,.538,.521,97,125,.776,52,332,384,161,72,24,69,143,684,19
Jae Crowder,SF,29,MEM,45,45,1322,147,399,.368,78,266,.293,69,133,.519,.466,75,95,.789,40,237,277,125,47,14,54,85,447,19
Jae Crowder,PF,29,MIA,20,8,553,79,164,.482,57,128,.445,22,36,.611,.655,22,30,.733,12,95,107,36,25,10,15,58,237,19
Jarrett Culver,SG,20,MIN,63,35,1506,230,569,.404,66,221,.299,164,348,.471,.462,54,117,.462,70,142,212,110,57,38,81,125,580,19
Seth Curry,SG,29,DAL,64,25,1576,284,574,.495,145,321,.452,139,253,.549,.621,80,97,.825,27,118,145,124,38,9,62,113,793,19
Stephen Curry,PG,31,GSW,5,5,139,33,82,.402,12,49,.245,21,33,.636,.476,26,26,1.000,4,22,26,33,5,2,16,11,104,19
Troy Daniels,SG,28,TOT,47,0,532,72,186,.387,46,132,.348,26,54,.481,.511,10,16,.625,12,40,52,17,11,3,12,37,200,19
Troy Daniels,SG,28,LAL,41,0,456,62,158,.392,40,112,.357,22,46,.478,.519,10,16,.625,12,34,46,14,8,3,9,30,174,19
Troy Daniels,SG,28,DEN,6,0,76,10,28,.357,6,20,.300,4,8,.500,.464,0,0,0,0,6,6,3,3,0,3,7,26,19
Anthony Davis,PF,26,LAL,62,62,2131,551,1096,.503,72,218,.330,479,878,.546,.536,444,525,.846,142,435,577,200,91,143,154,156,1618,19
Ed Davis,C,30,UTA,28,1,303,22,46,.478,0,0,0,22,46,.478,.478,7,14,.500,35,70,105,12,11,9,13,61,51,19
Terence Davis,SG,22,TOR,72,4,1209,199,436,.456,94,242,.388,105,194,.541,.564,51,59,.864,50,187,237,115,39,14,76,124,543,19
Dewayne Dedmon,C,30,TOT,44,18,774,102,255,.400,22,107,.206,80,148,.541,.443,30,36,.833,60,189,249,22,25,41,57,133,256,19
Dewayne Dedmon,C,30,SAC,34,10,541,69,171,.404,14,71,.197,55,100,.550,.444,23,28,.821,46,121,167,15,15,26,47,93,175,19
Dewayne Dedmon,C,30,ATL,10,8,233,33,84,.393,8,36,.222,25,48,.521,.440,7,8,.875,14,68,82,7,10,15,10,40,81,19
Matthew Dellavedova,PG,29,CLE,57,4,821,62,175,.354,21,91,.231,41,84,.488,.414,32,37,.865,18,57,75,180,20,2,59,78,177,19
DeMar DeRozan,SF,30,SAS,68,68,2316,557,1049,.531,9,35,.257,548,1014,.540,.535,381,451,.845,44,331,375,380,70,20,164,180,1504,19
Cheick Diallo,C,23,PHO,47,2,479,92,142,.648,1,3,.333,91,139,.655,.651,34,39,.872,30,101,131,22,11,12,32,55,219,19
Hamidou Diallo,SF,21,OKC,46,3,896,132,296,.446,16,57,.281,116,239,.485,.473,38,63,.603,44,123,167,36,37,9,51,101,318,19
Gorgui Dieng,C,30,TOT,63,17,1096,166,364,.456,54,152,.355,112,212,.528,.530,78,101,.772,91,263,354,73,51,59,60,124,464,19
Gorgui Dieng,C,30,MIN,46,17,778,124,277,.448,46,120,.383,78,157,.497,.531,47,59,.797,73,183,256,58,37,42,44,89,341,19
Gorgui Dieng,C,30,MEM,17,0,318,42,87,.483,8,32,.250,34,55,.618,.529,31,42,.738,18,80,98,15,14,17,16,35,123,19
Spencer Dinwiddie,PG,26,BRK,64,49,1994,424,1021,.415,123,400,.308,301,621,.485,.476,347,446,.778,32,189,221,432,40,21,174,180,1318,19
Donte DiVincenzo,SG,23,MIL,66,24,1520,232,510,.455,83,247,.336,149,263,.567,.536,63,86,.733,66,252,318,154,85,20,90,113,610,19
Luka Dončić,PG,20,DAL,61,61,2047,581,1255,.463,171,541,.316,410,714,.574,.531,426,562,.758,78,495,573,538,62,14,260,153,1759,19
Luguentz Dort,SF,20,OKC,36,28,820,86,218,.394,30,101,.297,56,117,.479,.463,42,53,.792,24,57,81,27,31,4,22,97,244,19
Damyean Dotson,SG,25,NYK,48,0,836,120,290,.414,59,163,.362,61,127,.480,.516,22,33,.667,10,81,91,57,23,4,21,44,321,19
Sekou Doumbouya,PF,19,DET,38,19,754,92,236,.390,28,98,.286,64,138,.464,.449,31,46,.674,20,98,118,19,20,8,35,80,243,19
PJ Dozier,SG,23,DEN,29,0,412,65,157,.414,17,49,.347,48,108,.444,.468,21,29,.724,10,45,55,63,14,6,27,45,168,19
Goran Dragić,PG,33,MIA,59,3,1663,319,724,.441,124,338,.367,195,386,.505,.526,191,246,.776,29,158,187,301,40,10,144,124,953,19
Andre Drummond,C,26,TOT,57,56,1879,418,784,.533,5,35,.143,413,749,.551,.536,169,294,.575,250,614,864,152,109,93,203,201,1010,19
Andre Drummond,C,26,DET,49,48,1654,360,679,.530,1,21,.048,359,658,.546,.531,149,255,.584,226,549,775,138,97,82,174,176,870,19
Andre Drummond,C,26,CLE,8,8,225,58,105,.552,4,14,.286,54,91,.593,.571,20,39,.513,24,65,89,14,12,11,29,25,140,19
Jared Dudley,PF,34,LAL,45,1,364,24,60,.400,18,42,.429,6,18,.333,.550,2,2,1.000,6,46,52,28,15,3,8,41,68,19
Kris Dunn,PG,25,CHI,51,32,1269,152,342,.444,29,112,.259,123,230,.535,.487,40,54,.741,23,163,186,173,101,17,68,158,373,19
Carsen Edwards,SG,21,BOS,37,0,351,42,128,.328,24,76,.316,18,52,.346,.422,13,19,.684,6,41,47,24,12,4,15,34,121,19
Henry Ellenson,C,23,BRK,5,0,15,1,7,.143,0,4,0,1,3,.333,.143,0,0,0,2,4,6,1,0,0,0,1,2,19
Wayne Ellington,SG,32,NYK,36,1,558,61,174,.351,50,143,.350,11,31,.355,.494,11,13,.846,4,61,65,44,13,4,18,41,183,19
Joel Embiid,C,25,PHI,51,51,1506,382,801,.477,57,172,.331,325,629,.517,.512,351,435,.807,141,452,593,152,45,65,159,174,1172,19
James Ennis III,SF-SG,29,TOT,69,18,1265,160,359,.446,55,169,.325,105,190,.553,.522,79,98,.806,71,174,245,63,35,22,58,137,454,19
James Ennis III,SF,29,PHI,49,0,776,100,226,.442,37,106,.349,63,120,.525,.524,48,61,.787,48,102,150,41,23,14,31,85,285,19
James Ennis III,SG,29,ORL,20,18,489,60,133,.451,18,63,.286,42,70,.600,.519,31,37,.838,23,72,95,22,12,8,27,52,169,19
Drew Eubanks,C,22,SAS,22,3,272,43,67,.642,1,1,1.000,42,66,.636,.649,20,26,.769,28,57,85,15,5,17,21,37,107,19
Jacob Evans,SG,22,TOT,29,1,418,45,134,.336,13,39,.333,32,95,.337,.384,25,29,.862,9,32,41,31,11,12,25,41,128,19
Jacob Evans,SG,22,GSW,27,1,414,45,133,.338,13,38,.342,32,95,.337,.387,25,29,.862,9,32,41,31,11,12,25,41,128,19
Jacob Evans,SG,22,MIN,2,0,4,0,1,0,0,1,0,0,0,0,0,0,0,0,0,0,0,0,0,0,0,0,0,19
Dante Exum,SG,24,TOT,35,1,485,56,119,.471,15,43,.349,41,76,.539,.534,32,43,.744,12,55,67,40,13,8,31,38,159,19
Dante Exum,SG,24,UTA,11,0,83,10,23,.435,2,6,.333,8,17,.471,.478,2,2,1.000,3,9,12,7,1,2,10,8,24,19
Dante Exum,SG,24,CLE,24,1,402,46,96,.479,13,37,.351,33,59,.559,.547,30,41,.732,9,46,55,33,12,6,21,30,135,19
Tacko Fall,C,24,BOS,7,0,33,11,14,.786,0,0,0,11,14,.786,.786,1,3,.333,1,14,15,1,1,4,3,7,23,19
Derrick Favors,C,28,NOP,51,49,1243,209,339,.617,1,7,.143,208,332,.627,.618,40,71,.563,163,338,501,81,30,46,55,107,459,19
Cristiano Felício,C,27,CHI,22,0,386,34,54,.630,0,2,0,34,52,.654,.630,18,23,.783,55,47,102,16,10,2,18,34,86,19
Terrance Ferguson,SF,21,OKC,56,38,1257,78,220,.355,49,168,.292,29,52,.558,.466,15,20,.750,23,51,74,51,27,17,31,155,220,19
Bruno Fernando,C,21,ATL,56,13,713,103,199,.518,5,37,.135,98,162,.605,.530,29,51,.569,67,131,198,49,18,17,42,107,240,19
Yogi Ferrell,PG,26,SAC,50,0,530,79,188,.420,24,79,.304,55,109,.505,.484,36,42,.857,6,43,49,69,18,4,28,38,218,19
Dorian Finney-Smith,PF,26,DAL,71,68,2120,243,522,.466,114,303,.376,129,219,.589,.575,78,108,.722,145,260,405,114,45,39,69,178,678,19
Bryn Forbes,SG,26,SAS,63,62,1579,242,581,.417,148,381,.388,94,200,.470,.544,75,90,.833,12,114,126,108,33,0,57,113,707,19
Evan Fournier,SF,27,ORL,66,66,2076,434,929,.467,173,434,.399,261,495,.527,.560,180,220,.818,18,153,171,209,71,15,125,161,1221,19
De'Aaron Fox,PG,22,SAC,51,49,1634,391,815,.480,54,185,.292,337,630,.535,.513,241,342,.705,35,161,196,348,74,25,158,145,1077,19
Melvin Frazier,SG,23,ORL,19,0,126,15,34,.441,8,16,.500,7,18,.389,.559,2,4,.500,2,8,10,3,9,2,5,11,40,19
Michael Frazier,SG,25,HOU,13,0,145,7,29,.241,4,23,.174,3,6,.500,.310,9,14,.643,1,9,10,2,2,0,5,22,27,19
Tim Frazier,PG,29,DET,27,11,355,34,94,.362,10,30,.333,24,64,.375,.415,19,24,.792,9,24,33,93,14,4,36,42,97,19
Enes Freedom,C,27,BOS,58,7,983,199,348,.572,1,7,.143,198,341,.581,.573,70,99,.707,163,268,431,56,22,41,56,100,469,19
Markelle Fultz,PG,21,ORL,72,60,1996,359,772,.465,36,135,.267,323,637,.507,.488,116,159,.730,41,197,238,369,90,11,147,142,870,19
Wenyen Gabriel,PF,22,TOT,30,1,235,21,48,.438,6,20,.300,15,28,.536,.500,15,22,.682,21,31,52,8,11,7,16,39,63,19
Wenyen Gabriel,PF,22,SAC,11,0,61,6,17,.353,1,8,.125,5,9,.556,.382,6,10,.600,4,6,10,3,3,2,5,7,19,19
Wenyen Gabriel,PF,22,POR,19,1,174,15,31,.484,5,12,.417,10,19,.526,.565,9,12,.750,17,25,42,5,8,5,11,32,44,19
Daniel Gafford,C,21,CHI,43,7,609,94,134,.701,0,0,0,94,134,.701,.701,32,60,.533,52,54,106,21,13,56,29,98,220,19
Danilo Gallinari,PF,31,OKC,62,62,1834,358,817,.438,178,439,.405,180,378,.476,.547,266,298,.893,34,288,322,119,42,5,76,75,1160,19
Langston Galloway,SG,28,DET,66,6,1702,236,542,.435,132,331,.399,104,211,.493,.557,73,85,.859,33,116,149,101,48,11,40,96,677,19
Darius Garland,SG,20,CLE,59,59,1824,280,699,.401,105,296,.355,175,403,.434,.476,63,72,.875,27,84,111,229,42,4,151,92,728,19
Marc Gasol,C,35,TOR,44,43,1161,119,279,.427,57,148,.385,62,131,.473,.529,36,49,.735,31,244,275,147,34,38,59,124,331,19
Rudy Gay,PF,33,SAS,67,5,1461,266,596,.446,74,220,.336,192,376,.511,.508,120,136,.882,61,301,362,114,35,33,88,103,726,19
Paul George,SF,29,LAC,48,48,1419,343,782,.439,157,381,.412,186,401,.464,.539,190,217,.876,24,248,272,185,68,20,125,113,1033,19
Taj Gibson,C,34,NYK,62,56,1025,167,286,.584,4,14,.286,163,272,.599,.591,41,56,.732,111,156,267,52,27,30,47,122,379,19
Harry Giles,C,21,SAC,46,17,667,139,251,.554,0,2,0,139,249,.558,.554,38,49,.776,43,145,188,60,22,18,44,119,316,19
Shai Gilgeous-Alexander,SG,21,OKC,70,70,2428,478,1015,.471,87,251,.347,391,764,.512,.514,288,357,.807,47,365,412,232,79,47,134,117,1331,19
Rudy Gobert,C,27,UTA,68,68,2333,386,557,.693,0,0,0,386,557,.693,.693,254,403,.630,230,686,916,101,51,135,130,215,1026,19
Brandon Goodwin,PG,24,ATL,34,1,430,76,190,.400,26,87,.299,50,103,.485,.468,28,30,.933,11,61,72,51,12,4,29,43,206,19
Aaron Gordon,PF,24,ORL,62,62,2017,335,767,.437,73,237,.308,262,530,.494,.484,151,224,.674,107,368,475,228,51,39,100,125,894,19
Eric Gordon,SF,31,HOU,36,15,1016,171,463,.369,96,303,.317,75,160,.469,.473,82,107,.766,9,62,71,54,23,13,43,70,520,19
Devonte' Graham,PG,24,CHO,63,53,2211,368,963,.382,218,585,.373,150,378,.397,.495,191,233,.820,42,170,212,471,62,15,181,115,1145,19
Treveon Graham,SF,26,TOT,55,20,929,87,242,.360,33,120,.275,54,122,.443,.428,36,56,.643,51,99,150,45,24,6,29,102,243,19
Treveon Graham,SF,26,MIN,33,20,663,62,175,.354,20,83,.241,42,92,.457,.411,27,37,.730,29,71,100,30,17,2,19,66,171,19
Treveon Graham,SF,26,ATL,22,0,266,25,67,.373,13,37,.351,12,30,.400,.470,9,19,.474,22,28,50,15,7,4,10,36,72,19
Jerami Grant,PF,25,DEN,71,24,1892,303,634,.478,98,252,.389,205,382,.537,.555,147,196,.750,58,190,248,88,50,57,63,154,851,19
Jerian Grant,SG,27,WAS,6,0,80,10,27,.370,2,8,.250,8,19,.421,.407,5,7,.714,2,4,6,9,1,1,3,11,27,19
Josh Gray,PG,26,NOP,2,0,23,1,2,.500,0,0,0,1,2,.500,.500,0,0,0,1,1,2,2,0,0,5,1,2,19
Danny Green,SG,32,LAL,68,68,1687,197,474,.416,120,327,.367,77,147,.524,.542,33,48,.688,51,174,225,91,85,32,63,136,547,19
Draymond Green,PF,29,GSW,43,43,1222,123,316,.389,36,129,.279,87,187,.465,.446,63,83,.759,23,243,266,266,59,33,98,110,345,19
JaMychal Green,PF,29,LAC,63,1,1307,151,352,.429,92,238,.387,59,114,.518,.560,36,48,.750,77,311,388,49,29,24,54,174,430,19
Javonte Green,SG,26,BOS,48,2,468,63,126,.500,9,33,.273,54,93,.581,.536,28,42,.667,24,69,93,26,24,8,23,43,163,19
Jeff Green,PF-C,33,TOT,48,4,960,159,344,.462,62,183,.339,97,161,.602,.552,73,91,.802,24,109,133,50,26,19,42,89,453,19
Jeff Green,PF,33,UTA,30,2,553,75,195,.385,34,104,.327,41,91,.451,.472,49,63,.778,14,67,81,20,12,10,27,46,233,19
Jeff Green,C,33,HOU,18,2,407,84,149,.564,28,79,.354,56,70,.800,.658,24,28,.857,10,42,52,30,14,9,15,43,220,19
Blake Griffin,PF,30,DET,18,18,512,88,250,.352,27,111,.243,61,139,.439,.406,76,98,.776,17,67,84,59,7,7,40,27,279,19
Marko Guduric,SG,24,MEM,44,0,484,62,157,.395,25,83,.301,37,74,.500,.475,24,26,.923,14,59,73,45,12,8,36,34,173,19
Kyle Guy,SG,22,SAC,3,0,10,2,5,.400,0,3,0,2,2,1.000,.400,0,0,0,0,1,1,1,0,0,0,1,4,19
Rui Hachimura,PF,21,WAS,48,48,1444,254,545,.466,25,87,.287,229,458,.500,.489,116,140,.829,78,216,294,87,37,8,53,105,649,19
Devon Hall,PG,24,OKC,11,0,81,6,30,.200,4,17,.235,2,13,.154,.267,4,8,.500,2,5,7,13,4,1,5,6,20,19
Donta Hall,C-PF,22,TOT,9,0,133,15,22,.682,0,0,0,15,22,.682,.682,9,18,.500,14,24,38,4,3,6,5,23,39,19
Donta Hall,PF,22,DET,4,0,48,1,4,.250,0,0,0,1,4,.250,.250,4,6,.667,6,9,15,2,1,1,2,9,6,19
Donta Hall,C,22,BRK,5,0,85,14,18,.778,0,0,0,14,18,.778,.778,5,12,.417,8,15,23,2,2,5,3,14,33,19
Dusty Hannahs,SG,26,MEM,2,0,13,4,9,.444,2,3,.667,2,6,.333,.556,2,2,1.000,0,1,1,0,0,0,0,1,12,19
Tim Hardaway Jr.,SG,27,DAL,71,58,2091,384,884,.434,204,513,.398,180,371,.485,.550,149,182,.819,25,207,232,137,41,5,69,125,1121,19
James Harden,SG,30,HOU,68,68,2483,672,1514,.444,299,843,.355,373,671,.556,.543,692,800,.865,70,376,446,512,125,60,308,227,2335,19
Maurice Harkless,PF-SF,26,TOT,62,48,1427,142,283,.502,34,98,.347,108,185,.584,.562,39,66,.591,55,185,240,68,58,33,53,148,357,19
Maurice Harkless,PF,26,LAC,50,38,1141,112,217,.516,27,73,.370,85,144,.590,.578,24,42,.571,47,153,200,48,49,30,46,120,275,19
Maurice Harkless,SF,26,NYK,12,10,286,30,66,.455,7,25,.280,23,41,.561,.508,15,24,.625,8,32,40,20,9,3,7,28,82,19
Jared Harper,PG,22,PHO,3,0,8,1,4,.250,0,2,0,1,2,.500,.250,0,0,0,0,0,0,0,0,0,0,0,2,19
Montrezl Harrell,C,26,LAC,63,2,1749,471,812,.580,0,18,0,471,794,.593,.580,231,351,.658,163,282,445,107,39,72,108,146,1173,19
Gary Harris,SG,25,DEN,56,55,1780,218,519,.420,70,210,.333,148,309,.479,.487,75,92,.815,26,137,163,118,76,14,60,116,581,19
Joe Harris,SF,28,BRK,69,69,2123,381,784,.486,172,406,.424,209,378,.553,.596,64,89,.719,64,234,298,144,41,17,104,159,998,19
Tobias Harris,PF,27,PHI,72,72,2469,553,1173,.471,131,357,.367,422,816,.517,.527,174,216,.806,69,426,495,227,53,40,104,165,1411,19
Shaquille Harrison,SG,26,CHI,43,10,484,77,165,.467,16,42,.381,61,123,.496,.515,39,50,.780,22,64,86,49,34,19,19,55,209,19
Josh Hart,SF,24,NOP,65,16,1755,225,532,.423,121,354,.342,104,178,.584,.537,85,115,.739,61,364,425,108,63,23,75,160,656,19
Isaiah Hartenstein,C,21,HOU,23,2,266,44,67,.657,0,5,0,44,62,.710,.657,19,28,.679,29,61,90,18,9,12,16,41,107,19
Udonis Haslem,C,39,MIA,4,1,44,4,11,.364,1,3,.333,3,8,.375,.409,3,4,.750,1,15,16,1,0,0,1,6,12,19
Jaxson Hayes,C,19,NOP,64,14,1080,174,259,.672,1,4,.250,173,255,.678,.674,123,190,.647,97,162,259,56,26,55,53,161,472,19
Gordon Hayward,SF,29,BOS,52,52,1740,350,700,.500,85,222,.383,265,478,.554,.561,124,145,.855,55,293,348,212,38,22,96,96,909,19
John Henson,C,29,TOT,40,8,600,95,171,.556,8,36,.222,87,135,.644,.579,23,46,.500,46,116,162,54,24,42,36,78,221,19
John Henson,C,29,CLE,29,2,412,61,120,.508,6,31,.194,55,89,.618,.533,17,33,.515,32,82,114,43,16,32,21,55,145,19
John Henson,C,29,DET,11,6,188,34,51,.667,2,5,.400,32,46,.696,.686,6,13,.462,14,34,48,11,8,10,15,23,76,19
Dewan Hernandez,C,23,TOR,6,0,28,5,14,.357,1,2,.500,4,12,.333,.393,3,5,.600,5,9,14,3,1,0,3,6,14,19
Juancho Hernangómez,PF,24,TOT,48,14,833,100,247,.405,44,129,.341,56,118,.475,.494,44,71,.620,43,154,197,40,19,9,32,64,288,19
Juancho Hernangómez,PF,24,DEN,34,0,422,38,110,.345,15,60,.250,23,50,.460,.414,16,25,.640,24,71,95,22,5,5,18,29,107,19
Juancho Hernangómez,PF,24,MIN,14,14,411,62,137,.453,29,69,.420,33,68,.485,.558,28,46,.609,19,83,102,18,14,4,14,35,181,19
Willy Hernangómez,C,25,CHO,31,0,375,74,139,.532,5,22,.227,69,117,.590,.550,37,59,.627,43,91,134,29,10,7,30,32,190,19
Tyler Herro,SG,20,MIA,55,8,1508,270,631,.428,116,298,.389,154,333,.462,.520,87,100,.870,16,208,224,121,34,9,87,76,743,19
Kevin Hervey,PF,23,OKC,10,0,52,7,27,.259,3,20,.150,4,7,.571,.315,0,0,0,1,11,12,5,1,1,0,4,17,19
Mario Hezonja,PF,24,POR,53,4,871,92,218,.422,24,78,.308,68,140,.486,.477,48,59,.814,30,154,184,50,36,9,42,107,256,19
Buddy Hield,SG,27,SAC,72,44,2216,498,1162,.429,271,688,.394,227,474,.479,.545,115,136,.846,57,271,328,213,66,17,168,165,1382,19
George Hill,PG,33,MIL,59,2,1271,194,376,.516,81,176,.460,113,200,.565,.624,85,101,.842,50,127,177,180,47,5,57,84,554,19
Solomon Hill,PF,28,TOT,59,4,1088,110,278,.396,63,171,.368,47,107,.439,.509,40,54,.741,29,136,165,104,43,12,51,85,323,19
Solomon Hill,PF,28,MEM,48,3,901,96,233,.412,56,147,.381,40,86,.465,.532,26,38,.684,24,120,144,94,31,7,40,73,274,19
Solomon Hill,PF,28,MIA,11,1,187,14,45,.311,7,24,.292,7,21,.333,.389,14,16,.875,5,16,21,10,12,5,11,12,49,19
Jaylen Hoard,PF,20,POR,13,0,103,15,32,.469,0,3,0,15,29,.517,.469,8,13,.615,14,18,32,4,5,0,4,12,38,19
Aaron Holiday,PG,23,IND,66,33,1617,233,563,.414,87,221,.394,146,342,.427,.491,74,87,.851,22,134,156,225,55,16,88,120,627,19
Jrue Holiday,SG,29,NOP,61,61,2117,458,1006,.455,122,346,.353,336,660,.509,.516,129,182,.709,77,216,293,408,99,48,184,145,1167,19
Justin Holiday,SF,30,IND,73,6,1826,208,486,.428,134,331,.405,74,155,.477,.566,53,67,.791,32,206,238,93,87,46,44,137,603,19
Rondae Hollis-Jefferson,PF,25,TOR,60,6,1122,155,329,.471,3,23,.130,152,306,.497,.476,105,143,.734,110,173,283,106,46,23,59,115,418,19
Richaun Holmes,C,26,SAC,44,38,1242,223,344,.648,0,0,0,223,344,.648,.648,93,118,.788,127,231,358,42,41,56,52,169,539,19
Rodney Hood,SF,27,POR,21,21,619,87,172,.506,35,71,.493,52,101,.515,.608,21,27,.778,10,62,72,32,17,4,19,46,230,19
Al Horford,C,33,PHI,67,61,2025,319,709,.450,99,283,.350,220,426,.516,.520,61,80,.763,103,353,456,270,52,61,80,142,798,19
Talen Horton-Tucker,SG,19,LAL,6,1,81,14,30,.467,4,13,.308,10,17,.588,.533,2,4,.500,2,5,7,6,8,1,6,10,34,19
Danuel House Jr.,SF,26,HOU,63,52,1913,230,539,.427,129,355,.363,101,184,.549,.546,73,90,.811,57,210,267,85,67,34,54,132,662,19
Dwight Howard,C,34,LAL,69,2,1306,202,277,.729,3,5,.600,199,272,.732,.735,110,214,.514,172,335,507,45,31,79,84,222,517,19
William Howard,PF,26,HOU,2,0,13,0,4,0,0,4,0,0,0,0,0,0,0,0,0,2,2,1,0,0,1,1,0,19
Kevin Huerter,SG,21,ATL,56,48,1760,252,610,.413,127,334,.380,125,276,.453,.517,53,64,.828,35,193,228,213,51,27,87,139,684,19
De'Andre Hunter,SF,22,ATL,63,62,2018,280,683,.410,108,304,.355,172,379,.454,.489,110,144,.764,44,242,286,112,44,18,103,182,778,19
Chandler Hutchison,SF,23,CHI,28,10,527,80,175,.457,12,38,.316,68,137,.496,.491,46,78,.590,18,90,108,26,27,7,27,47,218,19
Serge Ibaka,C,30,TOR,55,27,1485,343,670,.512,70,182,.385,273,488,.559,.564,89,124,.718,114,338,452,77,28,46,109,153,845,19
Andre Iguodala,SF,36,MIA,21,0,418,38,88,.432,14,47,.298,24,41,.585,.511,6,15,.400,17,61,78,51,14,21,26,35,96,19
Ersan İlyasova,PF,32,MIL,63,8,986,146,313,.466,50,137,.365,96,176,.545,.546,72,87,.828,62,240,302,49,24,17,34,95,414,19
Joe Ingles,PF,32,UTA,72,45,2137,246,553,.445,141,353,.399,105,200,.525,.572,74,94,.787,27,251,278,373,65,11,142,154,707,19
Brandon Ingram,PF,22,NOP,62,62,2104,507,1096,.463,150,384,.391,357,712,.501,.531,313,368,.851,51,329,380,259,61,38,189,179,1477,19
Kyrie Irving,PG,27,BRK,20,20,658,199,416,.478,56,142,.394,143,274,.522,.546,94,102,.922,22,81,103,128,27,10,52,53,548,19
Jonathan Isaac,PF,22,ORL,34,32,980,156,332,.470,32,94,.340,124,238,.521,.518,60,77,.779,58,173,231,48,53,78,49,83,404,19
Wes Iwundu,SF,25,ORL,52,21,953,97,233,.416,28,82,.341,69,151,.457,.476,78,97,.804,24,107,131,60,25,13,26,80,300,19
Frank Jackson,PG,21,NOP,59,2,797,134,331,.405,47,144,.326,87,187,.465,.476,56,75,.747,22,61,83,61,17,4,49,77,371,19
Jaren Jackson Jr.,C,20,MEM,57,57,1622,353,753,.469,145,368,.394,208,385,.540,.565,139,186,.747,55,207,262,78,40,92,99,232,990,19
Josh Jackson,SF,22,MEM,22,0,381,70,159,.440,23,72,.319,47,87,.540,.513,35,50,.700,11,55,66,35,18,9,28,40,198,19
Justin Jackson,PF,24,DAL,65,3,1045,135,341,.396,48,163,.294,87,178,.489,.466,42,50,.840,27,127,154,52,15,10,14,69,360,19
Reggie Jackson,SG-PG,29,TOT,31,16,743,134,326,.411,57,145,.393,77,181,.425,.498,45,54,.833,17,75,92,126,13,5,51,59,370,19
Reggie Jackson,PG,29,DET,14,10,381,76,198,.384,31,82,.378,45,116,.388,.462,26,33,.788,11,30,41,72,8,1,23,21,209,19
Reggie Jackson,SG,29,LAC,17,6,362,58,128,.453,26,63,.413,32,65,.492,.555,19,21,.905,6,45,51,54,5,4,28,38,161,19
Justin James,SF,23,SAC,36,0,232,35,84,.417,9,29,.310,26,55,.473,.470,10,21,.476,6,26,32,18,6,9,8,17,89,19
LeBron James,PG,35,LAL,67,67,2316,643,1303,.493,148,425,.348,495,878,.564,.550,264,381,.693,66,459,525,684,78,36,261,118,1698,19
Amile Jefferson,PF,26,ORL,18,0,74,5,14,.357,0,0,0,5,14,.357,.357,5,14,.357,10,13,23,4,1,3,3,7,15,19
DaQuan Jeffries,SG,22,SAC,13,0,141,20,40,.500,5,18,.278,15,22,.682,.563,5,6,.833,3,15,18,7,4,1,2,19,50,19
Ty Jerome,SG,22,PHO,31,0,328,38,113,.336,14,50,.280,24,63,.381,.398,12,16,.750,7,39,46,44,15,3,18,29,102,19
Alize Johnson,PF,23,IND,17,1,118,12,29,.414,3,8,.375,9,21,.429,.466,7,10,.700,16,32,48,7,3,2,7,12,34,19
B.J. Johnson,SF,24,ORL,10,0,83,9,32,.281,3,9,.333,6,23,.261,.328,9,10,.900,3,12,15,3,3,0,6,3,30,19
Cameron Johnson,PF,23,PHO,57,9,1255,176,405,.435,106,272,.390,70,133,.526,.565,46,57,.807,49,138,187,69,36,20,32,88,504,19
James Johnson,PF-C,32,TOT,32,1,619,103,215,.479,33,91,.363,70,124,.565,.556,31,48,.646,25,93,118,74,25,32,48,80,270,19
James Johnson,PF,32,MIA,18,0,281,39,87,.448,16,45,.356,23,42,.548,.540,8,14,.571,8,44,52,21,6,13,15,34,102,19
James Johnson,C,32,MIN,14,1,338,64,128,.500,17,46,.370,47,82,.573,.566,23,34,.676,17,49,66,53,19,19,33,46,168,19
Keldon Johnson,SF,20,SAS,17,1,301,53,89,.596,13,22,.591,40,67,.597,.669,35,44,.795,10,47,57,15,14,2,13,28,154,19
Stanley Johnson,PF,23,TOR,25,0,150,22,59,.373,7,24,.292,15,35,.429,.432,9,16,.563,7,30,37,20,6,4,15,16,60,19
Tyler Johnson,PG-SG,27,TOT,39,7,709,97,250,.388,38,119,.319,59,131,.450,.464,42,50,.840,18,58,76,74,16,9,29,58,274,19
Tyler Johnson,PG,27,PHO,31,3,515,65,171,.380,24,83,.289,41,88,.466,.450,24,32,.750,10,42,52,50,12,8,24,43,178,19
Tyler Johnson,SG,27,BRK,8,4,194,32,79,.405,14,36,.389,18,43,.419,.494,18,18,1.000,8,16,24,24,4,1,5,15,96,19
Nikola Jokić,C,24,DEN,73,73,2336,565,1071,.528,80,255,.314,485,816,.594,.565,246,301,.817,166,545,711,512,85,44,226,222,1456,19
Damian Jones,C,24,ATL,55,27,887,121,178,.680,2,9,.222,119,169,.704,.685,62,84,.738,74,132,206,35,26,40,28,149,306,19
Derrick Jones Jr.,SF,22,MIA,59,16,1375,184,349,.527,37,132,.280,147,217,.677,.580,95,123,.772,66,167,233,62,58,38,30,130,500,19
Tyus Jones,PG,23,MEM,65,6,1232,197,429,.459,47,124,.379,150,305,.492,.514,43,58,.741,9,94,103,285,59,6,55,44,484,19
DeAndre Jordan,C,31,BRK,56,6,1234,191,287,.666,0,0,0,191,287,.666,.666,83,122,.680,141,420,561,105,18,52,74,114,465,19
Cory Joseph,PG,28,SAC,72,26,1759,171,412,.415,56,159,.352,115,253,.455,.483,60,70,.857,44,144,188,251,53,21,80,133,458,19
Mfiondu Kabengele,C,22,LAC,12,0,64,14,32,.438,9,20,.450,5,12,.417,.578,5,5,1.000,1,10,11,2,2,2,2,9,42,19
Frank Kaminsky,C,26,PHO,39,13,777,138,307,.450,41,124,.331,97,183,.530,.516,61,90,.678,35,141,176,75,14,10,37,75,378,19
Luke Kennard,SG,23,DET,28,25,922,151,342,.442,73,183,.399,78,159,.491,.548,67,75,.893,9,89,98,115,12,6,43,65,442,19
Stanton Kidd,SG,27,UTA,4,0,15,0,3,0,0,1,0,0,2,0,0,0,0,0,0,3,3,1,0,0,2,3,0,19
Michael Kidd-Gilchrist,PF,26,TOT,25,0,281,22,66,.333,5,20,.250,17,46,.370,.371,11,14,.786,14,53,67,14,2,6,16,37,60,19
Michael Kidd-Gilchrist,PF,26,CHO,12,0,160,18,53,.340,5,17,.294,13,36,.361,.387,7,9,.778,9,26,35,10,0,3,7,18,48,19
Michael Kidd-Gilchrist,PF,26,DAL,13,0,121,4,13,.308,0,3,0,4,10,.400,.308,4,5,.800,5,27,32,4,2,3,9,19,12,19
Louis King,SF,20,DET,10,0,62,8,21,.381,4,11,.364,4,10,.400,.476,0,3,0,1,9,10,5,2,0,2,10,20,19
Maxi Kleber,PF,28,DAL,74,21,1890,237,514,.461,119,319,.373,118,195,.605,.577,79,93,.849,112,276,388,88,25,83,58,176,672,19
Brandon Knight,SG-PG,28,TOT,25,3,462,59,167,.353,45,131,.344,14,36,.389,.488,20,34,.588,4,37,41,69,10,3,38,40,183,19
Brandon Knight,SG,28,CLE,16,0,241,28,86,.326,19,64,.297,9,22,.409,.436,4,13,.308,3,17,20,31,5,2,16,20,79,19
Brandon Knight,PG,28,DET,9,3,221,31,81,.383,26,67,.388,5,14,.357,.543,16,21,.762,1,20,21,38,5,1,22,20,104,19
Kevin Knox,SF,20,NYK,65,4,1166,144,401,.359,65,199,.327,79,202,.391,.440,66,101,.653,28,156,184,61,23,28,45,106,419,19
John Konchar,SG,23,MEM,19,0,181,24,37,.649,5,10,.500,19,27,.704,.716,1,2,.500,18,29,47,22,7,3,7,7,54,19
Furkan Korkmaz,SG,22,PHI,72,12,1559,242,563,.430,143,356,.402,99,207,.478,.557,77,102,.755,18,150,168,79,41,16,59,98,704,19
Luke Kornet,C,24,CHI,36,14,559,82,187,.439,31,108,.287,51,79,.646,.521,20,28,.714,22,62,84,32,11,26,14,54,215,19
Kyle Korver,SF,38,MIL,58,1,960,126,293,.430,99,237,.418,27,56,.482,.599,35,41,.854,15,107,122,68,26,12,48,78,386,19
Rodions Kurucs,PF,21,BRK,47,9,684,79,177,.446,33,90,.367,46,87,.529,.540,24,38,.632,25,112,137,51,25,5,46,90,215,19
Kyle Kuzma,PF,24,LAL,61,9,1526,291,668,.436,86,272,.316,205,396,.518,.500,114,155,.735,52,221,273,80,28,26,91,126,782,19
Skal Labissière,C,23,POR,33,1,567,81,147,.551,3,13,.231,78,134,.582,.561,25,33,.758,65,104,169,42,7,31,30,89,190,19
Jeremy Lamb,SG,27,IND,46,42,1291,216,479,.451,53,158,.335,163,321,.508,.506,92,110,.836,24,176,200,96,55,22,50,104,577,19
Romeo Langford,SG,20,BOS,32,2,370,28,80,.350,5,27,.185,23,53,.434,.381,18,25,.720,15,26,41,13,8,8,11,33,79,19
Zach LaVine,SF,24,CHI,60,60,2085,539,1199,.450,184,484,.380,355,715,.497,.526,268,334,.802,41,248,289,254,88,28,206,131,1530,19
Vic Law,PF,24,ORL,8,0,62,6,18,.333,1,7,.143,5,11,.455,.361,2,6,.333,2,9,11,3,2,0,2,6,15,19
Jake Layman,SF,25,MIN,23,2,505,81,179,.453,24,72,.333,57,107,.533,.520,24,32,.750,17,40,57,15,17,10,24,47,210,19
T.J. Leaf,PF,22,IND,28,1,222,36,86,.419,5,18,.278,31,68,.456,.448,7,16,.438,23,48,71,9,10,4,8,22,84,19
Jalen Lecque,SG,19,PHO,5,0,32,4,10,.400,0,4,0,4,6,.667,.400,2,2,1.000,0,2,2,2,0,0,2,3,10,19
Courtney Lee,SG,34,DAL,24,9,345,40,82,.488,21,47,.447,19,35,.543,.616,6,7,.857,7,25,32,12,18,6,11,33,107,19
Damion Lee,SG,27,GSW,49,36,1423,213,511,.417,85,239,.356,128,272,.471,.500,110,126,.873,32,207,239,133,50,6,67,116,621,19
Alex Len,C,26,TOT,55,12,970,177,319,.555,16,59,.271,161,260,.619,.580,68,105,.648,100,221,321,50,23,48,55,127,438,19
Alex Len,C,26,ATL,40,9,745,142,260,.546,14,56,.250,128,204,.627,.573,51,81,.630,69,161,230,42,20,33,39,93,349,19
Alex Len,C,26,SAC,15,3,225,35,59,.593,2,3,.667,33,56,.589,.610,17,24,.708,31,60,91,8,3,15,16,34,89,19
Kawhi Leonard,SF,28,LAC,57,57,1848,532,1133,.470,123,325,.378,409,808,.506,.524,356,402,.886,54,348,402,280,103,33,149,113,1543,19
Meyers Leonard,C,27,MIA,51,49,1034,119,234,.509,53,128,.414,66,106,.623,.622,18,28,.643,30,230,260,55,14,15,39,107,309,19
Caris LeVert,SG,25,BRK,45,31,1330,311,732,.425,80,220,.364,231,512,.451,.480,140,197,.711,49,140,189,199,53,10,118,81,842,19
Damian Lillard,PG,29,POR,66,66,2474,624,1349,.463,270,674,.401,354,675,.524,.563,460,518,.888,33,251,284,530,70,22,194,114,1978,19
Nassir Little,PF,19,POR,48,5,573,65,151,.430,14,59,.237,51,92,.554,.477,28,44,.636,31,77,108,22,13,14,15,72,172,19
Kevon Looney,C,23,GSW,20,4,262,29,79,.367,1,14,.071,28,65,.431,.373,9,12,.750,28,38,66,20,12,6,12,34,68,19
Brook Lopez,C,31,MIL,68,67,1817,292,671,.435,102,325,.314,190,346,.549,.511,127,152,.836,58,254,312,99,46,163,70,163,813,19
Robin Lopez,C,31,MIL,66,5,958,147,299,.492,35,105,.333,112,194,.577,.550,28,53,.528,56,105,161,45,10,45,63,96,357,19
Kevin Love,PF,31,CLE,56,56,1780,327,727,.450,146,390,.374,181,337,.537,.550,187,219,.854,54,493,547,178,33,19,140,90,987,19
Kyle Lowry,PG,33,TOR,58,58,2098,334,803,.416,164,466,.352,170,337,.504,.518,294,343,.857,32,260,292,433,82,26,178,190,1126,19
Timothé Luwawu-Cabarrot,SF,24,BRK,47,2,853,117,269,.435,62,160,.388,55,109,.505,.550,69,81,.852,29,98,127,29,18,7,37,106,365,19
Trey Lyles,PF,24,SAS,63,53,1271,153,343,.446,65,168,.387,88,175,.503,.541,33,45,.733,71,290,361,69,28,28,39,98,404,19
Daryl Macon,PG,24,MIA,4,0,14,1,3,.333,1,2,.500,0,1,0,.500,0,0,0,0,0,0,1,0,0,2,1,3,19
J.P. Macura,SG,24,CLE,1,0,1,0,0,0,0,0,0,0,0,0,0,0,0,0,0,0,0,0,0,0,0,0,0,19
Josh Magette,PG,30,ORL,8,0,38,5,15,.333,1,4,.250,4,11,.364,.367,1,2,.500,1,5,6,5,3,1,5,4,12,19
Ian Mahinmi,C,33,WAS,38,35,808,104,210,.495,5,26,.192,99,184,.538,.507,70,113,.619,78,140,218,49,31,44,45,114,283,19
Thon Maker,C,22,DET,60,14,776,93,193,.482,22,64,.344,71,129,.550,.539,73,110,.664,54,113,167,43,25,39,45,102,281,19
Terance Mann,SF,23,LAC,41,6,362,37,79,.468,7,20,.350,30,59,.508,.513,18,27,.667,10,45,55,53,11,5,18,46,99,19
Boban Marjanović,C,31,DAL,44,5,422,121,211,.573,4,17,.235,117,194,.603,.583,43,57,.754,66,131,197,20,8,10,30,56,289,19
Lauri Markkanen,PF,22,CHI,50,50,1492,251,591,.425,109,317,.344,142,274,.518,.517,126,153,.824,60,253,313,74,42,23,81,96,737,19
Caleb Martin,SF,24,CHO,18,1,317,37,84,.440,20,37,.541,17,47,.362,.560,17,21,.810,10,28,38,23,12,7,15,32,111,19
Cody Martin,SF,24,CHO,48,3,903,89,207,.430,18,77,.234,71,130,.546,.473,42,65,.646,38,120,158,95,39,9,44,78,238,19
Jeremiah Martin,PG,23,BRK,9,0,99,24,53,.453,5,18,.278,19,35,.543,.500,11,14,.786,1,9,10,18,7,2,4,7,64,19
Kelan Martin,SF,24,MIN,31,4,495,71,181,.392,25,96,.260,46,85,.541,.461,30,31,.968,12,84,96,23,7,9,20,51,197,19
Frank Mason III,PG,25,MIL,9,0,118,23,51,.451,6,21,.286,17,30,.567,.510,10,17,.588,5,14,19,29,5,1,11,11,62,19
Garrison Mathews,SG,23,WAS,18,0,227,24,56,.429,19,46,.413,5,10,.500,.598,31,34,.912,6,18,24,10,8,1,8,32,98,19
Wesley Matthews,SG,33,MIL,67,67,1635,167,422,.396,108,297,.364,59,125,.472,.524,52,68,.765,22,144,166,92,38,9,43,103,494,19
Luc Mbah a Moute,PF,33,HOU,3,0,25,2,5,.400,0,2,0,2,3,.667,.400,1,2,.500,1,1,2,0,2,0,1,0,5,19
Patrick McCaw,SF,24,TOR,37,12,908,67,162,.414,23,71,.324,44,91,.484,.485,13,18,.722,19,67,86,79,39,4,29,60,170,19
CJ McCollum,SG,28,POR,70,70,2556,611,1356,.451,194,512,.379,417,844,.494,.522,140,185,.757,46,251,297,310,54,42,127,183,1556,19
T.J. McConnell,PG,27,IND,71,3,1326,212,411,.516,5,17,.294,207,394,.525,.522,35,42,.833,38,151,189,355,56,11,100,73,464,19
Jalen McDaniels,SF,22,CHO,16,0,293,33,70,.471,9,24,.375,24,46,.522,.536,14,17,.824,15,50,65,13,8,3,11,36,89,19
Doug McDermott,PF,28,IND,69,0,1372,267,547,.488,128,294,.435,139,253,.549,.605,48,58,.828,26,148,174,78,12,5,42,117,710,19
JaVale McGee,C,32,LAL,68,68,1130,195,306,.637,3,6,.500,192,300,.640,.642,53,82,.646,125,265,390,37,36,94,55,159,446,19
Rodney McGruder,SG,28,LAC,56,4,871,72,181,.398,24,89,.270,48,92,.522,.464,19,34,.559,29,122,151,36,26,8,24,74,187,19
Alfonzo McKinnie,SF,27,CLE,40,1,593,73,171,.427,14,65,.215,59,106,.557,.468,22,31,.710,37,76,113,14,23,8,26,72,182,19
Jordan McLaughlin,PG,23,MIN,30,2,590,87,178,.489,29,76,.382,58,102,.569,.570,26,39,.667,7,42,49,125,34,4,31,31,229,19
Ben McLemore,SF,26,HOU,71,23,1619,242,545,.444,181,452,.400,61,93,.656,.610,50,67,.746,21,136,157,58,45,16,50,155,715,19
Jordan McRae,SG,28,TOT,37,4,784,149,366,.407,45,126,.357,104,240,.433,.469,83,109,.761,18,106,124,93,21,16,43,73,426,19
Jordan McRae,SG,28,WAS,29,4,654,133,317,.420,40,106,.377,93,211,.441,.483,64,83,.771,17,87,104,82,19,15,38,61,370,19
Jordan McRae,SG,28,DEN,4,0,32,2,6,.333,2,4,.500,0,2,0,.500,3,4,.750,1,4,5,4,2,1,0,2,9,19
Jordan McRae,SG,28,DET,4,0,98,14,43,.326,3,16,.188,11,27,.407,.360,16,22,.727,0,15,15,7,0,0,5,10,47,19
Nicolò Melli,C,29,NOP,60,8,1042,136,323,.421,69,206,.335,67,117,.573,.528,54,73,.740,38,142,180,82,34,23,46,124,395,19
De'Anthony Melton,PG,21,MEM,60,8,1167,161,401,.401,40,140,.286,121,261,.464,.451,93,121,.769,43,177,220,175,77,20,84,109,455,19
Chimezie Metu,C,22,SAS,18,0,105,24,42,.571,0,2,0,24,40,.600,.571,10,13,.769,12,21,33,10,3,6,10,7,58,19
Khris Middleton,SF,28,MIL,62,59,1853,471,947,.497,147,354,.415,324,593,.546,.575,208,227,.916,44,338,382,265,53,7,137,142,1297,19
Eric Mika,C,25,SAC,1,0,19,2,3,.667,0,0,0,2,3,.667,.667,2,2,1.000,2,5,7,0,0,0,0,5,6,19
C.J. Miles,SF,32,WAS,10,0,161,19,59,.322,11,35,.314,8,24,.333,.415,15,20,.750,4,8,12,12,10,4,4,14,64,19
Malcolm Miller,SF,26,TOR,28,1,162,12,29,.414,8,22,.364,4,7,.571,.552,3,8,.375,2,14,16,11,5,2,4,18,35,19
Patty Mills,PG,31,SAS,66,1,1485,258,598,.431,154,403,.382,104,195,.533,.560,97,112,.866,22,86,108,118,53,6,54,105,767,19
Paul Millsap,PF,34,DEN,51,48,1240,211,438,.482,54,124,.435,157,314,.500,.543,115,141,.816,98,195,293,83,44,30,70,150,591,19
Shake Milton,SG,23,PHI,40,24,805,134,277,.484,58,135,.430,76,142,.535,.588,51,65,.785,15,73,88,104,20,7,47,92,377,19
Donovan Mitchell,SG,23,UTA,69,69,2364,602,1342,.449,173,473,.366,429,869,.494,.513,278,322,.863,53,251,304,294,70,14,184,172,1655,19
Naz Mitrou-Long,SG,26,IND,5,0,47,6,17,.353,2,12,.167,4,5,.800,.412,0,0,0,0,7,7,8,1,1,3,2,14,19
Adam Mokoka,SF,21,CHI,11,0,112,12,28,.429,6,15,.400,6,13,.462,.536,2,4,.500,7,3,10,4,4,0,2,17,32,19
Malik Monk,SG,21,CHO,55,1,1169,212,488,.434,58,204,.284,154,284,.542,.494,82,100,.820,27,130,157,114,25,16,77,74,564,19
Matt Mooney,SG,22,CLE,4,0,19,1,4,.250,0,2,0,1,2,.500,.250,0,0,0,0,3,3,1,2,1,0,1,2,19
E'Twaun Moore,SG,30,NOP,56,6,1020,186,437,.426,63,167,.377,123,270,.456,.498,31,45,.689,31,100,131,78,32,11,40,80,466,19
Ja Morant,PG,20,MEM,67,67,2074,447,937,.477,60,179,.335,387,758,.511,.509,239,308,.776,51,208,259,488,58,18,220,110,1193,19
Juwan Morgan,PF,22,UTA,21,0,134,15,26,.577,3,8,.375,12,18,.667,.635,3,4,.750,10,19,29,6,1,2,6,19,36,19
Marcus Morris,SF-PF,30,TOT,62,62,1936,355,810,.438,142,348,.408,213,462,.461,.526,181,220,.823,59,252,311,86,47,30,97,180,1033,19
Marcus Morris,SF,30,NYK,43,43,1387,281,636,.442,116,264,.439,165,372,.444,.533,163,198,.823,48,185,233,59,34,17,73,128,841,19
Marcus Morris,PF,30,LAC,19,19,549,74,174,.425,26,84,.310,48,90,.533,.500,18,22,.818,11,67,78,27,13,13,24,52,192,19
Markieff Morris,PF,30,TOT,58,17,1187,203,458,.443,88,228,.386,115,230,.500,.539,66,85,.776,40,178,218,77,31,17,76,133,560,19
Markieff Morris,PF,30,DET,44,16,988,175,389,.450,75,189,.397,100,200,.500,.546,61,79,.772,24,149,173,69,26,11,70,104,486,19
Markieff Morris,PF,30,LAL,14,1,199,28,69,.406,13,39,.333,15,30,.500,.500,5,6,.833,16,29,45,8,5,6,6,29,74,19
Monte Morris,PG,24,DEN,73,12,1636,260,566,.459,65,172,.378,195,394,.495,.517,75,89,.843,24,113,137,255,55,17,53,73,660,19
Johnathan Motley,PF,24,LAC,13,0,41,11,15,.733,1,1,1.000,10,14,.714,.767,5,7,.714,3,7,10,8,3,0,5,6,28,19
Emmanuel Mudiay,PG,23,UTA,54,2,850,151,327,.462,30,87,.345,121,240,.504,.508,63,83,.759,18,108,126,116,24,10,76,72,395,19
Mychal Mulder,SF,25,GSW,7,3,204,26,67,.388,16,52,.308,10,15,.667,.507,9,12,.750,3,20,23,8,2,1,5,20,77,19
Dejounte Murray,PG,23,SAS,66,58,1687,294,637,.462,41,111,.369,253,526,.481,.494,91,114,.798,69,314,383,271,111,17,125,143,720,19
Jamal Murray,PG,22,DEN,59,59,1904,408,894,.456,112,324,.346,296,570,.519,.519,163,185,.881,45,191,236,284,67,17,127,102,1091,19
Džanan Musa,SF,20,BRK,40,0,487,64,172,.372,19,78,.244,45,94,.479,.427,45,60,.750,21,65,86,43,15,1,36,30,192,19
Mike Muscala,C,28,OKC,47,2,572,77,189,.407,54,143,.378,23,46,.500,.550,18,22,.818,16,92,108,40,9,12,17,58,226,19
Svi Mykhailiuk,SF,22,DET,56,27,1265,166,405,.410,115,285,.404,51,120,.425,.552,57,70,.814,17,87,104,106,41,4,61,87,504,19
Abdel Nader,SF,26,OKC,55,6,867,123,263,.468,48,128,.375,75,135,.556,.559,51,66,.773,14,86,100,38,23,20,43,78,345,19
Larry Nance Jr.,PF,27,CLE,56,10,1472,229,431,.531,56,159,.352,173,272,.636,.596,50,74,.676,106,303,409,123,56,22,60,91,564,19
Shabazz Napier,PG,28,TOT,56,32,1344,188,456,.412,76,240,.317,112,216,.519,.496,126,153,.824,26,132,158,262,69,11,128,101,578,19
Shabazz Napier,PG,28,MIN,36,22,856,114,283,.403,47,159,.296,67,124,.540,.486,72,88,.818,17,93,110,187,40,7,76,62,347,19
Shabazz Napier,PG,28,WAS,20,10,488,74,173,.428,29,81,.358,45,92,.489,.512,54,65,.831,9,39,48,75,29,4,52,39,231,19
Raul Neto,PG,27,PHI,54,3,668,101,222,.455,34,88,.386,67,134,.500,.532,39,47,.830,11,50,61,95,24,6,47,50,275,19
Malik Newman,SG,22,CLE,1,0,4,0,2,0,0,1,0,0,1,0,0,2,2,1.000,0,0,0,0,0,0,1,0,2,19
Georges Niang,PF,26,UTA,66,1,923,141,322,.438,90,225,.400,51,97,.526,.578,20,24,.833,15,112,127,44,18,5,30,75,392,19
Joakim Noah,C,34,LAC,5,0,50,4,8,.500,0,0,0,4,8,.500,.500,6,8,.750,5,11,16,7,1,1,6,9,14,19
Nerlens Noel,C,25,OKC,61,7,1127,184,269,.684,1,3,.333,183,266,.688,.686,80,106,.755,91,209,300,57,59,91,66,166,449,19
Zach Norvell,SG,22,TOT,5,0,41,3,12,.250,3,8,.375,0,4,0,.375,1,1,1.000,0,6,6,3,2,0,3,4,10,19
Zach Norvell,SG,22,LAL,2,0,5,0,1,0,0,0,0,0,1,0,0,0,0,0,0,1,1,0,0,0,0,0,0,19
Zach Norvell,SG,22,GSW,3,0,36,3,11,.273,3,8,.375,0,3,0,.409,1,1,1.000,0,5,5,3,2,0,3,4,10,19
Jaylen Nowell,SG,20,MIN,15,0,151,19,53,.358,3,26,.115,16,27,.593,.387,16,17,.941,3,10,13,19,3,1,3,11,57,19
Frank Ntilikina,PG,21,NYK,57,26,1187,131,333,.393,44,137,.321,87,196,.444,.459,51,59,.864,23,98,121,172,54,16,71,142,357,19
Kendrick Nunn,PG,24,MIA,67,67,1962,401,914,.439,137,391,.350,264,523,.505,.514,85,100,.850,21,159,180,220,56,15,114,152,1024,19
Jusuf Nurkić,C,25,POR,8,8,253,54,109,.495,2,10,.200,52,99,.525,.505,31,35,.886,23,59,82,32,11,16,19,39,141,19
David Nwaba,SF,27,BRK,20,0,268,37,71,.521,12,28,.429,25,43,.581,.606,18,27,.667,8,37,45,8,11,12,8,32,104,19
Royce O'Neale,SF,26,UTA,71,62,2049,158,365,.433,92,244,.377,66,121,.545,.559,42,55,.764,27,362,389,180,59,32,61,202,450,19
Kyle O'Quinn,C,29,PHI,29,2,313,42,85,.494,7,27,.259,35,58,.603,.535,11,20,.550,34,82,116,51,7,24,20,37,102,19
Semi Ojeleye,PF,25,BOS,69,6,1011,80,196,.408,48,127,.378,32,69,.464,.531,28,32,.875,26,119,145,37,21,5,19,80,236,19
Jahlil Okafor,C,24,NOP,30,9,467,101,162,.623,1,3,.333,100,159,.629,.627,40,62,.645,48,79,127,37,7,22,38,67,243,19
Elie Okobo,PG,22,PHO,55,3,719,72,181,.398,25,71,.352,47,110,.427,.467,50,71,.704,16,74,90,115,24,4,38,54,219,19
Josh Okogie,SG,21,MIN,62,28,1547,170,398,.427,41,154,.266,129,244,.529,.479,152,191,.796,87,181,268,99,68,26,87,139,533,19
KZ Okpala,PF,20,MIA,5,0,26,3,5,.600,0,1,0,3,4,.750,.600,1,2,.500,1,4,5,1,2,1,1,2,7,19
Victor Oladipo,SG,27,IND,19,16,528,97,246,.394,33,104,.317,64,142,.451,.461,48,59,.814,9,66,75,56,17,4,47,36,275,19
Kelly Olynyk,C,28,MIA,67,9,1300,184,398,.462,95,234,.406,89,164,.543,.582,86,100,.860,44,261,305,116,45,23,71,173,549,19
Miye Oni,SF,22,UTA,10,1,109,12,32,.375,7,19,.368,5,13,.385,.484,4,5,.800,5,12,17,4,4,2,4,9,35,19
Cedi Osman,SF,24,CLE,65,65,1910,266,609,.437,123,321,.383,143,288,.497,.538,63,94,.670,39,192,231,154,54,16,91,160,718,19
Kelly Oubre Jr.,SF,24,PHO,56,55,1933,373,826,.452,108,307,.352,265,519,.511,.517,192,246,.780,67,294,361,85,71,40,83,192,1046,19
Tariq Owens,PF,24,PHO,3,0,15,1,5,.200,0,2,0,1,3,.333,.200,2,2,1.000,2,1,3,0,1,0,0,1,4,19
Jeremy Pargo,PG,33,GSW,3,0,44,11,22,.500,3,7,.429,8,15,.533,.568,0,1,0,1,2,3,8,1,0,4,8,25,19
Jabari Parker,PF,24,TOT,38,23,917,219,429,.510,32,119,.269,187,310,.603,.548,61,81,.753,61,153,214,68,45,16,64,99,531,19
Jabari Parker,PF,24,ATL,32,23,837,198,393,.504,31,115,.270,167,278,.601,.543,53,72,.736,54,137,191,58,42,15,60,93,480,19
Jabari Parker,PF,24,SAC,6,0,80,21,36,.583,1,4,.250,20,32,.625,.597,8,9,.889,7,16,23,10,3,1,4,6,51,19
Chandler Parsons,PF,31,ATL,5,0,54,5,18,.278,4,14,.286,1,4,.250,.389,0,0,0,1,6,7,3,4,1,3,3,14,19
Eric Paschall,PF,23,GSW,60,26,1654,318,640,.497,37,129,.287,281,511,.550,.526,164,212,.774,82,193,275,127,32,13,94,125,837,19
Anžejs Pasečņiks,C,24,WAS,27,0,437,61,116,.526,0,3,0,61,113,.540,.526,34,58,.586,42,65,107,18,9,12,24,75,156,19
Patrick Patterson,PF,30,LAC,59,18,776,95,233,.408,67,172,.390,28,61,.459,.552,35,43,.814,35,116,151,41,7,3,21,54,292,19
Justin Patton,C,22,OKC,5,0,24,4,10,.400,1,4,.250,3,6,.500,.450,0,0,0,1,4,5,2,0,0,2,4,9,19
Chris Paul,PG,34,OKC,70,70,2208,434,887,.489,111,304,.365,323,583,.554,.552,253,279,.907,26,323,349,472,111,11,161,158,1232,19
Cameron Payne,SG,25,PHO,8,0,183,33,68,.485,15,29,.517,18,39,.462,.596,6,7,.857,4,27,31,24,8,2,11,20,87,19
Elfrid Payton,PG,25,NYK,45,36,1246,193,440,.439,14,69,.203,179,371,.482,.455,49,86,.570,52,160,212,323,70,17,96,89,449,19
Gary Payton II,SF,27,WAS,29,17,432,48,116,.414,13,46,.283,35,70,.500,.470,4,8,.500,26,54,80,48,33,7,20,54,113,19
Norvel Pelle,C,26,PHI,24,0,232,25,48,.521,0,1,0,25,47,.532,.521,7,14,.500,20,52,72,8,3,31,18,55,57,19
Theo Pinson,SG,24,BRK,33,0,365,45,155,.290,15,80,.188,30,75,.400,.339,15,16,.938,10,44,54,56,17,4,33,35,120,19
Mason Plumlee,C,29,DEN,61,1,1057,177,288,.615,0,5,0,177,283,.625,.615,83,155,.535,98,219,317,154,33,38,82,143,437,19
Jakob Poeltl,C,24,SAS,66,18,1171,166,266,.624,0,0,0,166,266,.624,.624,40,86,.465,131,244,375,116,37,95,54,126,372,19
Vincent Poirier,C,26,BOS,22,0,130,17,36,.472,1,2,.500,16,34,.471,.486,6,7,.857,13,30,43,8,2,9,8,25,41,19
Shamorie Ponds,PG,21,TOR,4,0,11,3,5,.600,1,2,.500,2,3,.667,.700,2,2,1.000,0,1,1,2,0,1,0,2,9,19
Jordan Poole,SG,20,GSW,57,14,1274,167,502,.333,74,265,.279,93,237,.392,.406,95,119,.798,9,109,118,134,35,10,74,94,503,19
Kevin Porter Jr.,SF,19,CLE,50,3,1162,186,421,.442,53,158,.335,133,263,.506,.505,73,101,.723,22,140,162,109,46,14,93,135,498,19
Michael Porter Jr.,SF,21,DEN,55,8,903,195,383,.509,62,147,.422,133,236,.564,.590,60,72,.833,66,193,259,46,27,25,49,100,512,19
Otto Porter Jr.,SF,26,CHI,14,9,331,62,140,.443,24,62,.387,38,78,.487,.529,19,27,.704,13,35,48,25,15,6,11,31,167,19
Bobby Portis,PF,24,NYK,66,5,1393,265,589,.450,67,187,.358,198,402,.493,.507,71,93,.763,80,258,338,98,32,18,73,110,668,19
Kristaps Porziņģis,C,24,DAL,57,57,1814,398,932,.427,142,403,.352,256,529,.484,.503,226,283,.799,100,440,540,102,41,115,92,185,1164,19
Dwight Powell,C,28,DAL,40,37,1061,146,229,.638,10,39,.256,136,190,.716,.659,74,111,.667,75,152,227,59,34,22,36,102,376,19
Norman Powell,SG,26,TOR,52,26,1479,296,598,.495,109,273,.399,187,325,.575,.586,129,153,.843,26,164,190,91,60,21,77,108,830,19
Taurean Prince,PF,25,BRK,64,61,1857,278,739,.376,146,431,.339,132,308,.429,.475,71,89,.798,50,331,381,116,57,25,127,159,773,19
Chasson Randle,PG,26,GSW,3,0,40,0,4,0,0,2,0,0,2,0,0,5,6,.833,0,2,2,5,2,0,0,3,5,19
Julius Randle,PF,25,NYK,64,64,2080,463,1006,.460,64,231,.277,399,775,.515,.492,258,352,.733,151,471,622,198,51,22,193,178,1248,19
Josh Reaves,SF,22,DAL,4,0,28,3,9,.333,0,2,0,3,7,.429,.333,2,2,1.000,1,2,3,3,0,0,0,5,8,19
Cam Reddish,SF,20,ATL,58,34,1551,213,554,.384,83,250,.332,130,304,.428,.459,101,126,.802,35,181,216,87,62,28,96,132,610,19
J.J. Redick,SG,35,NOP,60,36,1581,286,631,.453,180,397,.453,106,234,.453,.596,165,185,.892,10,141,151,119,20,10,75,96,917,19
Naz Reid,C,20,MIN,30,11,495,100,243,.412,32,97,.330,68,146,.466,.477,37,53,.698,34,90,124,35,19,22,22,83,269,19
Josh Richardson,SG,26,PHI,55,53,1693,278,646,.430,85,249,.341,193,397,.486,.496,114,141,.809,41,133,174,162,52,36,104,136,755,19
Austin Rivers,SG,27,HOU,68,4,1594,211,501,.421,96,270,.356,115,231,.498,.517,78,111,.703,27,148,175,113,49,10,50,129,596,19
Andre Roberson,SF,28,OKC,7,0,87,8,29,.276,3,14,.214,5,15,.333,.328,1,2,.500,7,20,27,4,1,3,2,13,20,19
Duncan Robinson,SG,25,MIA,73,68,2166,323,687,.470,270,606,.446,53,81,.654,.667,67,72,.931,10,222,232,102,35,19,70,193,983,19
Glenn Robinson III,SF,26,TOT,62,52,1786,288,592,.486,77,197,.391,211,395,.534,.552,74,86,.860,81,189,270,96,54,16,55,100,727,19
Glenn Robinson III,SF,26,GSW,48,48,1516,244,507,.481,68,170,.400,176,337,.522,.548,63,74,.851,66,160,226,85,45,14,50,82,619,19
Glenn Robinson III,SF,26,PHI,14,4,270,44,85,.518,9,27,.333,35,58,.603,.571,11,12,.917,15,29,44,11,9,2,5,18,108,19
Jerome Robinson,SG,22,TOT,63,6,979,115,310,.371,49,153,.320,66,157,.420,.450,40,57,.702,13,116,129,87,28,17,49,112,319,19
Jerome Robinson,SG,22,LAC,42,1,476,46,136,.338,19,67,.284,27,69,.391,.408,11,19,.579,5,55,60,46,13,8,26,55,122,19
Jerome Robinson,SG,22,WAS,21,5,503,69,174,.397,30,86,.349,39,88,.443,.483,29,38,.763,8,61,69,41,15,9,23,57,197,19
Justin Robinson,PG,22,WAS,9,0,49,5,12,.417,3,5,.600,2,7,.286,.542,0,0,0,1,4,5,7,0,1,3,2,13,19
Mitchell Robinson,C,21,NYK,61,7,1412,253,341,.742,0,0,0,253,341,.742,.742,84,148,.568,186,242,428,36,52,119,37,194,590,19
Isaiah Roby,PF,21,OKC,3,0,11,0,1,0,0,0,0,0,1,0,0,0,0,0,0,2,2,0,0,0,1,1,0,19
Rajon Rondo,PG,33,LAL,48,3,984,137,328,.418,41,125,.328,96,203,.473,.480,27,41,.659,23,119,142,240,40,2,91,58,342,19
Derrick Rose,PG,31,DET,50,15,1298,369,753,.490,45,147,.306,324,606,.535,.520,121,139,.871,27,94,121,278,40,16,126,49,904,19
Terrence Ross,SG,28,ORL,69,0,1889,341,846,.403,177,504,.351,164,342,.480,.508,157,184,.853,13,209,222,82,77,24,70,109,1016,19
Terry Rozier,PG,25,CHO,63,63,2164,398,941,.423,172,423,.407,226,518,.436,.514,166,190,.874,50,226,276,259,61,10,141,126,1134,19
Ricky Rubio,PG,29,PHO,65,65,2016,287,692,.415,78,216,.361,209,476,.439,.471,195,226,.863,46,258,304,570,94,11,173,167,847,19
D'Angelo Russell,PG,23,TOT,45,45,1452,360,846,.426,158,431,.367,202,415,.487,.519,161,199,.809,17,160,177,285,48,13,147,86,1039,19
D'Angelo Russell,PG,23,GSW,33,33,1060,273,635,.430,120,321,.374,153,314,.487,.524,113,144,.785,14,108,122,206,31,9,101,64,779,19
D'Angelo Russell,PG,23,MIN,12,12,392,87,211,.412,38,110,.345,49,101,.485,.502,48,55,.873,3,52,55,79,17,4,46,22,260,19
Domantas Sabonis,PF,23,IND,62,62,2159,458,848,.540,17,67,.254,441,781,.565,.550,214,296,.723,189,582,771,310,47,30,170,195,1147,19
Luka Šamanić,PF,20,SAS,3,1,48,5,16,.313,3,8,.375,2,8,.250,.406,3,4,.750,1,9,10,6,0,2,2,6,16,19
JaKarr Sampson,PF,26,IND,34,12,471,68,115,.591,2,13,.154,66,102,.647,.600,18,27,.667,20,68,88,21,16,12,15,64,156,19
Dario Šarić,PF,25,PHO,66,51,1632,256,538,.476,84,235,.357,172,303,.568,.554,108,128,.844,100,306,406,123,37,16,88,156,704,19
Tomáš Satoranský,SG,28,CHI,65,64,1878,237,551,.430,64,199,.322,173,352,.491,.488,106,121,.876,76,178,254,354,80,7,130,135,644,19
Admiral Schofield,PF,22,WAS,33,2,368,35,92,.380,19,61,.311,16,31,.516,.484,10,15,.667,7,40,47,15,8,4,7,50,99,19
Dennis Schröder,PG,26,OKC,65,2,1999,453,965,.469,125,325,.385,328,640,.513,.534,198,236,.839,19,217,236,262,45,14,166,146,1229,19
Mike Scott,PF,31,PHI,68,11,1207,149,350,.426,80,217,.369,69,133,.519,.540,30,37,.811,65,183,248,56,21,5,26,96,408,19
Thabo Sefolosha,PF,35,HOU,41,0,436,37,91,.407,15,54,.278,22,37,.595,.489,3,8,.375,21,72,93,25,24,12,15,43,92,19
Collin Sexton,PG,21,CLE,65,65,2143,513,1086,.472,97,255,.380,416,831,.501,.517,226,267,.846,61,143,204,192,65,7,158,142,1349,19
Landry Shamet,SG,22,LAC,53,30,1452,158,391,.404,111,296,.375,47,95,.495,.546,65,76,.855,6,94,100,99,20,10,42,142,492,19
Marial Shayok,SG,24,PHI,4,0,28,3,12,.250,2,6,.333,1,6,.167,.333,3,4,.750,1,6,7,1,0,1,3,4,11,19
Iman Shumpert,SF,29,BRK,13,0,241,21,64,.328,8,33,.242,13,31,.419,.391,4,7,.571,9,25,34,12,12,2,10,21,54,19
Pascal Siakam,PF,25,TOR,60,60,2110,500,1104,.453,131,365,.359,369,739,.499,.512,240,303,.792,64,375,439,207,61,53,148,170,1371,19
Chris Silva,PF,23,MIA,44,0,346,48,78,.615,0,3,0,48,75,.640,.615,37,55,.673,60,66,126,23,9,21,32,85,133,19
Ben Simmons,PG,23,PHI,57,57,2017,375,647,.580,2,7,.286,373,640,.583,.581,185,298,.621,113,331,444,455,119,33,200,186,937,19
Anfernee Simons,SG,20,POR,70,4,1449,214,536,.399,75,226,.332,139,310,.448,.469,76,92,.826,25,127,152,97,26,10,61,135,579,19
Alen Smailagić,C,19,GSW,14,0,139,20,40,.500,3,13,.231,17,27,.630,.538,16,19,.842,10,17,27,13,3,4,11,14,59,19
Marcus Smart,SG,25,BOS,60,40,1919,256,682,.375,137,395,.347,119,287,.415,.476,127,152,.836,42,183,225,291,101,29,103,162,776,19
Dennis Smith Jr.,PG,22,NYK,34,3,537,72,211,.341,16,54,.296,56,157,.357,.379,27,53,.509,21,57,78,98,28,8,58,65,187,19
Ish Smith,PG,31,WAS,68,23,1787,308,689,.447,62,169,.367,246,520,.473,.492,62,86,.721,30,189,219,334,59,30,95,106,740,19
J.R. Smith,SG,34,LAL,6,0,79,7,22,.318,1,11,.091,6,11,.545,.341,2,2,1.000,0,5,5,3,1,0,4,5,17,19
Zhaire Smith,SF,20,PHI,7,0,32,3,11,.273,0,3,0,3,8,.375,.273,2,4,.500,0,2,2,2,3,0,2,4,8,19
Tony Snell,SF,28,DET,59,57,1641,170,382,.445,102,254,.402,68,128,.531,.579,32,32,1.000,9,102,111,127,32,15,31,101,474,19
Omari Spellman,C,22,GSW,49,3,886,127,295,.431,43,110,.391,84,185,.454,.503,73,92,.793,77,142,219,47,33,24,54,63,370,19
Max Strus,SF,23,CHI,2,0,6,2,3,.667,0,1,0,2,2,1.000,.667,1,1,1.000,1,0,1,0,0,0,0,1,5,19
Edmond Sumner,SG,24,IND,31,3,447,61,142,.430,14,53,.264,47,89,.528,.479,16,29,.552,11,35,46,55,15,9,22,44,152,19
Caleb Swanigan,PF-C,22,TOT,27,1,288,28,47,.596,0,2,0,28,45,.622,.596,9,17,.529,27,73,100,31,3,7,37,62,65,19
Caleb Swanigan,C,22,SAC,7,0,23,2,4,.500,0,0,0,2,4,.500,.500,1,2,.500,2,5,7,2,1,2,6,8,5,19
Caleb Swanigan,PF,22,POR,20,1,265,26,43,.605,0,2,0,26,41,.634,.605,8,15,.533,25,68,93,29,2,5,31,54,60,19
Jayson Tatum,PF,21,BOS,66,66,2265,552,1226,.450,189,469,.403,363,757,.480,.527,254,313,.812,64,396,460,200,93,57,155,136,1547,19
Jeff Teague,PG,31,TOT,59,17,1464,213,489,.436,43,117,.368,170,372,.457,.480,172,197,.873,27,115,142,308,44,19,116,106,641,19
Jeff Teague,PG,31,MIN,34,13,945,145,324,.448,33,87,.379,112,237,.473,.498,125,144,.868,15,73,88,208,25,13,76,70,448,19
Jeff Teague,PG,31,ATL,25,4,519,68,165,.412,10,30,.333,58,135,.430,.442,47,53,.887,12,42,54,100,19,6,40,36,193,19
Garrett Temple,SG,33,BRK,62,35,1730,222,587,.378,127,386,.329,95,201,.473,.486,70,87,.805,29,189,218,156,49,29,62,108,641,19
Daniel Theis,C,27,BOS,65,64,1566,241,426,.566,32,96,.333,209,330,.633,.603,87,114,.763,140,286,426,111,37,84,54,219,601,19
Isaiah Thomas,PG,30,WAS,40,37,925,174,426,.408,78,189,.413,96,237,.405,.500,62,76,.816,11,57,68,146,13,6,77,77,488,19
Khyri Thomas,SG,23,DET,8,0,61,5,17,.294,5,14,.357,0,3,0,.441,2,4,.500,1,0,1,3,3,0,3,9,17,19
Lance Thomas,PF,31,BRK,7,4,98,8,23,.348,4,13,.308,4,10,.400,.435,4,4,1.000,2,11,13,6,0,0,6,11,24,19
Matt Thomas,SG,25,TOR,41,1,440,73,150,.487,47,99,.475,26,51,.510,.643,9,12,.750,9,52,61,22,10,1,16,38,202,19
Tristan Thompson,PF,28,CLE,57,51,1721,288,562,.512,9,23,.391,279,539,.518,.520,99,161,.615,226,351,577,120,33,50,103,124,684,19
Sindarius Thornwell,SF,25,NOP,2,0,35,6,11,.545,2,4,.500,4,7,.571,.636,2,4,.500,0,4,4,4,1,1,2,2,16,19
Matisse Thybulle,SG,22,PHI,65,14,1287,112,265,.423,56,157,.357,56,108,.519,.528,25,41,.610,44,63,107,79,94,47,51,141,305,19
Anthony Tolliver,PF,34,TOT,55,13,872,65,182,.357,49,145,.338,16,37,.432,.492,21,29,.724,34,120,154,42,19,11,34,74,200,19
Anthony Tolliver,PF,34,POR,33,9,554,43,117,.368,30,89,.337,13,28,.464,.496,13,19,.684,27,83,110,29,8,9,21,54,129,19
Anthony Tolliver,PF,34,SAC,9,0,82,3,17,.176,2,15,.133,1,2,.500,.235,1,2,.500,2,9,11,3,4,1,4,6,9,19
Anthony Tolliver,PF,34,MEM,13,4,236,19,48,.396,17,41,.415,2,7,.286,.573,7,8,.875,5,28,33,10,7,1,9,14,62,19
Juan Toscano-Anderson,SG,26,GSW,13,6,272,29,63,.460,8,23,.348,21,40,.525,.524,3,5,.600,9,43,52,26,13,5,16,30,69,19
Karl-Anthony Towns,C,24,MIN,35,35,1187,316,622,.508,114,277,.412,202,345,.586,.600,180,226,.796,95,283,378,153,33,42,110,117,926,19
Gary Trent Jr.,SF,21,POR,61,8,1332,196,441,.444,112,268,.418,84,173,.486,.571,37,45,.822,25,75,100,61,48,16,21,90,541,19
Allonzo Trier,SG,24,NYK,24,1,291,51,106,.481,19,53,.358,32,53,.604,.571,34,43,.791,6,23,29,28,3,4,22,29,155,19
P.J. Tucker,PF,34,HOU,72,72,2467,177,426,.415,107,299,.358,70,127,.551,.541,39,48,.813,112,364,476,115,77,36,72,229,500,19
Rayjon Tucker,SG,22,UTA,20,0,161,20,43,.465,3,17,.176,17,26,.654,.500,19,23,.826,3,17,20,5,1,1,8,10,62,19
Evan Turner,SG,31,ATL,19,0,251,25,67,.373,0,5,0,25,62,.403,.373,12,14,.857,8,30,38,38,9,8,26,20,62,19
Myles Turner,C,23,IND,62,62,1826,268,587,.457,86,250,.344,182,337,.540,.530,127,169,.751,86,321,407,72,46,132,85,166,749,19
Jarrod Uthoff,PF,26,TOT,7,0,53,7,18,.389,3,9,.333,4,9,.444,.472,2,2,1.000,2,4,6,0,1,0,0,2,19,19
Jarrod Uthoff,PF,26,MEM,4,0,14,1,7,.143,0,4,0,1,3,.333,.143,2,2,1.000,1,0,1,0,1,0,0,1,4,19
Jarrod Uthoff,PF,26,WAS,3,0,39,6,11,.545,3,5,.600,3,6,.500,.682,0,0,0,1,4,5,0,0,0,0,1,15,19
Jonas Valančiūnas,C,27,MEM,70,70,1845,432,739,.585,32,91,.352,400,648,.617,.606,148,200,.740,213,575,788,131,30,76,127,185,1044,19
Denzel Valentine,SF,26,CHI,36,5,488,97,237,.409,46,137,.336,51,100,.510,.506,6,8,.750,9,65,74,43,26,6,26,51,246,19
Jarred Vanderbilt,PF,20,TOT,11,0,46,5,8,.625,0,1,0,5,7,.714,.625,2,2,1.000,3,6,9,2,3,1,7,6,12,19
Jarred Vanderbilt,PF,20,DEN,9,0,41,5,7,.714,0,0,0,5,7,.714,.714,0,0,0,3,5,8,2,3,1,7,6,10,19
Jarred Vanderbilt,PF,20,MIN,2,0,5,0,1,0,0,1,0,0,0,0,0,2,2,1.000,0,1,1,0,0,0,0,0,2,19
Fred VanVleet,SG,25,TOR,54,54,1928,319,773,.413,146,374,.390,173,399,.434,.507,168,198,.848,18,185,203,357,100,17,121,132,952,19
Gabe Vincent,PG,23,MIA,9,0,83,8,37,.216,6,27,.222,2,10,.200,.297,0,0,0,0,5,5,6,5,0,1,6,22,19
Noah Vonleh,C,24,TOT,36,1,377,52,92,.565,3,15,.200,49,77,.636,.582,25,32,.781,37,87,124,28,11,6,21,40,132,19
Noah Vonleh,C,24,MIN,29,1,347,47,86,.547,2,14,.143,45,72,.625,.558,23,28,.821,34,82,116,26,11,6,19,36,119,19
Noah Vonleh,C,24,DEN,7,0,30,5,6,.833,1,1,1.000,4,5,.800,.917,2,4,.500,3,5,8,2,0,0,2,4,13,19
Nikola Vučević,C,29,ORL,62,62,1998,493,1033,.477,98,289,.339,395,744,.531,.525,131,167,.784,140,533,673,222,54,47,88,135,1215,19
Dean Wade,PF,23,CLE,12,0,71,9,13,.692,2,4,.500,7,9,.778,.769,0,1,0,3,16,19,2,2,4,3,8,20,19
Moritz Wagner,C,22,WAS,45,5,835,145,266,.545,25,80,.313,120,186,.645,.592,78,95,.821,56,163,219,56,28,19,66,152,393,19
Dion Waiters,SG,28,TOT,10,0,207,41,99,.414,15,47,.319,26,52,.500,.490,14,17,.824,2,22,24,20,4,6,16,21,111,19
Dion Waiters,SG,28,MIA,3,0,42,10,26,.385,8,17,.471,2,9,.222,.538,0,1,0,0,11,11,3,0,2,3,5,28,19
Dion Waiters,SG,28,LAL,7,0,165,31,73,.425,7,30,.233,24,43,.558,.473,14,16,.875,2,11,13,17,4,4,13,16,83,19
Kemba Walker,PG,29,BOS,56,56,1742,378,889,.425,180,473,.381,198,416,.476,.526,209,242,.864,36,181,217,268,48,28,117,91,1145,19
Lonnie Walker IV,SG,21,SAS,61,12,988,152,357,.426,41,101,.406,111,256,.434,.483,44,61,.721,23,116,139,68,32,14,44,78,389,19
Tyrone Wallace,SG,25,ATL,14,0,160,14,44,.318,1,15,.067,13,29,.448,.330,11,17,.647,3,19,22,13,7,1,10,19,40,19
Derrick Walton,PG,24,TOT,26,1,248,18,39,.462,10,24,.417,8,15,.533,.590,7,9,.778,2,14,16,27,7,0,5,21,53,19
Derrick Walton,PG,24,LAC,23,1,222,17,36,.472,9,21,.429,8,15,.533,.597,7,9,.778,2,13,15,22,4,0,4,19,50,19
Derrick Walton,PG,24,DET,3,0,26,1,3,.333,1,3,.333,0,0,0,.500,0,0,0,0,1,1,5,3,0,1,2,3,19
Brad Wanamaker,PG,30,BOS,71,1,1369,162,362,.448,37,102,.363,125,260,.481,.499,126,136,.926,22,122,144,179,61,14,76,133,487,19
T.J. Warren,SF,26,IND,67,67,2202,534,997,.536,91,226,.403,443,771,.575,.581,167,204,.819,68,212,280,99,78,34,84,187,1326,19
P.J. Washington,PF,21,CHO,58,57,1759,268,589,.455,86,230,.374,182,359,.507,.528,88,136,.647,58,258,316,123,51,44,93,158,710,19
Yuta Watanabe,SF,25,MEM,18,0,105,15,34,.441,3,8,.375,12,26,.462,.485,3,8,.375,7,13,20,5,5,1,2,9,36,19
Tremont Waters,PG,22,BOS,11,1,119,14,49,.286,4,24,.167,10,25,.400,.327,8,8,1.000,0,12,12,16,10,2,15,13,40,19
Paul Watson,SF,25,TOT,10,0,87,10,26,.385,4,12,.333,6,14,.429,.462,7,9,.778,2,15,17,8,4,1,3,5,31,19
Paul Watson,SF,25,ATL,2,0,17,0,7,0,0,3,0,0,4,0,0,0,0,0,0,2,2,3,1,0,0,1,0,19
Paul Watson,SF,25,TOR,8,0,70,10,19,.526,4,9,.444,6,10,.600,.632,7,9,.778,2,13,15,5,3,1,3,4,31,19
Quinndary Weatherspoon,SG,23,SAS,11,0,78,5,17,.294,1,5,.200,4,12,.333,.324,1,2,.500,1,6,7,11,3,1,5,8,12,19
Russell Westbrook,PG,31,HOU,57,57,2049,604,1281,.472,55,213,.258,549,1068,.514,.493,290,380,.763,100,351,451,401,93,20,255,200,1553,19
Coby White,PG,19,CHI,65,1,1674,312,792,.394,133,376,.354,179,416,.430,.478,102,129,.791,28,202,230,175,49,6,109,117,859,19
Derrick White,SG,25,SAS,68,20,1677,253,552,.458,79,216,.366,174,336,.518,.530,180,211,.853,35,188,223,241,44,59,89,152,765,19
Hassan Whiteside,C,30,POR,67,61,2008,436,702,.621,4,7,.571,432,695,.622,.624,164,239,.686,258,647,905,78,26,196,120,196,1040,19
Andrew Wiggins,SF,24,TOT,54,54,1858,437,978,.447,111,334,.332,326,644,.506,.504,190,268,.709,66,208,274,198,45,53,132,127,1175,19
Andrew Wiggins,SF,24,MIN,42,42,1455,351,790,.444,91,275,.331,260,515,.505,.502,149,207,.720,48,171,219,155,29,36,107,101,942,19
Andrew Wiggins,SF,24,GSW,12,12,403,86,188,.457,20,59,.339,66,129,.512,.511,41,61,.672,18,37,55,43,16,17,25,26,233,19
Grant Williams,PF,21,BOS,69,5,1043,87,211,.412,24,96,.250,63,115,.548,.469,39,54,.722,59,119,178,68,30,36,50,163,237,19
Johnathan Williams,PF,24,WAS,15,6,180,19,34,.559,0,2,0,19,32,.594,.559,7,13,.538,24,40,64,8,1,8,5,16,45,19
Kenrich Williams,PF,25,NOP,39,18,832,51,147,.347,25,97,.258,26,50,.520,.432,9,26,.346,51,135,186,57,27,21,22,88,136,19
Lou Williams,PG,33,LAC,65,8,1864,391,936,.418,111,315,.352,280,621,.451,.477,292,339,.861,31,170,201,365,43,12,182,80,1185,19
Marvin Williams,PF,33,TOT,58,1,1129,119,267,.446,56,156,.359,63,111,.568,.551,49,57,.860,30,153,183,60,36,30,33,103,343,19
Marvin Williams,PF,33,CHO,41,1,808,94,210,.448,44,117,.376,50,93,.538,.552,43,50,.860,15,94,109,41,26,22,25,71,275,19
Marvin Williams,PF,33,MIL,17,0,321,25,57,.439,12,39,.308,13,18,.722,.544,6,7,.857,15,59,74,19,10,8,8,32,68,19
Robert Williams,C,22,BOS,29,1,388,64,88,.727,0,0,0,64,88,.727,.727,22,34,.647,40,88,128,27,22,35,21,51,150,19
Nigel Williams-Goss,PG,25,UTA,10,0,50,5,16,.313,2,7,.286,3,9,.333,.375,2,2,1.000,2,4,6,6,3,1,3,6,14,19
Zion Williamson,PF,19,NOP,24,24,668,210,360,.583,6,14,.429,204,346,.590,.592,114,178,.640,64,86,150,50,16,9,59,42,540,19
D.J. Wilson,PF,23,MIL,37,1,363,52,132,.394,18,73,.247,34,59,.576,.462,11,18,.611,12,80,92,25,3,5,19,33,133,19
Justise Winslow,SG,23,MIA,11,5,352,50,129,.388,6,27,.222,44,102,.431,.411,18,27,.667,16,57,73,44,7,5,24,38,124,19
Christian Wood,PF,24,DET,62,12,1325,288,508,.567,54,140,.386,234,368,.636,.620,180,242,.744,104,286,390,60,34,54,84,98,810,19
Delon Wright,PG,27,DAL,73,5,1570,190,411,.462,47,127,.370,143,284,.504,.519,77,100,.770,70,210,280,244,85,22,73,93,504,19
Justin Wright-Foreman,PG,22,UTA,4,0,45,7,20,.350,2,10,.200,5,10,.500,.400,3,4,.750,0,5,5,7,2,0,3,5,19,19
Thaddeus Young,PF,31,CHI,64,16,1591,269,601,.448,79,222,.356,190,379,.501,.513,42,72,.583,94,221,315,117,92,23,102,134,659,19
Trae Young,PG,21,ATL,60,60,2120,546,1249,.437,205,568,.361,341,681,.501,.519,481,559,.860,32,223,255,560,65,8,289,104,1778,19
Cody Zeller,C,27,CHO,58,39,1341,251,479,.524,18,75,.240,233,404,.577,.543,122,179,.682,160,251,411,88,40,25,75,140,642,19
Tyler Zeller,C,30,SAS,2,0,4,1,4,.250,0,0,0,1,4,.250,.250,0,0,0,3,1,4,0,0,0,0,0,2,19
Ante Žižić,C,23,CLE,22,0,221,41,72,.569,0,0,0,41,72,.569,.569,14,19,.737,18,48,66,6,7,5,10,27,96,19
Ivica Zubac,C,22,LAC,72,70,1326,236,385,.613,0,2,0,236,383,.616,.613,124,166,.747,197,346,543,82,16,66,61,168,596,19
Precious Achiuwa,PF,21,MIA,61,4,737,124,228,.544,0,1,0,124,227,.546,.544,56,110,.509,73,135,208,29,20,28,43,91,304,20
Jaylen Adams,PG,24,MIL,7,0,18,1,8,.125,0,2,0,1,6,.167,.125,0,0,0,0,3,3,2,0,0,0,1,2,20
Steven Adams,C,27,NOP,58,58,1605,189,308,.614,0,3,0,189,305,.620,.614,60,135,.444,213,301,514,111,54,38,78,113,438,20
Bam Adebayo,C,23,MIA,64,64,2143,456,800,.570,2,8,.250,454,792,.573,.571,283,354,.799,142,431,573,346,75,66,169,145,1197,20
LaMarcus Aldridge,C,35,TOT,26,23,674,140,296,.473,31,80,.388,109,216,.505,.525,41,47,.872,19,99,118,49,11,29,27,47,352,20
LaMarcus Aldridge,C,35,SAS,21,18,544,115,248,.464,27,75,.360,88,173,.509,.518,31,37,.838,17,77,94,36,8,18,20,36,288,20
LaMarcus Aldridge,C,35,BRK,5,5,130,25,48,.521,4,5,.800,21,43,.488,.563,10,10,1.000,2,22,24,13,3,11,7,11,64,20
Ty-Shon Alexander,SG,22,PHO,15,0,47,3,12,.250,2,9,.222,1,3,.333,.333,1,2,.500,2,8,10,6,0,1,3,2,9,20
Nickeil Alexander-Walker,SG,22,NOP,46,13,1007,192,458,.419,76,219,.347,116,239,.485,.502,48,66,.727,13,131,144,102,47,22,69,88,508,20
Grayson Allen,SG,25,MEM,50,38,1259,173,414,.418,107,274,.391,66,140,.471,.547,79,91,.868,19,141,160,108,46,8,48,71,532,20
Jarrett Allen,C,22,TOT,63,45,1864,298,482,.618,6,19,.316,292,463,.631,.624,204,290,.703,196,435,631,106,32,90,100,96,806,20
Jarrett Allen,C,22,BRK,12,5,320,44,65,.677,0,0,0,44,65,.677,.677,46,61,.754,38,87,125,20,7,19,22,21,134,20
Jarrett Allen,C,22,CLE,51,40,1544,254,417,.609,6,19,.316,248,398,.623,.616,158,229,.690,158,348,506,86,25,71,78,75,672,20
Al-Farouq Aminu,PF,30,TOT,23,14,434,38,99,.384,8,37,.216,30,62,.484,.424,18,22,.818,22,88,110,31,19,9,28,29,102,20
Al-Farouq Aminu,PF,30,ORL,17,14,367,36,89,.404,7,31,.226,29,58,.500,.444,14,17,.824,20,71,91,29,17,9,25,22,93,20
Al-Farouq Aminu,PF,30,CHI,6,0,67,2,10,.200,1,6,.167,1,4,.250,.250,4,5,.800,2,17,19,2,2,0,3,7,9,20
Kyle Anderson,PF,27,MEM,69,69,1887,308,658,.468,94,261,.360,214,397,.539,.540,144,184,.783,52,344,396,250,84,57,86,120,854,20
Giannis Antetokounmpo,PF,26,MIL,61,61,2013,626,1100,.569,67,221,.303,559,879,.636,.600,398,581,.685,97,574,671,357,72,73,207,168,1717,20
Kostas Antetokounmpo,PF,23,LAL,15,0,56,3,10,.300,0,0,0,3,10,.300,.300,6,13,.462,4,15,19,1,2,4,11,8,12,20
Thanasis Antetokounmpo,SF,28,MIL,57,3,551,67,137,.489,7,29,.241,60,108,.556,.515,25,49,.510,54,70,124,46,22,10,43,74,166,20
Carmelo Anthony,PF,36,POR,69,3,1690,327,777,.421,133,325,.409,194,452,.429,.506,137,154,.890,32,182,214,104,46,38,61,144,924,20
Cole Anthony,PG,20,ORL,47,34,1273,219,552,.397,58,172,.337,161,380,.424,.449,109,131,.832,38,183,221,192,30,18,106,98,605,20
OG Anunoby,SF,23,TOR,43,43,1433,249,519,.480,104,261,.398,145,258,.562,.580,80,102,.784,54,183,237,94,66,32,75,114,682,20
Ryan Arcidiacono,PG,26,CHI,44,0,450,49,117,.419,25,67,.373,24,50,.480,.526,13,20,.650,5,62,67,56,9,0,10,47,136,20
Trevor Ariza,SF,35,MIA,30,27,841,99,241,.411,50,143,.350,49,98,.500,.515,34,44,.773,27,117,144,55,31,18,21,55,282,20
D.J. Augustin,PG,33,TOT,57,12,1129,135,343,.394,83,217,.382,52,126,.413,.515,85,94,.904,20,74,94,188,28,1,65,56,438,20
D.J. Augustin,PG,33,MIL,37,6,713,71,192,.370,49,129,.380,22,63,.349,.497,36,40,.900,11,39,50,110,20,1,34,33,227,20
D.J. Augustin,PG,33,HOU,20,6,416,64,151,.424,34,88,.386,30,63,.476,.536,49,54,.907,9,35,44,78,8,0,31,23,211,20
Deni Avdija,SF,20,WAS,54,32,1257,130,312,.417,53,168,.315,77,144,.535,.502,29,45,.644,22,240,262,63,32,15,33,140,342,20
Deandre Ayton,C,22,PHO,69,69,2115,430,687,.626,4,20,.200,426,667,.639,.629,133,173,.769,228,499,727,99,41,81,103,196,997,20
Udoka Azubuike,C,21,UTA,15,0,57,4,9,.444,0,0,0,4,9,.444,.444,8,10,.800,4,9,13,0,1,4,3,9,16,20
Dwayne Bacon,SG,25,ORL,72,50,1853,292,726,.402,59,207,.285,233,519,.449,.443,145,176,.824,31,193,224,93,45,5,46,103,788,20
Marvin Bagley III,PF,21,SAC,43,42,1112,247,490,.504,37,108,.343,210,382,.550,.542,77,134,.575,106,212,318,43,21,21,59,100,608,20
LaMelo Ball,PG,19,CHO,51,31,1469,293,672,.436,92,261,.352,201,411,.489,.504,125,165,.758,63,239,302,313,81,18,145,136,803,20
Lonzo Ball,PG,23,NOP,55,55,1747,290,700,.414,172,455,.378,118,245,.482,.537,50,64,.781,33,230,263,316,82,31,123,103,802,20
Mo Bamba,C,22,ORL,46,5,725,142,301,.472,38,118,.322,104,183,.568,.535,45,66,.682,76,189,265,35,14,58,36,87,367,20
Desmond Bane,SG,22,MEM,68,17,1519,234,499,.469,117,271,.432,117,228,.513,.586,40,49,.816,31,179,210,118,41,16,59,125,625,20
Harrison Barnes,PF,28,SAC,58,58,2102,319,642,.497,100,256,.391,219,386,.567,.575,195,235,.830,64,321,385,201,43,11,93,75,933,20
RJ Barrett,SG,20,NYK,72,72,2511,467,1060,.441,124,309,.401,343,751,.457,.499,206,276,.746,68,346,414,217,53,20,139,188,1264,20
Will Barton,SF,30,DEN,56,52,1736,259,608,.426,98,257,.381,161,351,.459,.507,95,121,.785,39,187,226,181,50,23,96,95,711,20
Keita Bates-Diop,SF,25,SAS,30,0,245,30,67,.448,5,17,.294,25,50,.500,.485,14,21,.667,9,40,49,12,11,5,7,11,79,20
Nicolas Batum,SF,32,LAC,67,38,1835,191,412,.464,110,272,.404,81,140,.579,.597,48,58,.828,50,266,316,148,69,37,53,102,540,20
Aron Baynes,C,34,TOR,53,31,980,134,304,.441,27,103,.262,107,201,.532,.485,29,41,.707,87,186,273,47,17,23,46,119,324,20
Kent Bazemore,SF,31,GSW,67,18,1333,176,392,.449,75,184,.408,101,208,.486,.545,54,78,.692,26,203,229,108,69,33,82,158,481,20
Darius Bazley,PF,20,OKC,55,55,1714,273,690,.396,83,286,.290,190,404,.470,.456,125,178,.702,51,345,396,99,29,25,122,60,754,20
Bradley Beal,SG,27,WAS,60,60,2147,670,1382,.485,130,373,.349,540,1009,.535,.532,408,459,.889,72,211,283,265,69,22,187,140,1878,20
Malik Beasley,SG,24,MIN,37,36,1214,264,600,.440,128,321,.399,136,279,.487,.547,68,80,.850,28,134,162,88,30,7,60,62,724,20
Jordan Bell,C,26,TOT,6,1,82,7,22,.318,0,2,0,7,20,.350,.318,1,2,.500,7,17,24,7,3,5,4,7,15,20
Jordan Bell,C,26,WAS,5,1,67,7,20,.350,0,2,0,7,18,.389,.350,0,0,0,6,13,19,5,3,3,3,5,14,20
Jordan Bell,C,26,GSW,1,0,15,0,2,0,0,0,0,0,2,0,0,1,2,.500,1,4,5,2,0,2,1,2,1,20
DeAndre' Bembry,SF,26,TOR,51,12,972,117,228,.513,14,53,.264,103,175,.589,.544,45,66,.682,33,113,146,107,53,18,71,87,293,20
Dāvis Bertāns,PF,28,WAS,57,7,1464,193,478,.404,169,428,.395,24,50,.480,.581,100,115,.870,18,150,168,49,33,13,33,136,655,20
Patrick Beverley,PG,32,LAC,37,34,832,93,220,.423,56,141,.397,37,79,.468,.550,36,45,.800,29,90,119,76,29,28,34,108,278,20
Saddiq Bey,SF,21,DET,70,53,1909,279,691,.404,175,460,.380,104,231,.450,.530,124,147,.844,43,275,318,95,52,14,60,110,857,20
Tyler Bey,SF,22,DAL,18,0,71,7,22,.318,1,4,.250,6,18,.333,.341,3,5,.600,8,11,19,3,0,1,3,6,18,20
Khem Birch,C,28,TOT,67,22,1529,189,380,.497,13,52,.250,176,328,.537,.514,91,129,.705,174,213,387,89,48,50,44,113,482,20
Khem Birch,C,28,ORL,48,5,952,94,209,.450,4,21,.190,90,188,.479,.459,63,85,.741,117,126,243,53,32,28,23,67,255,20
Khem Birch,C,28,TOR,19,17,577,95,171,.556,9,31,.290,86,140,.614,.582,28,44,.636,57,87,144,36,16,22,21,46,227,20
Goga Bitadze,C,21,IND,45,3,561,83,194,.428,20,79,.253,63,115,.548,.479,45,61,.738,60,90,150,37,9,60,17,94,231,20
Bismack Biyombo,C,28,CHO,66,36,1349,142,242,.587,0,1,0,142,241,.589,.587,47,105,.448,137,210,347,81,17,74,71,141,331,20
Nemanja Bjelica,PF,32,TOT,37,3,595,89,196,.454,27,85,.318,62,111,.559,.523,37,51,.725,29,98,127,69,15,5,33,68,242,20
Nemanja Bjelica,PF,32,SAC,26,1,439,69,150,.460,17,58,.293,52,92,.565,.517,32,42,.762,24,76,100,49,8,2,28,48,187,20
Nemanja Bjelica,PF,32,MIA,11,2,156,20,46,.435,10,27,.370,10,19,.526,.543,5,9,.556,5,22,27,20,7,3,5,20,55,20
Eric Bledsoe,SG,31,NOP,71,70,2111,307,730,.421,121,355,.341,186,375,.496,.503,134,195,.687,29,215,244,268,55,24,114,112,869,20
Keljin Blevins,SF,25,POR,17,0,75,5,20,.250,2,8,.250,3,12,.250,.300,0,0,0,3,7,10,4,2,0,5,8,12,20
Bogdan Bogdanović,SG,28,ATL,44,27,1305,267,565,.473,146,333,.438,121,232,.522,.602,40,44,.909,20,140,160,147,49,13,54,99,720,20
Bojan Bogdanović,SF,31,UTA,72,72,2216,406,925,.439,180,461,.390,226,464,.487,.536,233,265,.879,40,241,281,136,45,4,128,115,1225,20
Bol Bol,PF,21,DEN,32,2,160,25,58,.431,9,24,.375,16,34,.471,.509,10,15,.667,0,24,24,7,3,10,13,14,69,20
Marques Bolden,C,22,CLE,6,0,29,1,3,.333,0,0,0,1,3,.333,.333,5,8,.625,3,3,6,0,2,2,2,0,7,20
Jordan Bone,PG,23,ORL,14,0,196,23,54,.426,10,32,.313,13,22,.591,.519,0,0,0,4,20,24,18,2,0,3,11,56,20
Isaac Bonga,SF,21,WAS,40,8,432,30,81,.370,13,47,.277,17,34,.500,.451,5,8,.625,18,48,66,23,11,9,22,63,78,20
Devin Booker,SG,24,PHO,67,67,2270,623,1287,.484,126,371,.340,497,916,.543,.533,340,392,.867,34,247,281,289,53,16,207,181,1712,20
Chris Boucher,C,28,TOR,60,14,1453,288,560,.514,90,235,.383,198,325,.609,.595,152,193,.788,117,287,404,63,35,111,46,166,818,20
Brian Bowen,SF,22,IND,6,0,15,1,4,.250,0,1,0,1,3,.333,.250,1,1,1.000,0,3,3,0,0,0,0,1,3,20
Avery Bradley,SG,30,TOT,27,6,602,64,171,.374,33,101,.327,31,70,.443,.471,12,15,.800,8,49,57,46,21,3,28,55,173,20
Avery Bradley,SG,30,MIA,10,1,211,31,66,.470,16,38,.421,15,28,.536,.591,7,9,.778,2,16,18,14,7,1,9,26,85,20
Avery Bradley,SG,30,HOU,17,5,391,33,105,.314,17,63,.270,16,42,.381,.395,5,6,.833,6,33,39,32,14,2,19,29,88,20
Tony Bradley,C,23,TOT,42,8,684,131,197,.665,0,3,0,131,194,.675,.665,38,55,.691,85,154,239,37,15,30,33,61,300,20
Tony Bradley,C,23,PHI,20,8,287,51,75,.680,0,1,0,51,74,.689,.680,7,11,.636,39,65,104,17,6,13,6,28,109,20
Tony Bradley,C,23,OKC,22,0,397,80,122,.656,0,2,0,80,120,.667,.656,31,44,.705,46,89,135,20,9,17,27,33,191,20
Jarrell Brantley,PF,24,UTA,28,0,138,25,52,.481,12,28,.429,13,24,.542,.596,2,2,1.000,9,18,27,15,7,2,8,17,64,20
Ignas Brazdeikis,SF,22,TOT,13,0,249,35,83,.422,11,28,.393,24,55,.436,.488,10,14,.714,11,34,45,17,4,3,12,22,91,20
Ignas Brazdeikis,SF,22,NYK,4,0,7,0,1,0,0,0,0,0,1,0,0,2,2,1.000,1,1,2,1,0,0,1,0,2,20
Ignas Brazdeikis,SF,22,PHI,1,0,8,0,3,0,0,1,0,0,2,0,0,0,0,0,0,2,2,0,0,0,0,0,0,20
Ignas Brazdeikis,SF,22,ORL,8,0,234,35,79,.443,11,27,.407,24,52,.462,.513,8,12,.667,10,31,41,16,4,3,11,22,89,20
Mikal Bridges,SF,24,PHO,72,72,2348,363,669,.543,134,315,.425,229,354,.647,.643,110,131,.840,76,233,309,152,76,63,57,116,970,20
Miles Bridges,PF,22,CHO,66,19,1932,313,622,.503,116,290,.400,197,332,.593,.596,98,113,.867,81,316,397,147,44,52,106,143,840,20
Amida Brimah,C,26,IND,5,0,29,5,8,.625,0,0,0,5,8,.625,.625,3,3,1.000,2,6,8,1,0,5,4,4,13,20
Oshae Brissett,SF,22,IND,21,16,519,73,151,.483,33,78,.423,40,73,.548,.593,50,65,.769,29,86,115,18,19,20,10,32,229,20
Malcolm Brogdon,PG,28,IND,56,56,1930,444,980,.453,145,374,.388,299,606,.493,.527,153,177,.864,58,236,294,329,49,15,115,110,1186,20
Armoni Brooks,SG,22,HOU,20,5,520,78,192,.406,60,157,.382,18,35,.514,.563,7,12,.583,10,58,68,30,12,5,22,34,223,20
Dillon Brooks,SF,25,MEM,67,67,1997,432,1031,.419,128,372,.344,304,659,.461,.481,159,195,.815,53,143,196,157,78,26,119,237,1151,20
Bruce Brown,PG,24,BRK,65,37,1451,235,423,.556,17,59,.288,218,364,.599,.576,86,117,.735,111,238,349,104,58,28,54,145,573,20
Charlie Brown Jr.,SG,23,OKC,9,1,152,13,43,.302,5,21,.238,8,22,.364,.360,9,10,.900,3,14,17,9,4,2,6,19,40,20
Jaylen Brown,SG,24,BOS,58,58,1999,538,1111,.484,163,411,.397,375,700,.536,.558,191,250,.764,71,276,347,195,72,32,158,168,1430,20
Moses Brown,C,21,OKC,43,32,920,146,268,.545,0,0,0,146,268,.545,.545,78,126,.619,154,229,383,10,31,47,43,93,370,20
Sterling Brown,SG,25,HOU,51,14,1229,150,335,.448,91,215,.423,59,120,.492,.584,25,31,.806,38,186,224,72,38,12,41,97,416,20
Troy Brown Jr.,SF,21,TOT,34,0,524,62,144,.431,22,70,.314,40,74,.541,.507,15,21,.714,20,85,105,29,10,6,21,49,161,20
Troy Brown Jr.,SF,21,WAS,21,0,287,33,89,.371,14,46,.304,19,43,.442,.449,10,15,.667,11,50,61,19,3,4,16,29,90,20
Troy Brown Jr.,SF,21,CHI,13,0,237,29,55,.527,8,24,.333,21,31,.677,.600,5,6,.833,9,35,44,10,7,2,5,20,71,20
Jalen Brunson,PG,24,DAL,68,12,1697,328,627,.523,81,200,.405,247,427,.578,.588,120,151,.795,27,204,231,239,35,1,80,109,857,20
Elijah Bryant,SG,25,MIL,1,0,32,6,13,.462,1,5,.200,5,8,.625,.500,3,3,1.000,2,4,6,3,0,1,4,4,16,20
Thomas Bryant,C,23,WAS,10,10,271,59,91,.648,9,21,.429,50,70,.714,.698,16,24,.667,18,43,61,15,4,8,11,31,143,20
Reggie Bullock,SF,29,NYK,65,64,1949,248,561,.442,163,398,.410,85,163,.521,.587,50,55,.909,16,207,223,99,52,11,45,146,709,20
Trey Burke,PG,28,DAL,62,1,911,151,353,.428,58,164,.354,93,189,.492,.510,51,57,.895,10,44,54,81,36,7,33,64,411,20
Alec Burks,SG,29,NYK,49,5,1255,210,500,.420,102,246,.415,108,254,.425,.522,101,118,.856,21,206,227,107,31,14,49,102,623,20
Jimmy Butler,SF,31,MIA,52,52,1745,366,736,.497,25,102,.245,341,634,.538,.514,359,416,.863,94,265,359,369,108,18,109,71,1116,20
Bruno Caboclo,PF,25,HOU,6,0,36,8,17,.471,0,5,0,8,12,.667,.471,1,2,.500,3,11,14,1,0,2,4,6,17,20
Devontae Cacok,PF,24,LAL,20,1,98,17,29,.586,0,0,0,17,29,.586,.586,5,11,.455,12,20,32,1,5,4,5,8,39,20
Kentavious Caldwell-Pope,SG,27,LAL,67,67,1902,218,506,.431,120,293,.410,98,213,.460,.549,97,112,.866,27,152,179,127,62,26,66,114,653,20
Facundo Campazzo,PG,29,DEN,65,19,1425,120,315,.381,76,216,.352,44,99,.444,.502,80,91,.879,22,112,134,232,79,14,73,132,396,20
Vlatko Čančar,PF,23,DEN,41,1,281,33,72,.458,9,33,.273,24,39,.615,.521,10,13,.769,11,39,50,14,11,2,14,18,85,20
Devin Cannady,PG,24,ORL,8,0,74,11,28,.393,6,16,.375,5,12,.417,.500,6,7,.857,0,5,5,1,5,1,2,9,34,20
Clint Capela,C,26,ATL,63,63,1898,413,695,.594,0,0,0,413,695,.594,.594,130,227,.573,297,606,903,49,44,129,73,145,956,20
Vernon Carey Jr.,C,19,CHO,19,4,115,18,36,.500,1,7,.143,17,29,.586,.514,9,11,.818,6,21,27,2,1,5,5,13,46,20
Jevon Carter,PG,25,PHO,60,1,717,94,223,.422,56,151,.371,38,72,.528,.547,4,7,.571,16,76,92,71,29,9,16,56,248,20
Wendell Carter Jr.,C,21,TOT,54,44,1375,230,457,.503,15,51,.294,215,406,.530,.520,131,179,.732,132,311,443,104,35,42,78,146,606,20
Wendell Carter Jr.,C,21,CHI,32,25,792,129,252,.512,8,22,.364,121,230,.526,.528,82,111,.739,70,180,250,69,18,24,49,96,348,20
Wendell Carter Jr.,C,21,ORL,22,19,583,101,205,.493,7,29,.241,94,176,.534,.510,49,68,.721,62,131,193,35,17,18,29,50,258,20
Michael Carter-Williams,SG,29,ORL,31,25,800,105,270,.389,15,61,.246,90,209,.431,.417,49,80,.613,39,100,139,129,25,17,69,81,274,20
Alex Caruso,PG,26,LAL,58,6,1216,133,305,.436,55,137,.401,78,168,.464,.526,49,76,.645,31,139,170,160,64,15,76,108,370,20
Willie Cauley-Stein,C,27,DAL,53,16,906,115,182,.632,1,11,.091,114,171,.667,.635,49,78,.628,66,170,236,35,21,43,29,129,280,20
Chris Chiozza,PG,25,BRK,22,1,232,31,88,.352,13,42,.310,18,46,.391,.426,13,17,.765,3,21,24,65,7,6,16,19,88,20
Marquese Chriss,PF,23,GSW,2,0,27,5,14,.357,1,5,.200,4,9,.444,.393,2,4,.500,3,10,13,2,0,2,2,3,13,20
Gary Clark,SF-PF,26,TOT,39,11,654,40,132,.303,31,108,.287,9,24,.375,.420,8,10,.800,33,82,115,31,13,7,17,35,119,20
Gary Clark,SF,26,ORL,35,11,637,40,131,.305,31,108,.287,9,23,.391,.424,8,10,.800,33,79,112,30,12,7,17,34,119,20
Gary Clark,SF,26,DEN,2,0,4,0,0,0,0,0,0,0,0,0,0,0,0,0,0,1,1,0,0,0,0,0,0,20
Gary Clark,PF,26,PHI,2,0,13,0,1,0,0,0,0,0,1,0,0,0,0,0,0,2,2,1,1,0,0,1,0,20
Brandon Clarke,PF,24,MEM,59,16,1415,256,495,.517,20,77,.260,236,418,.565,.537,78,113,.690,97,231,328,95,60,51,33,84,610,20
Jordan Clarkson,SG,28,UTA,68,1,1818,457,1075,.425,208,599,.347,249,476,.523,.522,129,144,.896,47,227,274,168,61,10,115,110,1251,20
Nic Claxton,C,21,BRK,32,1,594,90,145,.621,1,5,.200,89,140,.636,.624,31,64,.484,43,123,166,28,23,40,18,68,212,20
Amir Coffey,SG,23,LAC,44,1,394,45,103,.437,23,56,.411,22,47,.468,.549,27,38,.711,10,34,44,22,10,0,15,30,140,20
John Collins,PF,23,ATL,63,63,1848,429,771,.556,83,208,.399,346,563,.615,.610,170,204,.833,118,349,467,78,34,63,84,193,1111,20
Mike Conley,PG,33,UTA,51,51,1498,284,640,.444,138,335,.412,146,305,.479,.552,121,142,.852,36,141,177,305,70,9,99,98,827,20
Pat Connaughton,SG,28,MIL,69,4,1575,168,387,.434,101,272,.371,67,115,.583,.565,31,40,.775,63,269,332,81,49,23,33,99,468,20
Quinn Cook,PG,27,TOT,23,0,157,29,68,.426,11,26,.423,18,42,.429,.507,7,8,.875,2,15,17,18,4,1,7,10,76,20
Quinn Cook,PG,27,LAL,16,0,62,12,26,.462,5,13,.385,7,13,.538,.558,4,5,.800,0,5,5,5,1,1,3,2,33,20
Quinn Cook,PG,27,CLE,7,0,95,17,42,.405,6,13,.462,11,29,.379,.476,3,3,1.000,2,10,12,13,3,0,4,8,43,20
Tyler Cook,SF-PF,23,TOT,32,1,438,69,103,.670,1,2,.500,68,101,.673,.675,17,35,.486,28,67,95,17,8,2,21,35,156,20
Tyler Cook,PF,23,BRK,4,0,17,1,3,.333,0,0,0,1,3,.333,.333,0,0,0,1,1,2,2,0,0,1,2,2,20
Tyler Cook,SF,23,DET,28,1,421,68,100,.680,1,2,.500,67,98,.684,.685,17,35,.486,27,66,93,15,8,2,20,33,154,20
DeMarcus Cousins,C,30,TOT,41,11,713,130,305,.426,47,135,.348,83,170,.488,.503,59,81,.728,53,210,263,76,34,24,64,107,366,20
DeMarcus Cousins,C,30,HOU,25,11,506,79,210,.376,39,116,.336,40,94,.426,.469,44,59,.746,30,161,191,60,21,18,39,74,241,20
DeMarcus Cousins,C,30,LAC,16,0,207,51,95,.537,8,19,.421,43,76,.566,.579,15,22,.682,23,49,72,16,13,6,25,33,125,20
Robert Covington,PF,30,POR,70,70,2243,204,509,.401,135,356,.379,69,153,.451,.533,50,62,.806,61,405,466,117,101,84,64,195,593,20
Torrey Craig,SF,30,TOT,50,8,803,109,227,.480,39,106,.368,70,121,.579,.566,17,22,.773,57,140,197,49,28,26,25,83,274,20
Torrey Craig,SF,30,MIL,18,0,201,18,46,.391,8,22,.364,10,24,.417,.478,1,2,.500,13,30,43,16,9,7,5,24,45,20
Torrey Craig,SF,30,PHO,32,8,602,91,181,.503,31,84,.369,60,97,.619,.588,16,20,.800,44,110,154,33,19,19,20,59,229,20
Jae Crowder,PF,30,PHO,60,42,1648,199,492,.404,148,380,.389,51,112,.455,.555,57,75,.760,32,250,282,127,48,27,55,125,603,20
Jarrett Culver,SG,21,MIN,34,7,499,69,168,.411,13,53,.245,56,115,.487,.449,29,48,.604,34,70,104,24,17,9,28,58,180,20
Seth Curry,SG,30,PHI,57,57,1638,258,552,.467,126,280,.450,132,272,.485,.582,69,77,.896,10,126,136,155,44,8,65,96,711,20
Stephen Curry,PG,32,GSW,63,63,2152,658,1365,.482,337,801,.421,321,564,.569,.605,362,395,.916,29,316,345,363,77,8,213,119,2015,20
Nate Darling,SG,22,CHO,7,0,26,2,7,.286,2,7,.286,0,0,0,.429,3,3,1.000,1,0,1,1,0,1,1,1,9,20
Anthony Davis,PF,27,LAL,36,36,1162,301,613,.491,26,100,.260,275,513,.536,.512,158,214,.738,62,224,286,110,45,59,74,60,786,20
Ed Davis,C,31,MIN,23,7,299,19,44,.432,0,0,0,19,44,.432,.432,10,12,.833,46,69,115,21,13,13,7,56,48,20
Terence Davis,SG,23,TOT,61,4,1074,195,456,.428,98,267,.367,97,189,.513,.535,45,55,.818,20,134,154,83,44,14,63,97,533,20
Terence Davis,SG,23,TOR,34,4,493,87,210,.414,44,122,.361,43,88,.489,.519,16,18,.889,9,57,66,37,17,7,29,48,234,20
Terence Davis,SG,23,SAC,27,0,581,108,246,.439,54,145,.372,54,101,.535,.549,29,37,.784,11,77,88,46,27,7,34,49,299,20
Gabriel Deck,PF,25,OKC,10,0,212,32,67,.478,2,15,.133,30,52,.577,.493,18,22,.818,16,24,40,24,8,0,6,9,84,20
Dewayne Dedmon,C,31,MIA,16,0,210,46,65,.708,1,5,.200,45,60,.750,.715,20,27,.741,28,58,86,12,9,6,13,36,113,20
Matthew Dellavedova,PG,30,CLE,13,1,224,14,56,.250,4,25,.160,10,31,.323,.286,4,4,1.000,6,18,24,58,4,1,6,21,36,20
DeMar DeRozan,PF,31,SAS,61,61,2056,455,920,.495,19,74,.257,436,846,.515,.505,387,440,.880,40,219,259,422,56,15,119,128,1316,20
Mamadi Diakite,PF,24,MIL,14,1,141,16,40,.400,1,8,.125,15,32,.469,.413,11,14,.786,8,26,34,8,7,6,3,16,44,20
Hamidou Diallo,SG-SF,22,TOT,52,9,1226,224,470,.477,28,82,.341,196,388,.505,.506,128,200,.640,59,213,272,101,41,24,76,134,604,20
Hamidou Diallo,SG,22,OKC,32,5,761,143,297,.481,12,41,.293,131,256,.512,.502,83,132,.629,37,128,165,77,31,12,49,83,381,20
Hamidou Diallo,SF,22,DET,20,4,465,81,173,.468,16,41,.390,65,132,.492,.514,45,68,.662,22,85,107,24,10,12,27,51,223,20
Gorgui Dieng,C,31,TOT,38,1,552,85,163,.521,30,70,.429,55,93,.591,.613,58,67,.866,40,100,140,48,26,16,32,56,258,20
Gorgui Dieng,C,31,MEM,22,1,371,56,108,.519,23,48,.479,33,60,.550,.625,38,43,.884,28,70,98,29,17,14,22,38,173,20
Gorgui Dieng,C,31,SAS,16,0,181,29,55,.527,7,22,.318,22,33,.667,.591,20,24,.833,12,30,42,19,9,2,10,18,85,20
Spencer Dinwiddie,SG,27,BRK,3,3,64,6,16,.375,2,7,.286,4,9,.444,.438,6,6,1.000,0,13,13,9,2,1,5,4,20,20
Donte DiVincenzo,SG,24,MIL,66,66,1814,253,603,.420,131,346,.379,122,257,.475,.528,51,71,.718,81,299,380,203,72,15,91,112,688,20
Luka Dončić,PG,21,DAL,66,66,2262,647,1351,.479,192,548,.350,455,803,.567,.550,344,471,.730,54,473,527,567,64,36,281,152,1830,20
Luguentz Dort,SG,21,OKC,52,52,1543,247,639,.387,113,329,.343,134,310,.432,.475,122,164,.744,38,151,189,88,45,19,79,134,729,20
Damyean Dotson,SG,26,CLE,46,7,907,119,293,.406,46,159,.289,73,134,.545,.485,24,36,.667,5,88,93,91,16,4,42,42,308,20
Devon Dotson,PG,21,CHI,11,0,50,11,21,.524,1,7,.143,10,14,.714,.548,0,0,0,2,3,5,7,4,0,0,3,23,20
Sekou Doumbouya,PF,20,DET,56,11,869,107,282,.379,26,115,.226,81,167,.485,.426,45,64,.703,39,104,143,47,24,9,44,94,285,20
PJ Dozier,SG,24,DEN,50,6,1088,148,355,.417,47,149,.315,101,206,.490,.483,42,66,.636,35,147,182,92,31,22,46,86,385,20
Goran Dragić,PG,34,MIA,50,11,1337,240,555,.432,91,244,.373,149,311,.479,.514,101,122,.828,25,144,169,219,33,8,118,113,672,20
Andre Drummond,C,27,TOT,46,46,1242,282,572,.493,0,8,0,282,564,.500,.493,123,205,.600,166,385,551,94,63,49,124,149,687,20
Andre Drummond,C,27,CLE,25,25,722,180,380,.474,0,8,0,180,372,.484,.474,77,129,.597,101,236,337,64,40,29,81,69,437,20
Andre Drummond,C,27,LAL,21,21,520,102,192,.531,0,0,0,102,192,.531,.531,46,76,.605,65,149,214,30,23,20,43,80,250,20
Jared Dudley,PF,35,LAL,12,0,81,2,9,.222,2,6,.333,0,3,0,.333,0,0,0,4,17,21,5,1,1,2,7,6,20
Kris Dunn,PG,26,ATL,4,0,45,1,12,.083,0,2,0,1,10,.100,.083,3,4,.750,0,6,6,2,2,2,3,10,5,20
Kevin Durant,PF,32,BRK,35,32,1157,324,603,.537,85,189,.450,239,414,.577,.608,210,238,.882,13,234,247,195,25,45,120,70,943,20
Anthony Edwards,SG,19,MIN,72,55,2314,505,1211,.417,171,520,.329,334,691,.483,.488,211,272,.776,59,277,336,211,82,36,160,129,1392,20
Carsen Edwards,SG,22,BOS,31,1,276,47,111,.423,18,63,.286,29,48,.604,.505,11,13,.846,3,23,26,14,7,1,7,25,123,20
CJ Elleby,SF,20,POR,30,0,192,25,66,.379,7,34,.206,18,32,.563,.432,11,15,.733,11,21,32,10,6,3,5,27,68,20
Henry Ellenson,PF,24,TOR,2,0,38,5,14,.357,2,9,.222,3,5,.600,.429,3,4,.750,3,9,12,5,0,0,0,7,15,20
Wayne Ellington,SG,33,DET,46,31,1012,149,338,.441,116,275,.422,33,63,.524,.612,28,35,.800,12,73,85,67,18,9,33,59,442,20
Joel Embiid,C,26,PHI,51,51,1585,461,899,.513,58,154,.377,403,745,.541,.545,471,548,.859,113,426,539,145,50,69,159,123,1451,20
James Ennis III,SF,30,ORL,41,37,986,115,243,.473,45,104,.433,70,139,.504,.566,70,87,.805,43,123,166,62,32,7,36,84,345,20
Drew Eubanks,C,23,SAS,54,3,755,116,205,.566,2,2,1.000,114,203,.562,.571,77,106,.726,74,167,241,42,18,49,45,88,311,20
Dante Exum,SG,25,CLE,6,3,116,10,26,.385,2,11,.182,8,15,.533,.423,1,2,.500,2,15,17,13,4,2,7,9,23,20
Tacko Fall,C,25,BOS,19,0,136,21,29,.724,0,0,0,21,29,.724,.724,5,15,.333,16,36,52,3,1,20,6,22,47,20
Derrick Favors,C,29,UTA,68,0,1039,155,243,.638,0,2,0,155,241,.643,.638,59,80,.738,138,238,376,44,32,68,36,143,369,20
Cristiano Felício,C,28,CHI,18,0,84,7,13,.538,0,2,0,7,11,.636,.538,9,16,.563,10,16,26,9,4,0,4,10,23,20
Terrance Ferguson,SG,22,PHI,13,0,49,1,7,.143,0,5,0,1,2,.500,.143,0,0,0,0,1,1,2,1,0,4,7,2,20
Bruno Fernando,C,22,ATL,33,0,226,18,44,.409,0,2,0,18,42,.429,.409,15,22,.682,16,62,78,10,4,3,21,23,51,20
Yogi Ferrell,PG,27,TOT,10,0,136,20,57,.351,9,28,.321,11,29,.379,.430,7,9,.778,5,14,19,22,7,3,3,11,56,20
Yogi Ferrell,PG,27,CLE,2,0,40,8,21,.381,3,9,.333,5,12,.417,.452,0,2,0,3,4,7,5,3,1,3,4,19,20
Yogi Ferrell,PG,27,LAC,8,0,96,12,36,.333,6,19,.316,6,17,.353,.417,7,7,1.000,2,10,12,17,4,2,0,7,37,20
Dorian Finney-Smith,PF,27,DAL,60,60,1921,220,466,.472,119,302,.394,101,164,.616,.600,31,41,.756,98,228,326,102,52,25,48,138,590,20
Malik Fitts,PF,23,LAC,3,0,11,1,3,.333,1,2,.500,0,1,0,.500,0,0,0,0,3,3,0,0,0,0,3,3,20
Malachi Flynn,PG,22,TOR,47,14,928,127,340,.374,54,168,.321,73,172,.424,.453,45,56,.804,10,106,116,137,38,7,43,68,353,20
Bryn Forbes,SG,27,MIL,70,10,1354,250,529,.473,154,341,.452,96,188,.511,.618,47,61,.770,11,101,112,45,24,1,44,77,701,20
Trent Forrest,PG,22,UTA,30,0,302,32,71,.451,5,26,.192,27,45,.600,.486,19,19,1.000,11,33,44,45,9,4,21,22,88,20
Evan Fournier,SF-SG,28,TOT,42,36,1259,247,541,.457,117,283,.413,130,258,.504,.565,108,137,.788,10,118,128,144,47,19,73,96,719,20
Evan Fournier,SF,28,ORL,26,26,787,170,369,.461,73,188,.388,97,181,.536,.560,98,123,.797,5,70,75,95,27,9,54,55,511,20
Evan Fournier,SG,28,BOS,16,10,472,77,172,.448,44,95,.463,33,77,.429,.576,10,14,.714,5,48,53,49,20,10,19,41,208,20
De'Aaron Fox,PG,23,SAC,58,58,2036,529,1110,.477,103,320,.322,426,790,.539,.523,300,417,.719,33,170,203,417,87,27,174,170,1461,20
Robert Franks,PF,24,ORL,7,0,101,13,28,.464,5,15,.333,8,13,.615,.554,12,13,.923,6,8,14,5,3,3,2,8,43,20
Tim Frazier,PG,30,MEM,5,0,62,3,20,.150,0,8,0,3,12,.250,.150,2,6,.333,0,8,8,16,2,1,4,7,8,20
Enes Freedom,C,28,POR,72,35,1758,339,561,.604,1,4,.250,338,557,.607,.605,127,164,.774,284,511,795,84,33,48,78,168,806,20
Markelle Fultz,PG,22,ORL,8,8,215,41,104,.394,4,16,.250,37,88,.420,.413,17,19,.895,5,20,25,43,8,2,18,18,103,20
Wenyen Gabriel,PF,23,NOP,21,0,241,24,60,.400,13,32,.406,11,28,.393,.508,11,17,.647,20,34,54,11,9,8,15,32,72,20
Daniel Gafford,PF-C,22,TOT,54,11,791,154,225,.684,0,0,0,154,225,.684,.684,72,108,.667,94,137,231,29,26,75,41,98,380,20
Daniel Gafford,PF,22,CHI,31,11,383,60,87,.690,0,0,0,60,87,.690,.690,27,41,.659,44,59,103,17,11,34,22,54,147,20
Daniel Gafford,C,22,WAS,23,0,408,94,138,.681,0,0,0,94,138,.681,.681,45,67,.672,50,78,128,12,15,41,19,44,233,20
Danilo Gallinari,PF,32,ATL,51,4,1222,206,475,.434,103,254,.406,103,221,.466,.542,161,174,.925,17,194,211,76,30,10,43,105,676,20
Langston Galloway,SG,29,PHO,40,0,438,66,147,.449,36,85,.424,30,62,.484,.571,22,23,.957,7,35,42,26,8,0,13,25,190,20
Darius Garland,PG,21,CLE,54,50,1790,362,802,.451,105,266,.395,257,536,.479,.517,112,132,.848,23,106,129,329,66,6,164,110,941,20
Marc Gasol,C,36,LAL,52,42,993,88,194,.454,50,122,.410,38,72,.528,.582,36,50,.720,38,177,215,109,26,58,53,115,262,20
Rudy Gay,PF,34,SAS,63,1,1358,264,628,.420,106,278,.381,158,350,.451,.505,82,102,.804,42,261,303,88,45,40,65,115,716,20
Paul George,SF,30,LAC,54,54,1821,445,953,.467,171,416,.411,274,537,.510,.557,198,228,.868,45,314,359,280,62,24,179,132,1259,20
Taj Gibson,C,35,NYK,45,3,936,99,158,.627,3,15,.200,96,143,.671,.636,40,55,.727,99,151,250,36,31,49,22,99,241,20
Harry Giles,C,22,POR,38,0,348,42,97,.433,8,23,.348,34,74,.459,.474,16,27,.593,31,102,133,29,8,13,20,54,108,20
Shai Gilgeous-Alexander,SG,22,OKC,35,35,1180,287,565,.508,71,170,.418,216,395,.547,.571,185,229,.808,19,147,166,207,27,23,106,70,830,20
Anthony Gill,PF,28,WAS,26,4,218,30,60,.500,7,24,.292,23,36,.639,.558,13,16,.813,16,35,51,11,10,4,8,27,80,20
Freddie Gillespie,PF,23,TOR,20,2,392,44,84,.524,0,0,0,44,84,.524,.524,23,33,.697,42,55,97,9,13,20,12,43,111,20
Rudy Gobert,C,28,UTA,71,71,2187,391,579,.675,0,4,0,391,575,.680,.675,233,374,.623,240,720,960,89,40,190,118,163,1015,20
Brandon Goodwin,PG,25,ATL,47,5,620,84,223,.377,32,103,.311,52,120,.433,.448,28,43,.651,8,61,69,95,17,0,36,41,228,20
Aaron Gordon,PF,25,TOT,50,50,1384,231,499,.463,59,176,.335,172,323,.533,.522,97,149,.651,77,207,284,161,33,34,97,89,618,20
Aaron Gordon,PF,25,ORL,25,25,736,128,293,.437,42,112,.375,86,181,.475,.509,66,105,.629,39,127,166,105,16,20,67,49,364,20
Aaron Gordon,PF,25,DEN,25,25,648,103,206,.500,17,64,.266,86,142,.606,.541,31,44,.705,38,80,118,56,17,14,30,40,254,20
Eric Gordon,SG,32,HOU,27,13,789,159,367,.433,69,210,.329,90,157,.573,.527,94,114,.825,8,50,58,71,14,13,51,44,481,20
Devonte' Graham,PG,25,CHO,55,44,1659,252,669,.377,179,477,.375,73,192,.380,.510,133,158,.842,22,126,148,295,48,6,84,77,816,20
Jerami Grant,SF,26,DET,54,54,1829,400,932,.429,115,329,.350,285,603,.473,.491,290,343,.845,35,215,250,152,35,58,109,125,1205,20
Danny Green,SF,33,PHI,69,69,1934,224,544,.412,175,432,.405,49,112,.438,.573,31,40,.775,55,205,260,118,92,56,67,125,654,20
Draymond Green,PF,30,GSW,63,63,1982,170,380,.447,34,126,.270,136,254,.535,.492,70,88,.795,55,394,449,558,105,52,188,194,444,20
JaMychal Green,PF,30,DEN,58,5,1120,173,374,.463,79,198,.399,94,176,.534,.568,46,57,.807,85,192,277,53,26,22,53,144,471,20
Javonte Green,SF-SG,27,TOT,41,2,473,53,102,.520,10,30,.333,43,72,.597,.569,30,40,.750,26,45,71,17,28,6,19,45,146,20
Javonte Green,SF,27,BOS,25,2,345,39,71,.549,7,22,.318,32,49,.653,.599,20,30,.667,20,32,52,11,18,2,13,32,105,20
Javonte Green,SG,27,CHI,16,0,128,14,31,.452,3,8,.375,11,23,.478,.500,10,10,1.000,6,13,19,6,10,4,6,13,41,20
Jeff Green,PF,34,BRK,68,38,1835,261,530,.492,103,250,.412,158,280,.564,.590,125,161,.776,34,229,263,108,36,27,54,122,750,20
Josh Green,SG,20,DAL,39,5,445,42,93,.452,4,25,.160,38,68,.559,.473,13,23,.565,28,50,78,28,16,3,17,35,101,20
Blake Griffin,PF,31,TOT,46,30,1186,174,411,.423,70,205,.341,104,206,.505,.509,87,117,.744,35,190,225,140,32,15,62,111,505,20
Blake Griffin,PF,31,DET,20,20,626,81,222,.365,39,124,.315,42,98,.429,.453,44,62,.710,7,97,104,77,14,2,32,42,245,20
Blake Griffin,PF,31,BRK,26,10,560,93,189,.492,31,81,.383,62,108,.574,.574,43,55,.782,28,93,121,63,18,13,30,69,260,20
Kyle Guy,PG,23,SAC,31,0,235,29,88,.330,13,46,.283,16,42,.381,.403,16,20,.800,5,30,35,32,6,0,11,20,87,20
Rui Hachimura,PF,22,WAS,57,57,1797,310,648,.478,45,137,.328,265,511,.519,.513,124,161,.770,49,263,312,82,44,7,68,120,789,20
Ashton Hagans,PG,21,MIN,2,0,4,0,0,0,0,0,0,0,0,0,0,0,0,0,0,0,0,0,0,0,1,0,0,20
Tyrese Haliburton,PG,20,SAC,58,20,1746,292,619,.472,121,296,.409,171,323,.529,.569,48,56,.857,39,134,173,309,77,28,92,83,753,20
Donta Hall,PF,23,ORL,13,0,179,25,35,.714,0,0,0,25,35,.714,.714,23,34,.676,24,38,62,11,5,10,8,18,73,20
Josh Hall,SF,20,OKC,21,1,336,30,99,.303,4,37,.108,26,62,.419,.323,22,44,.500,6,53,59,28,4,1,25,37,86,20
R.J. Hampton,SG-PG,19,TOT,51,1,888,136,313,.435,27,87,.310,109,226,.482,.478,55,82,.671,29,150,179,87,21,10,53,61,354,20
R.J. Hampton,PG,19,DEN,25,0,233,25,60,.417,5,18,.278,20,42,.476,.458,9,12,.750,10,40,50,14,5,2,11,22,64,20
R.J. Hampton,SG,19,ORL,26,1,655,111,253,.439,22,69,.319,89,184,.484,.482,46,70,.657,19,110,129,73,16,8,42,39,290,20
Tim Hardaway Jr.,SG,28,DAL,70,31,1985,407,911,.447,207,529,.391,200,382,.524,.560,142,174,.816,20,209,229,126,31,11,64,111,1163,20
James Harden,PG,31,TOT,44,43,1609,342,734,.466,121,334,.362,221,400,.553,.548,278,323,.861,35,313,348,475,53,33,177,99,1083,20
James Harden,PG,31,HOU,8,8,290,60,135,.444,25,72,.347,35,63,.556,.537,53,60,.883,5,36,41,83,7,6,34,14,198,20
James Harden,PG,31,BRK,36,35,1319,282,599,.471,96,262,.366,186,337,.552,.551,225,263,.856,30,277,307,392,46,27,143,85,885,20
Maurice Harkless,PF-SF,27,TOT,37,23,772,69,165,.418,23,84,.274,46,81,.568,.488,33,43,.767,13,76,89,44,30,20,22,86,194,20
Maurice Harkless,SF,27,MIA,11,3,124,5,13,.385,5,11,.455,0,2,0,.577,0,2,0,2,11,13,7,2,4,3,14,15,20
Maurice Harkless,PF,27,SAC,26,20,648,64,152,.421,18,73,.247,46,79,.582,.480,33,41,.805,11,65,76,37,28,16,19,72,179,20
Jared Harper,PG,23,NYK,8,0,16,0,4,0,0,1,0,0,3,0,0,3,4,.750,0,2,2,1,0,0,3,1,3,20
Montrezl Harrell,C,27,LAL,69,1,1580,375,603,.622,0,10,0,375,593,.632,.622,181,256,.707,158,270,428,73,46,49,74,128,931,20
Gary Harris,SG,26,TOT,39,38,1080,138,345,.400,48,141,.340,90,204,.441,.470,64,78,.821,21,58,79,78,28,11,37,71,388,20
Gary Harris,SG,26,DEN,19,19,581,69,156,.442,24,75,.320,45,81,.556,.519,22,30,.733,13,34,47,32,17,4,14,37,184,20
Gary Harris,SG,26,ORL,20,19,499,69,189,.365,24,66,.364,45,123,.366,.429,42,48,.875,8,24,32,46,11,7,23,34,204,20
Jalen Harris,SG,22,TOR,13,2,172,36,72,.500,17,36,.472,19,36,.528,.618,7,9,.778,3,15,18,17,8,0,14,15,96,20
Joe Harris,SF,29,BRK,69,65,2141,357,707,.505,211,444,.475,146,263,.555,.654,49,63,.778,43,205,248,130,46,14,62,141,974,20
Tobias Harris,PF,28,PHI,62,62,2014,473,924,.512,82,208,.394,391,716,.546,.556,182,204,.892,62,357,419,220,55,51,107,119,1210,20
Shaquille Harrison,SG,27,TOT,34,0,333,26,78,.333,3,16,.188,23,62,.371,.353,18,22,.818,7,41,48,25,17,5,11,33,73,20
Shaquille Harrison,SG,27,UTA,17,0,56,6,20,.300,0,2,0,6,18,.333,.300,5,6,.833,3,6,9,9,2,0,5,3,17,20
Shaquille Harrison,SG,27,DEN,17,0,277,20,58,.345,3,14,.214,17,44,.386,.371,13,16,.813,4,35,39,16,15,5,6,30,56,20
Josh Hart,SF,25,NOP,47,4,1349,151,344,.439,63,193,.326,88,151,.583,.531,69,89,.775,53,324,377,109,38,12,49,111,434,20
Isaiah Hartenstein,C,22,TOT,46,2,559,94,171,.550,2,6,.333,92,165,.558,.556,46,71,.648,65,116,181,55,19,39,44,104,236,20
Isaiah Hartenstein,C,22,DEN,30,0,272,41,80,.513,0,0,0,41,80,.513,.513,22,36,.611,40,45,85,15,11,20,21,59,104,20
Isaiah Hartenstein,C,22,CLE,16,2,287,53,91,.582,2,6,.333,51,85,.600,.593,24,35,.686,25,71,96,40,8,19,23,45,132,20
Udonis Haslem,C,40,MIA,1,0,3,2,2,1.000,0,0,0,2,2,1.000,1.000,0,0,0,0,1,1,0,0,0,0,0,4,20
Jaxson Hayes,C,20,NOP,60,3,964,175,280,.625,6,14,.429,169,266,.635,.636,93,120,.775,92,165,257,35,25,38,39,101,449,20
Killian Hayes,PG,19,DET,26,18,670,71,201,.353,20,72,.278,51,129,.395,.403,14,17,.824,6,63,69,138,27,10,83,57,176,20
Gordon Hayward,SF,30,CHO,44,44,1496,311,658,.473,85,205,.415,226,453,.499,.537,156,185,.843,37,221,258,181,52,14,91,74,863,20
Juancho Hernangómez,PF,25,MIN,52,6,900,130,299,.435,55,168,.327,75,131,.573,.527,60,97,.619,45,160,205,35,19,7,27,52,375,20
Willy Hernangómez,C,26,NOP,47,12,846,151,268,.563,1,10,.100,150,258,.581,.565,62,93,.667,117,217,334,50,22,23,34,68,365,20
Tyler Herro,SG,21,MIA,54,15,1635,307,699,.439,107,297,.360,200,402,.498,.516,94,117,.803,25,243,268,184,35,17,101,71,815,20
Buddy Hield,SG,28,SAC,71,71,2433,403,992,.406,282,721,.391,121,271,.446,.548,88,104,.846,29,305,334,257,63,30,130,175,1176,20
George Hill,PG,34,TOT,30,17,672,95,197,.482,31,80,.388,64,117,.547,.561,40,50,.800,16,45,61,73,23,5,31,31,261,20
George Hill,PG,34,OKC,14,14,369,61,120,.508,22,57,.386,39,63,.619,.600,21,25,.840,8,21,29,43,12,2,12,12,165,20
George Hill,PG,34,PHI,16,3,303,34,77,.442,9,23,.391,25,54,.463,.500,19,25,.760,8,24,32,30,11,3,19,19,96,20
Solomon Hill,PF,29,ATL,71,16,1513,107,298,.359,68,212,.321,39,86,.453,.473,35,46,.761,42,172,214,75,50,11,42,116,317,20
Nate Hinton,SG,21,DAL,21,0,93,15,42,.357,4,19,.211,11,23,.478,.405,7,10,.700,1,8,9,8,7,2,5,8,41,20
Jaylen Hoard,SF,21,OKC,19,0,320,44,88,.500,0,11,0,44,77,.571,.500,28,41,.683,21,44,65,24,13,5,17,19,116,20
Aaron Holiday,PG,24,IND,66,8,1176,170,436,.390,67,182,.368,103,254,.406,.467,68,83,.819,15,74,89,123,46,13,66,94,475,20
Jrue Holiday,PG,30,MIL,59,56,1907,414,823,.503,111,283,.392,303,540,.561,.570,107,136,.787,73,195,268,357,96,37,127,98,1046,20
Justin Holiday,SG,31,IND,72,52,2183,258,625,.413,173,453,.382,85,172,.494,.551,67,85,.788,32,224,256,119,74,41,54,135,756,20
Rondae Hollis-Jefferson,PF,26,POR,11,1,107,9,18,.500,0,1,0,9,17,.529,.500,9,16,.563,11,15,26,13,2,4,2,15,27,20
Richaun Holmes,C,27,SAC,61,61,1782,366,575,.637,2,11,.182,364,564,.645,.638,135,170,.794,144,360,504,101,39,96,75,213,869,20
Rodney Hood,SF,28,TOT,55,5,942,94,260,.362,34,113,.301,60,147,.408,.427,24,28,.857,23,80,103,53,24,7,36,74,246,20
Rodney Hood,SF,28,POR,38,5,726,73,201,.363,25,84,.298,48,117,.410,.425,9,12,.750,18,55,73,47,20,4,31,59,180,20
Rodney Hood,SF,28,TOR,17,0,216,21,59,.356,9,29,.310,12,30,.400,.432,15,16,.938,5,25,30,6,4,3,5,15,66,20
Al Horford,C,34,OKC,28,28,782,162,360,.450,56,152,.368,106,208,.510,.528,18,22,.818,29,159,188,94,25,26,29,48,398,20
Talen Horton-Tucker,SG,20,LAL,65,4,1304,224,489,.458,37,131,.282,187,358,.522,.496,100,129,.775,25,144,169,181,63,21,105,127,585,20
Danuel House Jr.,SF,27,HOU,36,23,932,110,272,.404,54,156,.346,56,116,.483,.504,41,63,.651,18,114,132,69,20,16,36,67,315,20
Dwight Howard,C,35,PHI,69,6,1196,178,303,.587,5,20,.250,173,283,.611,.596,121,210,.576,190,390,580,61,30,62,112,200,482,20
Markus Howard,SG,21,DEN,37,1,205,40,106,.377,18,65,.277,22,41,.537,.462,7,9,.778,1,20,21,18,4,1,18,23,105,20
Kevin Huerter,SG,22,ATL,69,49,2126,316,731,.432,140,386,.363,176,345,.510,.528,50,64,.781,38,193,231,241,82,18,79,165,822,20
Elijah Hughes,SF,22,UTA,18,0,64,10,30,.333,8,23,.348,2,7,.286,.467,3,4,.750,1,8,9,6,1,1,6,1,31,20
De'Andre Hunter,SF,23,ATL,23,19,678,120,248,.484,31,95,.326,89,153,.582,.546,73,85,.859,17,93,110,44,19,12,29,59,344,20
Chandler Hutchison,SF,24,TOT,25,1,346,39,103,.379,8,22,.364,31,81,.383,.417,21,25,.840,6,72,78,17,12,5,20,33,107,20
Chandler Hutchison,SF,24,CHI,7,0,64,5,18,.278,1,3,.333,4,15,.267,.306,2,2,1.000,1,19,20,4,1,0,5,9,13,20
Chandler Hutchison,SF,24,WAS,18,1,282,34,85,.400,7,19,.368,27,66,.409,.441,19,23,.826,5,53,58,13,11,5,15,24,94,20
Serge Ibaka,C,31,LAC,41,39,955,186,365,.510,39,115,.339,147,250,.588,.563,43,53,.811,73,202,275,74,9,47,44,76,454,20
Andre Iguodala,SF,37,MIA,63,5,1339,95,248,.383,60,182,.330,35,66,.530,.504,25,38,.658,38,183,221,142,57,35,67,90,275,20
Ersan İlyasova,PF,33,UTA,17,1,148,21,54,.389,18,41,.439,3,13,.231,.556,5,5,1.000,7,22,29,4,10,3,8,29,65,20
Joe Ingles,SF,33,UTA,67,30,1867,275,562,.489,183,406,.451,92,156,.590,.652,76,90,.844,27,217,244,318,45,12,117,120,809,20
Brandon Ingram,SF,23,NOP,61,61,2093,513,1101,.466,143,375,.381,370,726,.510,.531,281,320,.878,34,265,299,296,42,36,154,124,1450,20
Kyrie Irving,PG,28,BRK,54,54,1886,549,1086,.506,152,378,.402,397,708,.561,.576,201,218,.922,52,205,257,324,76,37,130,140,1451,20
Wes Iwundu,SF,26,TOT,41,4,539,34,102,.333,5,41,.122,29,61,.475,.358,26,31,.839,15,75,90,18,15,4,19,49,99,20
Wes Iwundu,SF,26,DAL,23,3,288,17,52,.327,3,23,.130,14,29,.483,.356,12,14,.857,6,38,44,10,9,3,6,26,49,20
Wes Iwundu,SF,26,NOP,18,1,251,17,50,.340,2,18,.111,15,32,.469,.360,14,17,.824,9,37,46,8,6,1,13,23,50,20
Frank Jackson,PG,22,DET,40,6,738,134,293,.457,61,150,.407,73,143,.510,.561,61,75,.813,15,71,86,36,15,1,34,53,390,20
Jaren Jackson Jr.,C,21,MEM,11,4,258,53,125,.424,17,60,.283,36,65,.554,.492,35,42,.833,17,45,62,12,12,18,15,42,158,20
Josh Jackson,SG,23,DET,62,25,1560,296,707,.419,77,257,.300,219,450,.487,.473,159,218,.729,57,197,254,143,53,47,142,178,828,20
Justin Jackson,SF,25,TOT,34,3,577,89,221,.403,36,117,.308,53,104,.510,.484,31,37,.838,16,61,77,52,15,2,32,32,245,20
Justin Jackson,SF,25,OKC,33,3,544,86,212,.406,34,111,.306,52,101,.515,.486,30,35,.857,14,57,71,51,15,2,31,31,236,20
Justin Jackson,SF,25,MIL,1,0,33,3,9,.333,2,6,.333,1,3,.333,.444,1,2,.500,2,4,6,1,0,0,1,1,9,20
Reggie Jackson,SG,30,LAC,67,43,1544,263,585,.450,122,282,.433,141,303,.465,.554,67,82,.817,24,168,192,205,41,7,74,127,715,20
Justin James,SF,24,SAC,36,0,310,52,111,.468,14,38,.368,38,73,.521,.532,21,36,.583,9,21,30,22,8,3,15,23,139,20
LeBron James,PG,36,LAL,45,45,1504,422,823,.513,104,285,.365,318,538,.591,.576,178,255,.698,29,317,346,350,48,25,168,70,1126,20
Mike James,PG,30,BRK,13,1,236,34,92,.370,11,31,.355,23,61,.377,.429,21,27,.778,3,29,32,54,6,1,20,10,100,20
DaQuan Jeffries,SG,23,TOT,31,5,493,50,120,.417,20,67,.299,30,53,.566,.500,7,8,.875,19,52,71,22,15,10,14,48,127,20
DaQuan Jeffries,SG,23,SAC,18,2,232,24,57,.421,9,28,.321,15,29,.517,.500,6,7,.857,9,20,29,6,7,4,8,23,63,20
DaQuan Jeffries,SG,23,HOU,13,3,261,26,63,.413,11,39,.282,15,24,.625,.500,1,1,1.000,10,32,42,16,8,6,6,25,64,20
Ty Jerome,SG,23,OKC,33,1,788,128,287,.446,71,168,.423,57,119,.479,.570,26,34,.765,10,81,91,120,20,6,47,61,353,20
Isaiah Joe,SG,21,PHI,41,1,383,48,133,.361,39,106,.368,9,27,.333,.508,18,24,.750,6,30,36,20,12,4,11,34,153,20
Alize Johnson,PF,24,BRK,18,0,189,40,68,.588,1,6,.167,39,62,.629,.596,13,13,1.000,27,63,90,14,5,5,9,16,94,20
Cameron Johnson,PF,24,PHO,60,11,1437,203,483,.420,117,335,.349,86,148,.581,.541,50,59,.847,33,166,199,86,37,16,40,85,573,20
James Johnson,PF,33,TOT,51,12,1043,146,327,.446,31,120,.258,115,207,.556,.494,45,76,.592,32,145,177,98,42,42,55,120,368,20
James Johnson,PF,33,DAL,29,1,504,67,145,.462,15,60,.250,52,85,.612,.514,17,29,.586,14,72,86,50,24,23,27,59,166,20
James Johnson,PF,33,NOP,22,11,539,79,182,.434,16,60,.267,63,122,.516,.478,28,47,.596,18,73,91,48,18,19,28,61,202,20
Keldon Johnson,SF,21,SAS,69,67,1968,338,705,.479,60,181,.331,278,524,.531,.522,145,196,.740,93,319,412,121,40,24,78,142,881,20
Stanley Johnson,PF,24,TOR,61,13,1006,89,233,.382,45,137,.328,44,96,.458,.479,44,55,.800,29,124,153,89,52,18,54,116,267,20
Tyler Johnson,SG,28,BRK,39,3,684,72,183,.393,48,132,.364,24,51,.471,.525,18,21,.857,6,71,77,47,14,0,17,43,210,20
Nikola Jokić,C,25,DEN,72,72,2488,732,1293,.566,92,237,.388,640,1056,.606,.602,342,394,.868,205,575,780,599,95,48,222,192,1898,20
Damian Jones,C,25,TOT,39,10,547,70,103,.680,1,5,.200,69,98,.704,.684,42,58,.724,36,85,121,29,11,29,26,77,183,20
Damian Jones,C,25,PHO,14,0,94,8,16,.500,0,1,0,8,15,.533,.500,6,11,.545,7,11,18,4,1,5,6,19,22,20
Damian Jones,C,25,LAL,8,6,112,16,17,.941,0,0,0,16,17,.941,.941,11,12,.917,8,18,26,1,1,7,5,22,43,20
Damian Jones,C,25,SAC,17,4,341,46,70,.657,1,4,.250,45,66,.682,.664,25,35,.714,21,56,77,24,9,17,15,36,118,20
Derrick Jones Jr.,SF,23,POR,58,43,1318,147,304,.484,43,136,.316,104,168,.619,.554,59,91,.648,77,128,205,47,37,54,32,127,396,20
Mason Jones,SG,22,TOT,32,1,334,52,123,.423,24,66,.364,28,57,.491,.520,40,64,.625,7,48,55,42,7,1,29,24,168,20
Mason Jones,SG,22,HOU,26,1,307,47,114,.412,23,64,.359,24,50,.480,.513,35,57,.614,4,47,51,39,6,1,28,22,152,20
Mason Jones,SG,22,PHI,6,0,27,5,9,.556,1,2,.500,4,7,.571,.611,5,7,.714,3,1,4,3,1,0,1,2,16,20
Tre Jones,PG,21,SAS,37,1,269,37,78,.474,3,5,.600,34,73,.466,.494,17,19,.895,8,13,21,39,8,0,13,13,94,20
Tyus Jones,PG,24,MEM,70,9,1222,178,413,.431,45,140,.321,133,273,.487,.485,41,45,.911,21,119,140,259,64,6,48,31,442,20
DeAndre Jordan,C,32,BRK,57,43,1246,190,249,.763,0,1,0,190,248,.766,.763,46,92,.500,117,310,427,93,17,65,85,116,426,20
Cory Joseph,PG,29,TOT,63,13,1446,200,426,.469,45,132,.341,155,294,.527,.522,72,88,.818,35,124,159,213,61,18,79,139,517,20
Cory Joseph,PG,29,SAC,44,2,944,111,250,.444,31,94,.330,80,156,.513,.506,36,47,.766,25,74,99,108,39,9,44,98,289,20
Cory Joseph,PG,29,DET,19,11,502,89,176,.506,14,38,.368,75,138,.543,.545,36,41,.878,10,50,60,105,22,9,35,41,228,20
Mfiondu Kabengele,PF,23,TOT,39,0,280,33,89,.371,13,50,.260,20,39,.513,.444,16,20,.800,12,48,60,17,8,13,15,36,95,20
Mfiondu Kabengele,PF,23,LAC,23,0,94,9,32,.281,4,18,.222,5,14,.357,.344,5,6,.833,1,13,14,5,2,3,6,18,27,20
Mfiondu Kabengele,PF,23,CLE,16,0,186,24,57,.421,9,32,.281,15,25,.600,.500,11,14,.786,11,35,46,12,6,10,9,18,68,20
Frank Kaminsky,C,27,PHO,47,13,715,121,257,.471,31,85,.365,90,172,.523,.531,37,60,.617,36,152,188,79,14,17,22,70,310,20
Luke Kennard,SG,24,LAC,63,17,1232,197,414,.476,100,224,.446,97,190,.511,.597,26,31,.839,15,146,161,104,23,9,48,91,520,20
Louis King,SF,21,SAC,6,1,85,17,34,.500,4,11,.364,13,23,.565,.559,6,6,1.000,5,13,18,9,7,3,4,9,44,20
Maxi Kleber,PF,29,DAL,50,40,1341,116,275,.422,87,212,.410,29,63,.460,.580,34,37,.919,47,213,260,68,24,35,30,105,353,20
Nathan Knight,PF,23,ATL,33,0,279,37,100,.370,6,33,.182,31,67,.463,.400,44,55,.800,27,45,72,8,9,10,15,22,124,20
Kevin Knox,SF,21,NYK,42,0,464,56,143,.392,35,89,.393,21,54,.389,.514,16,20,.800,10,51,61,19,12,6,17,37,163,20
John Konchar,SG,24,MEM,43,0,575,69,138,.500,21,56,.375,48,82,.585,.576,25,30,.833,35,93,128,47,30,9,18,40,184,20
Furkan Korkmaz,SG,23,PHI,55,11,1062,170,424,.401,101,269,.375,69,155,.445,.520,60,82,.732,17,96,113,82,49,9,46,64,501,20
Luke Kornet,C-PF,25,TOT,31,2,348,44,101,.436,15,59,.254,29,42,.690,.510,3,6,.500,14,53,67,24,4,32,7,20,106,20
Luke Kornet,PF,25,CHI,13,0,94,9,27,.333,6,23,.261,3,4,.750,.444,2,4,.500,1,14,15,4,2,7,1,1,26,20
Luke Kornet,C,25,BOS,18,2,254,35,74,.473,9,36,.250,26,38,.684,.534,1,2,.500,13,39,52,20,2,25,6,19,80,20
Rodions Kurucs,SF-PF,22,TOT,21,0,125,11,32,.344,6,21,.286,5,11,.455,.438,3,4,.750,5,18,23,10,9,4,13,16,31,20
Rodions Kurucs,PF,22,BRK,5,0,16,1,3,.333,1,2,.500,0,1,0,.500,0,0,0,0,3,3,2,0,0,0,1,3,20
Rodions Kurucs,SF,22,HOU,11,0,75,5,21,.238,2,15,.133,3,6,.500,.286,1,2,.500,2,9,11,4,6,4,9,7,13,20
Rodions Kurucs,SF,22,MIL,5,0,34,5,8,.625,3,4,.750,2,4,.500,.813,2,2,1.000,3,6,9,4,3,0,4,8,15,20
Kyle Kuzma,SF,25,LAL,68,32,1954,335,757,.443,137,380,.361,198,377,.525,.533,67,97,.691,108,309,417,127,35,41,113,121,874,20
Anthony Lamb,SF,23,HOU,24,3,415,46,118,.390,23,71,.324,23,47,.489,.487,18,21,.857,27,43,70,23,6,5,19,34,133,20
Jeremy Lamb,SG,28,IND,36,8,765,120,276,.435,52,128,.406,68,148,.459,.529,71,75,.947,25,106,131,53,34,23,22,72,363,20
Romeo Langford,SG,21,BOS,18,4,283,21,59,.356,5,18,.278,16,41,.390,.398,9,12,.750,12,23,35,13,6,5,10,24,56,20
Zach LaVine,SG,25,CHI,58,58,2034,569,1123,.507,200,477,.419,369,646,.571,.596,253,298,.849,36,253,289,282,46,27,203,138,1591,20
Jake Layman,SF,26,MIN,45,11,627,91,184,.495,23,78,.295,68,106,.642,.557,26,37,.703,13,54,67,28,29,19,26,44,231,20
T.J. Leaf,PF,23,POR,7,0,35,5,10,.500,0,0,0,5,10,.500,.500,2,2,1.000,0,5,5,1,2,1,2,1,12,20
Jalen Lecque,PG,20,IND,4,0,12,1,9,.111,0,1,0,1,8,.125,.111,3,3,1.000,2,3,5,2,0,0,0,0,5,20
Damion Lee,SG,28,GSW,57,1,1079,128,274,.467,77,194,.397,51,80,.638,.608,40,44,.909,22,158,180,73,38,8,30,89,373,20
Saben Lee,PG,21,DET,48,7,781,99,210,.471,8,23,.348,91,187,.487,.490,61,89,.685,20,77,97,174,32,13,55,76,267,20
Alex Len,C,27,TOT,64,42,979,171,278,.615,8,25,.320,163,253,.644,.629,73,116,.629,78,182,260,49,20,64,55,127,423,20
Alex Len,C,27,TOR,7,2,76,5,10,.500,3,6,.500,2,4,.500,.650,3,6,.500,0,11,11,3,1,6,8,10,16,20
Alex Len,C,27,WAS,57,40,903,166,268,.619,5,19,.263,161,249,.647,.629,70,110,.636,78,171,249,46,19,58,47,117,407,20
Kawhi Leonard,SF,29,LAC,52,52,1773,465,908,.512,101,254,.398,364,654,.557,.568,261,295,.885,55,282,337,269,81,21,105,82,1292,20
Meyers Leonard,C,28,MIA,3,2,29,3,7,.429,3,7,.429,0,0,0,.643,1,2,.500,0,7,7,2,0,0,2,5,10,20
Caris LeVert,SG,26,TOT,47,39,1486,359,814,.441,84,258,.326,275,556,.495,.493,146,180,.811,33,181,214,245,66,30,102,105,948,20
Caris LeVert,SG,26,BRK,12,4,334,87,200,.435,22,63,.349,65,137,.474,.490,26,34,.765,10,42,52,72,13,6,26,20,222,20
Caris LeVert,SG,26,IND,35,35,1152,272,614,.443,62,195,.318,210,419,.501,.493,120,146,.822,23,139,162,173,53,24,76,85,726,20
Kira Lewis Jr.,PG,19,NOP,54,0,904,130,337,.386,40,120,.333,90,217,.415,.445,43,51,.843,12,59,71,124,38,10,34,88,343,20
Damian Lillard,PG,30,POR,67,67,2398,602,1334,.451,275,704,.391,327,630,.519,.554,449,484,.928,32,251,283,505,62,17,203,102,1928,20
Nassir Little,PF,20,POR,48,2,640,78,167,.467,28,80,.350,50,87,.575,.551,36,45,.800,32,96,128,23,5,13,18,51,220,20
Kevon Looney,C,24,GSW,61,34,1161,108,197,.548,4,17,.235,104,180,.578,.558,31,48,.646,117,205,322,119,21,22,37,136,251,20
Brook Lopez,C,32,MIL,70,70,1902,322,640,.503,95,281,.338,227,359,.632,.577,120,142,.845,104,243,347,50,40,103,64,149,859,20
Robin Lopez,C,32,WAS,71,9,1354,269,425,.633,5,18,.278,264,407,.649,.639,99,137,.723,141,131,272,55,15,44,75,109,642,20
Didi Louzada,SF,21,NOP,3,0,56,3,13,.231,2,8,.250,1,5,.200,.308,0,0,0,1,2,3,3,2,0,3,5,8,20
Kevin Love,PF,32,CLE,25,25,622,103,252,.409,57,156,.365,46,96,.479,.522,42,51,.824,17,169,186,63,16,2,38,26,305,20
Kyle Lowry,PG,34,TOR,46,46,1601,260,596,.436,131,331,.396,129,265,.487,.546,140,160,.875,35,212,247,338,45,14,126,143,791,20
Timothé Luwawu-Cabarrot,SF,25,BRK,58,7,1050,130,356,.365,75,239,.314,55,117,.470,.471,35,43,.814,28,101,129,69,33,6,43,99,370,20
Trey Lyles,PF,25,SAS,23,9,358,43,90,.478,14,40,.350,29,50,.580,.556,15,23,.652,9,77,86,14,6,1,6,13,115,20
Will Magnay,C,22,NOP,1,0,3,0,1,0,0,1,0,0,0,0,0,0,0,0,0,0,0,0,0,0,1,1,0,20
Thon Maker,C,23,CLE,8,0,76,10,18,.556,0,2,0,10,16,.625,.556,10,11,.909,8,10,18,4,2,4,3,7,30,20
Théo Maledon,PG,19,OKC,65,49,1778,226,614,.368,105,313,.335,121,301,.402,.454,101,135,.748,25,186,211,227,56,11,141,126,658,20
Karim Mané,PG,20,ORL,10,0,88,3,13,.231,1,2,.500,2,11,.182,.269,4,5,.800,1,13,14,4,0,2,3,10,11,20
Terance Mann,SG,24,LAC,67,10,1263,178,350,.509,38,91,.418,140,259,.541,.563,78,94,.830,56,186,242,104,29,13,40,126,472,20
Nico Mannion,PG,19,GSW,30,1,364,39,114,.342,22,60,.367,17,54,.315,.439,23,28,.821,6,40,46,70,16,1,31,29,123,20
Boban Marjanović,C,32,DAL,33,3,271,62,122,.508,1,8,.125,61,114,.535,.512,31,38,.816,47,81,128,10,2,6,12,29,156,20
Lauri Markkanen,PF,23,CHI,51,26,1317,250,521,.480,119,296,.402,131,225,.582,.594,76,92,.826,35,233,268,45,26,15,52,75,695,20
Naji Marshall,SF,23,NOP,32,10,700,82,209,.392,29,83,.349,53,126,.421,.462,53,75,.707,15,133,148,88,26,10,38,58,246,20
Caleb Martin,SF,25,CHO,53,3,818,96,256,.375,31,125,.248,65,131,.496,.436,41,64,.641,31,110,141,67,37,12,33,62,264,20
Cody Martin,SF,25,CHO,52,10,849,83,188,.441,16,58,.276,67,130,.515,.484,25,43,.581,52,109,161,86,37,12,40,52,207,20
Jeremiah Martin,PG,24,CLE,9,0,75,9,33,.273,3,12,.250,6,21,.286,.318,1,5,.200,2,5,7,4,5,2,6,1,22,20
Kelan Martin,SF,25,IND,35,0,322,62,138,.449,24,60,.400,38,78,.487,.536,9,10,.900,18,60,78,17,10,10,16,35,157,20
Kenyon Martin Jr.,SF,20,HOU,45,8,1068,162,318,.509,35,96,.365,127,222,.572,.564,60,84,.714,73,169,242,48,30,41,38,89,419,20
Frank Mason III,PG,26,ORL,4,1,79,9,24,.375,2,5,.400,7,19,.368,.417,5,7,.714,3,9,12,12,0,0,5,7,25,20
Garrison Mathews,SG,24,WAS,64,24,1038,97,237,.409,76,198,.384,21,39,.538,.570,84,95,.884,16,71,87,26,29,7,10,106,354,20
Dakota Mathias,SG,25,PHI,8,2,123,19,48,.396,8,26,.308,11,22,.500,.479,2,6,.333,1,6,7,13,1,3,1,7,48,20
Wesley Matthews,SG,34,LAL,58,10,1130,89,252,.353,66,197,.335,23,55,.418,.484,35,41,.854,20,73,93,54,38,17,26,80,279,20
Tyrese Maxey,SG,20,PHI,61,8,935,198,429,.462,31,103,.301,167,326,.512,.498,61,70,.871,11,93,104,120,26,13,41,79,488,20
Skylar Mays,SG,23,ATL,33,0,269,44,98,.449,14,40,.350,30,58,.517,.520,22,25,.880,10,25,35,30,14,2,9,15,124,20
Patrick McCaw,SF,25,TOR,5,0,33,1,1,1.000,0,0,0,1,1,1.000,1.000,3,3,1.000,1,2,3,4,2,0,0,6,5,20
CJ McCollum,SG,29,POR,47,47,1600,405,884,.458,169,420,.402,236,464,.509,.554,108,133,.812,30,155,185,223,44,21,65,87,1087,20
T.J. McConnell,PG,28,IND,69,3,1796,274,490,.559,15,48,.313,259,442,.586,.574,33,48,.688,55,201,256,456,128,23,135,113,596,20
Jaden McDaniels,PF,20,MIN,63,27,1511,164,367,.447,72,198,.364,92,169,.544,.545,27,45,.600,52,180,232,71,35,60,47,172,427,20
Jalen McDaniels,SF,23,CHO,47,18,904,133,284,.468,35,105,.333,98,179,.547,.530,45,64,.703,45,124,169,53,28,19,45,95,346,20
Doug McDermott,PF,29,IND,66,29,1619,354,665,.532,111,286,.388,243,379,.641,.616,80,98,.816,60,161,221,85,20,6,53,117,899,20
Sean McDermott,SF,24,MEM,18,0,158,13,33,.394,5,22,.227,8,11,.727,.470,8,8,1.000,6,13,19,4,2,3,4,8,39,20
JaVale McGee,C,33,TOT,46,2,678,144,282,.511,5,24,.208,139,258,.539,.520,44,67,.657,77,162,239,39,19,54,60,121,337,20
JaVale McGee,C,33,CLE,33,1,503,112,215,.521,5,20,.250,107,195,.549,.533,36,55,.655,54,116,170,33,16,40,45,80,265,20
JaVale McGee,C,33,DEN,13,1,175,32,67,.478,0,4,0,32,63,.508,.478,8,12,.667,23,46,69,6,3,14,15,41,72,20
Rodney McGruder,SG,29,DET,16,2,194,37,70,.529,11,24,.458,26,46,.565,.607,6,8,.750,8,14,22,16,8,1,7,12,91,20
Alfonzo McKinnie,SF,28,LAL,39,0,258,48,93,.516,16,39,.410,32,54,.593,.602,10,18,.556,22,32,54,6,7,0,5,26,122,20
Jordan McLaughlin,PG,24,MIN,51,2,938,100,242,.413,33,92,.359,67,150,.447,.481,23,30,.767,21,87,108,193,51,6,51,44,256,20
Ben McLemore,SG,27,TOT,53,5,905,135,365,.370,97,280,.346,38,85,.447,.503,39,53,.736,15,85,100,39,23,9,42,88,406,20
Ben McLemore,SG,27,HOU,32,4,537,80,224,.357,55,166,.331,25,58,.431,.480,23,32,.719,11,55,66,28,20,3,28,51,238,20
Ben McLemore,SG,27,LAL,21,1,368,55,141,.390,42,114,.368,13,27,.481,.539,16,21,.762,4,30,34,11,3,6,14,37,168,20
Nicolò Melli,PF,30,TOT,45,4,566,46,141,.326,23,85,.271,23,56,.411,.408,19,25,.760,29,93,122,44,14,3,12,58,134,20
Nicolò Melli,PF,30,NOP,22,0,241,15,59,.254,7,37,.189,8,22,.364,.314,6,7,.857,12,45,57,25,9,1,7,28,43,20
Nicolò Melli,PF,30,DAL,23,4,325,31,82,.378,16,48,.333,15,34,.441,.476,13,18,.722,17,48,65,19,5,2,5,30,91,20
De'Anthony Melton,PG,22,MEM,52,1,1045,172,393,.438,87,211,.412,85,182,.467,.548,41,51,.804,30,131,161,132,60,31,66,85,472,20
Sam Merrill,SG,24,MIL,30,2,233,32,72,.444,21,47,.447,11,25,.440,.590,4,4,1.000,6,24,30,21,8,1,10,17,89,20
Chimezie Metu,C,23,SAC,36,6,488,91,179,.508,13,37,.351,78,142,.549,.545,31,43,.721,31,81,112,28,14,18,29,59,226,20
Khris Middleton,SF,29,MIL,68,68,2269,511,1074,.476,151,365,.414,360,709,.508,.546,212,236,.898,54,352,406,370,74,9,178,160,1385,20
Darius Miller,SF,30,OKC,18,0,197,22,48,.458,17,42,.405,5,6,.833,.635,12,12,1.000,2,22,24,21,13,5,8,13,73,20
Patty Mills,PG,32,SAS,68,1,1685,252,611,.412,161,429,.375,91,182,.500,.544,71,78,.910,18,98,116,162,42,3,66,81,736,20
Paul Millsap,PF,35,DEN,56,36,1162,191,401,.476,49,143,.343,142,258,.550,.537,71,98,.724,76,186,262,98,51,36,51,111,502,20
Shake Milton,SG,24,PHI,63,4,1461,300,667,.450,71,203,.350,229,464,.494,.503,146,176,.830,33,115,148,193,39,18,103,130,817,20
Donovan Mitchell,PG,24,UTA,53,53,1771,478,1091,.438,178,461,.386,300,630,.476,.520,267,316,.845,50,185,235,277,52,15,147,117,1401,20
Adam Mokoka,SG,22,CHI,14,0,56,7,19,.368,1,10,.100,6,9,.667,.395,0,1,0,1,4,5,5,2,1,5,5,15,20
Malik Monk,SG,22,CHO,42,0,878,173,399,.434,85,212,.401,88,187,.471,.540,59,72,.819,14,87,101,87,19,4,55,47,490,20
E'Twaun Moore,SG,31,PHO,27,1,389,55,121,.455,11,35,.314,44,86,.512,.500,12,14,.857,14,31,45,40,15,5,23,32,133,20
Ja Morant,PG,21,MEM,63,63,2053,430,957,.449,73,241,.303,357,716,.499,.487,271,372,.728,59,193,252,465,57,13,203,87,1204,20
Juwan Morgan,PF,23,UTA,29,0,147,14,30,.467,4,13,.308,10,17,.588,.533,3,7,.429,9,19,28,9,4,1,4,21,35,20
Marcus Morris,PF,31,LAC,57,29,1502,276,584,.473,140,296,.473,136,288,.472,.592,73,89,.820,35,199,234,58,34,15,57,117,765,20
Markieff Morris,PF,31,LAL,61,27,1200,153,378,.405,65,209,.311,88,169,.521,.491,36,50,.720,48,218,266,73,22,19,54,105,407,20
Monte Morris,PG,25,DEN,47,13,1196,186,387,.481,51,134,.381,135,253,.534,.547,58,73,.795,11,85,96,150,34,13,34,48,481,20
Mychal Mulder,PG,26,GSW,60,6,766,119,265,.449,85,214,.397,34,51,.667,.609,14,22,.636,8,52,60,26,12,12,16,56,337,20
Dejounte Murray,PG,24,SAS,67,67,2139,441,974,.453,63,199,.317,378,775,.488,.485,106,134,.791,58,415,473,363,101,7,117,135,1051,20
Jamal Murray,PG,23,DEN,48,48,1704,378,792,.477,129,316,.408,249,476,.523,.559,133,153,.869,37,157,194,231,64,13,108,95,1018,20
Mike Muscala,C,29,OKC,35,0,645,119,267,.446,68,184,.370,51,83,.614,.573,33,36,.917,19,113,132,28,8,11,21,54,339,20
Svi Mykhailiuk,SF-SG,23,TOT,66,14,1324,208,506,.411,105,314,.334,103,192,.536,.515,38,50,.760,24,139,163,110,51,12,88,63,559,20
Svi Mykhailiuk,SF,23,DET,36,5,634,84,223,.377,57,171,.333,27,52,.519,.504,24,30,.800,11,63,74,57,27,6,39,33,249,20
Svi Mykhailiuk,SG,23,OKC,30,9,690,124,283,.438,48,143,.336,76,140,.543,.523,14,20,.700,13,76,89,53,24,6,49,30,310,20
Abdel Nader,SF,27,PHO,24,0,355,57,116,.491,18,43,.419,39,73,.534,.569,28,37,.757,7,55,62,19,10,9,19,34,160,20
Larry Nance Jr.,PF,28,CLE,35,27,1091,128,272,.471,41,114,.360,87,158,.551,.546,30,49,.612,54,181,235,107,61,17,55,72,327,20
Aaron Nesmith,SF,21,BOS,46,1,669,78,178,.438,40,108,.370,38,70,.543,.551,22,28,.786,28,99,127,23,15,9,23,87,218,20
Raul Neto,PG,28,WAS,64,22,1403,209,447,.468,64,164,.390,145,283,.512,.539,75,85,.882,28,128,156,146,73,6,53,109,557,20
Georges Niang,PF,27,UTA,72,10,1154,177,405,.437,124,292,.425,53,113,.469,.590,22,23,.957,28,148,176,59,25,8,51,116,500,20
Zeke Nnaji,PF,20,DEN,42,1,397,50,104,.481,24,59,.407,26,45,.578,.596,12,15,.800,14,51,65,10,8,4,7,29,136,20
Nerlens Noel,C,26,NYK,64,41,1547,137,223,.614,0,3,0,137,220,.623,.614,50,70,.714,142,266,408,46,70,141,65,176,324,20
Jaylen Nowell,SG,21,MIN,42,0,759,142,335,.424,50,150,.333,92,185,.497,.499,45,55,.818,19,76,95,62,22,12,28,72,379,20
Frank Ntilikina,PG,22,NYK,33,4,322,29,79,.367,23,48,.479,6,31,.194,.513,8,18,.444,6,25,31,19,18,4,11,45,89,20
Kendrick Nunn,PG,25,MIA,56,44,1650,319,658,.485,122,320,.381,197,338,.583,.578,56,60,.933,21,158,179,148,52,14,80,108,816,20
James Nunnally,SF,30,NOP,9,0,48,5,13,.385,4,12,.333,1,1,1.000,.538,1,2,.500,2,7,9,3,0,0,2,1,15,20
Jusuf Nurkić,C,26,POR,37,37,880,171,333,.514,12,30,.400,159,303,.525,.532,70,113,.619,86,246,332,125,38,39,73,103,424,20
David Nwaba,SF,28,HOU,30,9,679,106,218,.486,17,63,.270,89,155,.574,.525,47,68,.691,40,78,118,31,30,21,17,60,276,20
Jordan Nwora,SF,22,MIL,30,2,274,62,135,.459,28,62,.452,34,73,.466,.563,19,25,.760,9,51,60,7,16,7,24,22,171,20
Royce O'Neale,SF,27,UTA,71,71,2241,175,394,.444,107,278,.385,68,116,.586,.580,39,46,.848,88,397,485,181,57,32,83,182,496,20
Semi Ojeleye,PF,26,BOS,56,15,950,89,221,.403,58,158,.367,31,63,.492,.534,24,32,.750,31,116,147,37,17,0,21,56,260,20
Jahlil Okafor,C,25,DET,27,2,347,63,102,.618,2,9,.222,61,93,.656,.627,17,24,.708,23,43,66,13,6,5,21,39,145,20
Chuma Okeke,PF,22,ORL,45,19,1133,135,324,.417,49,141,.348,86,183,.470,.492,30,40,.750,42,139,181,101,48,22,38,48,349,20
Josh Okogie,SG,22,MIN,59,37,1197,102,254,.402,29,108,.269,73,146,.500,.459,83,108,.769,63,93,156,63,54,28,43,123,316,20
Onyeka Okongwu,C,20,ATL,50,4,601,96,149,.644,0,3,0,96,146,.658,.644,36,57,.632,62,101,163,18,23,33,29,100,228,20
Isaac Okoro,SG,20,CLE,67,67,2173,235,559,.420,62,214,.290,173,345,.501,.476,114,157,.726,68,138,206,128,62,24,86,185,646,20
KZ Okpala,PF,21,MIA,37,9,447,36,96,.375,12,50,.240,24,46,.522,.438,8,15,.533,21,47,68,19,10,11,15,59,92,20
Victor Oladipo,SG,28,TOT,33,33,1080,235,576,.408,78,239,.326,157,337,.466,.476,104,138,.754,12,148,160,151,46,14,83,81,652,20
Victor Oladipo,SG,28,IND,9,9,300,64,152,.421,25,69,.362,39,83,.470,.503,27,37,.730,1,50,51,38,15,2,18,23,180,20
Victor Oladipo,SG,28,HOU,20,20,669,155,381,.407,49,153,.320,106,228,.465,.471,65,83,.783,8,87,95,99,24,10,51,45,424,20
Victor Oladipo,SG,28,MIA,4,4,111,16,43,.372,4,17,.235,12,26,.462,.419,12,18,.667,3,11,14,14,7,2,14,13,48,20
Cameron Oliver,SF,24,HOU,4,0,87,19,33,.576,4,13,.308,15,20,.750,.636,1,4,.250,5,16,21,5,2,4,3,11,43,20
Kelly Olynyk,C-PF,29,TOT,70,62,1997,337,697,.484,126,368,.342,211,329,.641,.574,145,175,.829,87,402,489,203,79,42,126,207,945,20
Kelly Olynyk,C,29,MIA,43,38,1157,162,376,.431,77,243,.317,85,133,.639,.533,31,40,.775,44,217,261,91,40,26,55,123,432,20
Kelly Olynyk,PF,29,HOU,27,24,840,175,321,.545,49,125,.392,126,196,.643,.621,114,135,.844,43,185,228,112,39,16,71,84,513,20
Miye Oni,SG,23,UTA,54,0,519,35,99,.354,30,88,.341,5,11,.455,.505,5,6,.833,23,61,84,28,11,8,16,61,105,20
Cedi Osman,SF,25,CLE,59,26,1510,219,586,.374,99,324,.306,120,262,.458,.458,76,95,.800,38,163,201,174,53,9,80,119,613,20
Daniel Oturu,C,21,LAC,30,0,161,22,52,.423,1,5,.200,21,47,.447,.433,9,12,.750,21,27,48,10,4,7,9,24,54,20
Kelly Oubre Jr.,SF,25,GSW,55,50,1687,318,724,.439,90,285,.316,228,439,.519,.501,123,177,.695,82,247,329,73,57,42,70,121,849,20
Jabari Parker,PF,25,TOT,13,0,165,30,55,.545,2,11,.182,28,44,.636,.564,10,13,.769,10,32,42,11,1,5,10,13,72,20
Jabari Parker,PF,25,SAC,3,0,27,4,7,.571,0,1,0,4,6,.667,.571,0,0,0,1,5,6,1,0,1,3,4,8,20
Jabari Parker,PF,25,BOS,10,0,138,26,48,.542,2,10,.200,24,38,.632,.563,10,13,.769,9,27,36,10,1,4,7,9,64,20
Eric Paschall,PF,24,GSW,40,2,695,148,298,.497,18,54,.333,130,244,.533,.527,67,94,.713,28,100,128,51,12,7,43,68,381,20
Anžejs Pasečņiks,C,25,WAS,1,0,6,0,1,0,0,1,0,0,0,0,0,0,0,0,1,0,1,1,0,0,5,2,0,20
Patrick Patterson,PF,31,LAC,38,5,582,72,165,.436,40,112,.357,32,53,.604,.558,13,17,.765,19,56,75,29,14,8,11,45,197,20
Justin Patton,C,23,HOU,13,6,247,29,70,.414,9,34,.265,20,36,.556,.479,3,4,.750,14,35,49,14,12,14,4,34,70,20
Chris Paul,PG,35,PHO,70,70,2199,439,879,.499,102,258,.395,337,621,.543,.557,169,181,.934,25,287,312,622,99,19,156,166,1149,20
Cameron Payne,PG,26,PHO,60,1,1079,191,395,.484,73,166,.440,118,229,.515,.576,50,56,.893,16,128,144,217,36,16,60,97,505,20
Elfrid Payton,PG,26,NYK,63,63,1484,269,622,.432,28,98,.286,241,524,.460,.455,73,107,.682,64,152,216,203,47,9,103,116,639,20
Gary Payton II,PG,28,GSW,10,0,40,10,13,.769,2,4,.500,8,9,.889,.846,3,4,.750,2,9,11,1,6,1,1,8,25,20
Norvel Pelle,C,27,TOT,13,0,84,8,15,.533,0,0,0,8,15,.533,.533,4,6,.667,6,13,19,2,1,9,3,14,20,20
Norvel Pelle,C,27,BRK,3,0,28,3,7,.429,0,0,0,3,7,.429,.429,0,0,0,3,4,7,0,0,3,3,9,6,20
Norvel Pelle,C,27,SAC,1,0,4,0,1,0,0,0,0,0,1,0,0,3,4,.750,1,0,1,1,0,0,0,1,3,20
Norvel Pelle,C,27,NYK,9,0,52,5,7,.714,0,0,0,5,7,.714,.714,1,2,.500,2,9,11,1,1,6,0,4,11,20
Reggie Perry,PF,20,BRK,26,0,211,32,78,.410,4,21,.190,28,57,.491,.436,10,13,.769,27,46,73,14,6,6,15,40,78,20
Theo Pinson,SG,25,NYK,17,0,34,1,9,.111,0,8,0,1,1,1.000,.111,0,0,0,0,5,5,1,0,0,1,4,2,20
Mason Plumlee,C,30,DET,56,56,1499,234,381,.614,0,7,0,234,374,.626,.614,113,169,.669,145,374,519,202,43,50,105,186,581,20
Jakob Poeltl,C,25,SAS,69,51,1845,265,430,.616,0,0,0,265,430,.616,.616,63,124,.508,219,328,547,134,47,123,83,172,593,20
Vincent Poirier,C,27,PHI,10,0,39,3,12,.250,0,1,0,3,11,.273,.250,2,6,.333,6,8,14,2,0,3,4,8,8,20
Aleksej Pokusevski,PF,19,OKC,45,28,1090,139,408,.341,58,207,.280,81,201,.403,.412,31,42,.738,30,182,212,97,20,42,99,58,367,20
Jordan Poole,SG,21,GSW,51,7,988,205,474,.432,97,276,.351,108,198,.545,.535,105,119,.882,15,77,92,99,26,9,51,86,612,20
Jontay Porter,PF,21,MEM,11,0,54,8,15,.533,3,8,.375,5,7,.714,.633,3,5,.600,4,10,14,1,3,1,7,12,22,20
Kevin Porter Jr.,SG,20,HOU,26,23,835,156,367,.425,50,161,.311,106,206,.515,.493,69,94,.734,20,79,99,164,19,8,91,61,431,20
Michael Porter Jr.,SF,22,DEN,61,54,1912,443,817,.542,170,382,.445,273,435,.628,.646,106,134,.791,91,354,445,70,40,54,77,126,1162,20
Otto Porter Jr.,SF-PF,27,TOT,28,6,606,98,227,.432,39,104,.375,59,123,.480,.518,36,42,.857,28,124,152,55,16,4,25,41,271,20
Otto Porter Jr.,SF,27,CHI,25,6,540,89,202,.441,38,95,.400,51,107,.477,.535,31,37,.838,28,110,138,50,12,4,25,37,247,20
Otto Porter Jr.,PF,27,ORL,3,0,66,9,25,.360,1,9,.111,8,16,.500,.380,5,5,1.000,0,14,14,5,4,0,0,4,24,20
Bobby Portis,C,25,MIL,66,7,1372,313,598,.523,74,157,.471,239,441,.542,.585,54,73,.740,124,342,466,71,52,26,56,115,754,20
Kristaps Porziņģis,C,25,DAL,43,43,1327,325,683,.476,97,258,.376,228,425,.536,.547,118,138,.855,82,299,381,68,20,58,51,115,865,20
Dwight Powell,C,29,DAL,58,19,966,120,194,.619,5,21,.238,115,173,.665,.631,97,124,.782,80,154,234,63,36,30,40,135,342,20
Norman Powell,SG-SF,27,TOT,69,58,2205,438,918,.477,171,416,.411,267,502,.532,.570,236,271,.871,42,173,215,129,82,18,119,160,1283,20
Norman Powell,SG,27,TOR,42,31,1277,282,566,.498,118,269,.439,164,297,.552,.602,141,163,.865,19,107,126,77,47,8,77,98,823,20
Norman Powell,SF,27,POR,27,27,928,156,352,.443,53,147,.361,103,205,.502,.518,95,108,.880,23,66,89,52,35,10,42,62,460,20
Taurean Prince,PF,26,TOT,41,10,905,131,327,.401,62,155,.400,69,172,.401,.495,65,76,.855,19,123,142,76,28,23,47,75,389,20
Taurean Prince,PF,26,BRK,12,4,218,30,74,.405,13,37,.351,17,37,.459,.493,24,27,.889,2,32,34,7,8,8,11,21,97,20
Taurean Prince,PF,26,CLE,29,6,687,101,253,.399,49,118,.415,52,135,.385,.496,41,49,.837,17,91,108,69,20,15,36,54,292,20
Payton Pritchard,SG,23,BOS,66,4,1268,184,418,.440,102,248,.411,82,170,.482,.562,40,45,.889,33,125,158,120,37,9,53,104,510,20
Immanuel Quickley,PG,21,NYK,64,3,1243,229,580,.395,118,303,.389,111,277,.401,.497,155,174,.891,25,112,137,127,30,12,58,114,731,20
Jahmi'us Ramsey,SG,19,SAC,13,0,94,15,38,.395,5,19,.263,10,19,.526,.461,5,5,1.000,2,8,10,6,4,1,3,8,40,20
Chasson Randle,PG,27,ORL,41,5,837,92,237,.388,44,130,.338,48,107,.449,.481,38,48,.792,7,75,82,74,22,5,46,64,266,20
Julius Randle,PF,26,NYK,71,71,2667,602,1321,.456,160,389,.411,442,932,.474,.516,348,429,.811,84,639,723,427,64,18,241,225,1712,20
Cam Reddish,SF,21,ATL,26,21,750,96,263,.365,33,126,.262,63,137,.460,.428,67,82,.817,22,82,104,35,33,9,34,68,292,20
J.J. Redick,SG,36,TOT,44,0,723,106,267,.397,66,178,.371,40,89,.449,.521,49,52,.942,4,60,64,51,11,3,36,50,327,20
J.J. Redick,SG,36,NOP,31,0,576,87,214,.407,51,140,.364,36,74,.486,.526,45,47,.957,3,49,52,40,9,2,25,37,270,20
J.J. Redick,SG,36,DAL,13,0,147,19,53,.358,15,38,.395,4,15,.267,.500,4,5,.800,1,11,12,11,2,1,11,13,57,20
Paul Reed,PF,21,PHI,26,0,177,42,78,.538,0,6,0,42,72,.583,.538,4,8,.500,30,31,61,12,10,13,12,29,88,20
Naz Reid,C,21,MIN,70,15,1347,304,581,.523,61,174,.351,243,407,.597,.576,115,166,.693,82,240,322,72,34,76,69,179,784,20
Cameron Reynolds,SF,25,TOT,5,0,40,6,18,.333,3,12,.250,3,6,.500,.417,0,0,0,2,3,5,2,0,0,0,2,15,20
Cameron Reynolds,SF,25,SAS,3,0,6,1,2,.500,0,0,0,1,2,.500,.500,0,0,0,0,0,0,0,0,0,0,0,2,20
Cameron Reynolds,SF,25,HOU,2,0,34,5,16,.313,3,12,.250,2,4,.500,.406,0,0,0,2,3,5,2,0,0,0,2,13,20
Nick Richards,PF,23,CHO,18,0,63,4,9,.444,0,1,0,4,8,.500,.444,7,11,.636,4,7,11,2,0,0,3,7,15,20
Josh Richardson,SG,27,DAL,59,56,1790,264,618,.427,88,267,.330,176,351,.501,.498,99,108,.917,51,144,195,153,61,24,79,130,715,20
Grant Riller,PG,23,CHO,7,0,27,8,12,.667,2,4,.500,6,8,.750,.750,0,0,0,0,1,1,3,1,0,1,0,18,20
Austin Rivers,SG,28,TOT,36,7,845,104,245,.424,55,149,.369,49,96,.510,.537,22,31,.710,8,74,82,81,30,2,36,64,285,20
Austin Rivers,SG,28,NYK,21,2,442,58,135,.430,28,77,.364,30,58,.517,.533,10,14,.714,5,42,47,42,12,0,22,32,154,20
Austin Rivers,SG,28,DEN,15,5,403,46,110,.418,27,72,.375,19,38,.500,.541,12,17,.706,3,32,35,39,18,2,14,32,131,20
Andre Roberson,SG,29,BRK,5,0,63,2,14,.143,1,8,.125,1,6,.167,.179,1,2,.500,7,8,15,4,3,1,2,4,6,20
Duncan Robinson,SF,26,MIA,72,72,2262,315,717,.439,250,613,.408,65,104,.625,.614,62,75,.827,7,243,250,127,43,20,81,181,942,20
Glenn Robinson III,SF,27,SAC,23,2,369,42,99,.424,16,44,.364,26,55,.473,.505,21,23,.913,11,34,45,20,4,3,11,23,121,20
Jerome Robinson,SG,23,WAS,17,6,305,28,95,.295,11,42,.262,17,53,.321,.353,16,20,.800,4,34,38,25,12,6,19,31,83,20
Justin Robinson,PG,23,OKC,9,0,88,7,21,.333,4,14,.286,3,7,.429,.429,3,5,.600,1,6,7,9,3,0,2,10,21,20
Mitchell Robinson,C,22,NYK,31,29,853,115,176,.653,0,0,0,115,176,.653,.653,26,53,.491,113,139,252,17,35,45,26,86,256,20
Isaiah Roby,PF,22,OKC,61,34,1425,207,429,.483,32,109,.294,175,320,.547,.520,87,117,.744,89,252,341,107,52,37,113,162,533,20
Rajon Rondo,PG,34,TOT,45,3,770,95,215,.442,36,89,.404,59,126,.468,.526,16,17,.941,18,92,110,199,37,4,79,53,242,20
Rajon Rondo,PG,34,ATL,27,2,402,44,110,.400,17,45,.378,27,65,.415,.477,1,2,.500,4,51,55,95,19,2,39,25,106,20
Rajon Rondo,PG,34,LAC,18,1,368,51,105,.486,19,44,.432,32,61,.525,.576,15,15,1.000,14,41,55,104,18,2,40,28,136,20
Derrick Rose,PG,32,TOT,50,3,1279,287,611,.470,50,129,.388,237,482,.492,.511,110,127,.866,20,110,130,209,49,19,78,56,734,20
Derrick Rose,PG,32,DET,15,0,342,79,184,.429,13,39,.333,66,145,.455,.465,42,50,.840,6,23,29,63,18,4,29,17,213,20
Derrick Rose,PG,32,NYK,35,3,937,208,427,.487,37,90,.411,171,337,.507,.530,68,77,.883,14,87,101,146,31,15,49,39,521,20
Terrence Ross,SG,29,ORL,46,2,1347,254,616,.412,89,264,.337,165,352,.469,.485,120,138,.870,15,143,158,108,47,21,74,88,717,20
Terry Rozier,SG,26,CHO,69,69,2383,510,1134,.450,222,571,.389,288,563,.512,.548,165,202,.817,47,255,302,293,87,26,128,119,1407,20
Ricky Rubio,PG,30,MIN,68,51,1772,193,498,.388,66,214,.308,127,284,.447,.454,130,150,.867,28,195,223,433,98,4,111,139,582,20
D'Angelo Russell,PG,24,MIN,42,26,1196,281,652,.431,120,310,.387,161,342,.471,.523,114,149,.765,16,95,111,244,45,18,112,68,796,20
Domantas Sabonis,PF,24,IND,62,62,2231,484,904,.535,52,162,.321,432,742,.582,.564,240,328,.732,150,592,742,415,76,33,213,203,1260,20
Luka Šamanić,PF,21,SAS,33,4,308,47,105,.448,12,43,.279,35,62,.565,.505,16,29,.552,16,52,68,15,8,8,20,43,122,20
JaKarr Sampson,PF,27,IND,29,4,316,56,113,.496,3,15,.200,53,98,.541,.509,19,29,.655,27,50,77,4,2,14,15,52,134,20
Dario Šarić,C,26,PHO,50,4,871,153,342,.447,47,135,.348,106,207,.512,.516,84,99,.848,46,144,190,65,30,4,57,95,437,20
Tomáš Satoranský,SG,29,CHI,58,18,1307,169,329,.514,42,118,.356,127,211,.602,.578,67,79,.848,30,112,142,271,40,14,96,89,447,20
Dennis Schröder,SG,27,LAL,61,61,1956,332,760,.437,71,212,.335,261,548,.476,.484,206,243,.848,30,181,211,351,70,13,163,159,941,20
Mike Scott,PF,32,PHI,51,12,852,76,211,.360,53,155,.342,23,56,.411,.486,8,12,.667,11,109,120,40,24,14,19,72,213,20
Jay Scrubb,SG,20,LAC,4,1,84,14,36,.389,2,9,.222,12,27,.444,.417,5,5,1.000,2,12,14,1,4,0,7,5,35,20
Collin Sexton,SG,22,CLE,60,60,2115,525,1105,.475,98,264,.371,427,841,.508,.519,312,383,.815,58,129,187,262,62,10,167,157,1460,20
Landry Shamet,SG,23,BRK,61,12,1403,186,456,.408,129,333,.387,57,123,.463,.549,66,78,.846,11,101,112,99,31,10,48,93,567,20
Iman Shumpert,SG,30,BRK,2,0,11,1,4,.250,0,3,0,1,1,1.000,.250,0,0,0,1,0,1,0,1,0,1,0,2,20
Pascal Siakam,PF,26,TOR,56,56,2006,437,961,.455,73,246,.297,364,715,.509,.493,249,301,.827,95,310,405,250,64,37,130,174,1196,20
Chris Silva,PF,24,TOT,15,0,92,10,16,.625,1,1,1.000,9,15,.600,.656,11,15,.733,7,20,27,6,1,6,10,24,32,20
Chris Silva,PF,24,MIA,11,0,83,9,13,.692,1,1,1.000,8,12,.667,.731,11,15,.733,7,18,25,6,1,5,9,20,30,20
Chris Silva,PF,24,SAC,4,0,9,1,3,.333,0,0,0,1,3,.333,.333,0,0,0,0,2,2,0,0,1,1,4,2,20
Ben Simmons,PG,24,PHI,58,58,1877,325,583,.557,3,10,.300,322,573,.562,.560,176,287,.613,93,324,417,401,93,35,173,171,829,20
Anfernee Simons,SG,21,POR,64,0,1104,168,401,.419,120,282,.426,48,119,.403,.569,46,57,.807,14,126,140,89,18,8,43,96,502,20
Deividas Sirvydis,SG,20,DET,20,0,133,14,40,.350,10,28,.357,4,12,.333,.475,3,6,.500,0,29,29,5,2,0,5,9,41,20
Alen Smailagić,PF,20,GSW,15,1,84,11,27,.407,4,10,.400,7,17,.412,.481,2,6,.333,6,10,16,4,3,5,5,11,28,20
Marcus Smart,PG,26,BOS,48,45,1581,203,510,.398,93,282,.330,110,228,.482,.489,128,162,.790,36,131,167,273,72,23,96,126,627,20
Dennis Smith Jr.,PG,23,TOT,23,9,420,58,145,.400,19,58,.328,39,87,.448,.466,19,26,.731,12,43,55,77,23,14,26,37,154,20
Dennis Smith Jr.,PG,23,NYK,3,0,28,2,10,.200,0,4,0,2,6,.333,.200,5,6,.833,0,2,2,3,3,0,1,4,9,20
Dennis Smith Jr.,PG,23,DET,20,9,392,56,135,.415,19,54,.352,37,81,.457,.485,14,20,.700,12,41,53,74,20,14,25,33,145,20
Ish Smith,PG,32,WAS,44,1,924,129,297,.434,18,49,.367,111,248,.448,.465,19,33,.576,22,128,150,172,32,13,41,62,295,20
Jalen Smith,PF,20,PHO,27,1,156,22,50,.440,4,17,.235,18,33,.545,.480,5,7,.714,7,30,37,4,1,5,7,16,53,20
Tony Snell,SG,29,ATL,47,23,992,88,171,.515,62,109,.569,26,62,.419,.696,11,11,1.000,18,94,112,59,13,11,21,75,249,20
Ray Spalding,C,23,HOU,2,0,19,2,4,.500,0,1,0,2,3,.667,.500,0,2,0,2,2,4,0,0,2,3,3,4,20
Cassius Stanley,SG,21,IND,24,0,93,13,43,.302,3,13,.231,10,30,.333,.337,7,9,.778,8,12,20,1,1,2,1,14,36,20
Lamar Stevens,PF,23,CLE,40,0,499,62,136,.456,4,25,.160,58,111,.523,.471,37,51,.725,24,72,96,25,17,13,23,53,165,20
Isaiah Stewart,C,19,DET,68,14,1455,226,409,.553,21,63,.333,205,346,.592,.578,64,92,.696,159,294,453,59,39,86,67,184,537,20
Max Strus,SF,24,MIA,39,0,507,85,187,.455,50,148,.338,35,39,.897,.588,16,24,.667,5,36,41,24,11,2,8,43,236,20
Edmond Sumner,SG,25,IND,53,24,861,148,282,.525,35,88,.398,113,194,.582,.587,68,83,.819,18,76,94,49,33,10,51,88,399,20
Jae'Sean Tate,SF,25,HOU,70,58,2043,316,625,.506,60,195,.308,256,430,.595,.554,102,147,.694,132,242,374,178,85,36,98,222,794,20
Jayson Tatum,SF,22,BOS,64,64,2290,605,1318,.459,187,485,.386,418,833,.502,.530,295,340,.868,50,422,472,276,75,31,171,122,1692,20
Jeff Teague,PG,32,TOT,55,7,950,123,284,.433,36,82,.439,87,202,.431,.496,89,105,.848,15,73,88,132,34,12,64,56,371,20
Jeff Teague,PG,32,BOS,34,5,616,78,188,.415,26,56,.464,52,132,.394,.484,51,61,.836,10,47,57,73,26,7,39,43,233,20
Jeff Teague,PG,32,MIL,21,2,334,45,96,.469,10,26,.385,35,70,.500,.521,38,44,.864,5,26,31,59,8,5,25,13,138,20
Garrett Temple,SG,34,CHI,56,25,1528,158,381,.415,67,200,.335,91,181,.503,.503,40,50,.800,29,131,160,124,43,30,58,126,423,20
Tyrell Terry,PG,20,DAL,11,0,56,5,16,.313,0,7,0,5,9,.556,.313,1,3,.333,0,6,6,6,5,0,2,2,11,20
Daniel Theis,C,28,TOT,65,51,1601,252,466,.541,49,152,.322,203,314,.646,.593,74,110,.673,93,263,356,108,41,57,66,167,627,20
Daniel Theis,C,28,BOS,42,37,1027,159,288,.552,33,95,.347,126,193,.653,.609,46,67,.687,54,166,220,67,25,43,41,120,397,20
Daniel Theis,C,28,CHI,23,14,574,93,178,.522,16,57,.281,77,121,.636,.567,28,43,.651,39,97,136,41,16,14,25,47,230,20
Brodric Thomas,SG,24,TOT,32,1,399,39,108,.361,16,59,.271,23,49,.469,.435,31,46,.674,8,45,53,30,15,10,22,40,125,20
Brodric Thomas,SG,24,HOU,4,0,24,2,7,.286,1,6,.167,1,1,1.000,.357,5,7,.714,1,3,4,4,1,1,4,5,10,20
Brodric Thomas,SG,24,CLE,28,1,375,37,101,.366,15,53,.283,22,48,.458,.441,26,39,.667,7,42,49,26,14,9,18,35,115,20
Isaiah Thomas,PG,31,NOP,3,0,48,9,27,.333,3,12,.250,6,15,.400,.389,2,2,1.000,1,3,4,5,1,0,6,3,23,20
Khyri Thomas,SG,24,HOU,5,2,153,32,66,.485,9,27,.333,23,39,.590,.553,9,9,1.000,7,11,18,25,9,6,6,8,82,20
Matt Thomas,SG,26,TOT,45,0,326,50,127,.394,27,80,.338,23,47,.489,.500,12,14,.857,7,37,44,19,4,0,14,18,139,20
Matt Thomas,SG,26,TOR,26,0,192,24,62,.387,17,41,.415,7,21,.333,.524,6,7,.857,3,18,21,9,2,0,6,10,71,20
Matt Thomas,SG,26,UTA,19,0,134,26,65,.400,10,39,.256,16,26,.615,.477,6,7,.857,4,19,23,10,2,0,8,8,68,20
Tristan Thompson,PF,29,BOS,54,43,1287,169,326,.518,0,3,0,169,323,.523,.518,71,120,.592,169,270,439,67,24,33,62,119,409,20
Sindarius Thornwell,SG,26,TOT,21,1,217,15,46,.326,7,23,.304,8,23,.348,.402,4,8,.500,3,15,18,21,13,2,7,15,41,20
Sindarius Thornwell,SG,26,NOP,14,1,73,7,21,.333,3,9,.333,4,12,.333,.405,0,2,0,1,4,5,4,5,1,4,3,17,20
Sindarius Thornwell,SG,26,ORL,7,0,144,8,25,.320,4,14,.286,4,11,.364,.400,4,6,.667,2,11,13,17,8,1,3,12,24,20
Matisse Thybulle,SG,23,PHI,65,8,1298,102,243,.420,43,143,.301,59,100,.590,.508,8,18,.444,30,94,124,63,105,71,32,127,255,20
Killian Tillie,C,22,MEM,18,1,182,19,57,.333,10,33,.303,9,24,.375,.421,9,11,.818,6,18,24,8,5,8,2,20,57,20
Xavier Tillman Sr.,PF,22,MEM,59,12,1085,167,299,.559,22,65,.338,145,234,.620,.595,34,53,.642,74,182,256,75,44,33,45,116,390,20
Anthony Tolliver,PF,35,PHI,11,0,99,4,17,.235,4,14,.286,0,3,0,.353,5,6,.833,3,7,10,2,3,2,3,7,17,20
Obi Toppin,PF,22,NYK,62,0,683,104,209,.498,26,85,.306,78,124,.629,.560,19,26,.731,26,112,138,29,17,15,23,55,253,20
Juan Toscano-Anderson,SG,27,GSW,53,16,1107,121,209,.579,37,92,.402,84,117,.718,.667,22,31,.710,29,205,234,150,41,26,61,111,301,20
Axel Toupane,SF,28,MIL,8,1,61,4,11,.364,1,2,.500,3,9,.333,.409,5,7,.714,0,6,6,4,2,3,0,6,14,20
Karl-Anthony Towns,C,25,MIN,50,50,1689,425,875,.486,122,315,.387,303,560,.541,.555,267,311,.859,133,396,529,225,39,57,160,186,1239,20
Gary Trent Jr.,SG,22,TOT,58,38,1802,320,785,.408,165,429,.385,155,356,.435,.513,83,106,.783,27,125,152,80,56,10,43,92,888,20
Gary Trent Jr.,SG,22,POR,41,23,1262,217,524,.414,121,305,.397,96,219,.438,.530,58,75,.773,21,70,91,58,37,6,31,63,613,20
Gary Trent Jr.,SG,22,TOR,17,15,540,103,261,.395,44,124,.355,59,137,.431,.479,25,31,.806,6,55,61,22,19,4,12,29,275,20
P.J. Tucker,PF,35,TOT,52,33,1356,66,177,.373,40,119,.336,26,58,.448,.486,21,28,.750,51,153,204,61,39,20,40,125,193,20
P.J. Tucker,PF,35,HOU,32,32,959,48,131,.366,27,86,.314,21,45,.467,.469,18,23,.783,33,115,148,45,29,18,33,91,141,20
P.J. Tucker,PF,35,MIL,20,1,397,18,46,.391,13,33,.394,5,13,.385,.533,3,5,.600,18,38,56,16,10,2,7,34,52,20
Rayjon Tucker,PG,23,PHI,14,0,68,9,18,.500,2,7,.286,7,11,.636,.556,14,19,.737,1,10,11,6,2,0,4,8,34,20
Myles Turner,C,24,IND,47,47,1455,206,432,.477,69,206,.335,137,226,.606,.557,111,142,.782,63,243,306,48,40,159,67,165,592,20
Jonas Valančiūnas,C,28,MEM,62,61,1755,440,743,.592,21,57,.368,419,686,.611,.606,157,203,.773,253,523,776,112,35,57,100,179,1058,20
Denzel Valentine,SG,27,CHI,62,3,1036,155,416,.373,80,242,.331,75,174,.431,.469,16,17,.941,24,173,197,105,30,7,42,70,406,20
Jarred Vanderbilt,PF,21,MIN,64,30,1139,143,236,.606,1,5,.200,142,231,.615,.608,57,102,.559,118,250,368,76,64,46,53,123,344,20
Fred VanVleet,SG,26,TOR,52,52,1899,338,870,.389,174,476,.366,164,394,.416,.489,169,191,.885,32,188,220,328,87,37,95,119,1019,20
Anderson Varejão,C,38,CLE,5,0,36,4,16,.250,0,1,0,4,15,.267,.250,5,9,.556,7,13,20,3,0,2,1,3,13,20
Devin Vassell,SF,20,SAS,62,7,1056,123,303,.406,52,150,.347,71,153,.464,.492,43,51,.843,24,150,174,56,43,18,22,88,341,20
Gabe Vincent,PG,24,MIA,50,7,655,88,233,.378,46,149,.309,42,84,.500,.476,20,23,.870,10,46,56,67,21,2,34,79,242,20
Noah Vonleh,C,25,BRK,4,0,11,0,3,0,0,2,0,0,1,0,0,0,0,0,0,1,1,1,0,0,2,2,0,20
Nikola Vučević,C,30,TOT,70,70,2348,666,1396,.477,176,440,.400,490,956,.513,.540,131,156,.840,146,671,817,269,65,48,126,137,1639,20
Nikola Vučević,C,30,ORL,44,44,1500,436,908,.480,117,288,.406,319,620,.515,.545,91,110,.827,87,430,517,167,42,28,83,79,1080,20
Nikola Vučević,C,30,CHI,26,26,848,230,488,.471,59,152,.388,171,336,.509,.532,40,46,.870,59,241,300,102,23,20,43,58,559,20
Dean Wade,PF,24,CLE,63,19,1212,134,311,.431,78,213,.366,56,98,.571,.556,30,39,.769,38,177,215,74,35,21,30,78,376,20
Moritz Wagner,C,23,TOT,45,24,722,104,229,.454,31,91,.341,73,138,.529,.522,71,87,.816,27,119,146,50,26,18,43,108,310,20
Moritz Wagner,C,23,WAS,25,13,375,62,122,.508,13,42,.310,49,80,.613,.561,41,52,.788,13,60,73,32,22,8,21,62,178,20
Moritz Wagner,C,23,BOS,9,1,61,4,14,.286,2,6,.333,2,8,.250,.357,1,2,.500,3,16,19,6,0,1,9,10,11,20
Moritz Wagner,C,23,ORL,11,10,286,38,93,.409,16,43,.372,22,50,.440,.495,29,33,.879,11,43,54,12,4,9,13,36,121,20
Kemba Walker,PG,30,BOS,43,43,1369,284,676,.420,127,353,.360,157,323,.486,.514,134,149,.899,16,154,170,212,48,12,88,61,829,20
Lonnie Walker IV,SG,22,SAS,60,38,1522,256,609,.420,100,282,.355,156,327,.477,.502,57,70,.814,14,141,155,101,29,15,65,101,669,20
John Wall,PG,30,HOU,40,40,1288,293,726,.404,79,249,.317,214,477,.449,.458,158,211,.749,17,112,129,275,42,31,141,46,823,20
Brad Wanamaker,PG,31,TOT,61,0,1053,115,299,.385,16,85,.188,99,214,.463,.411,90,101,.891,18,87,105,174,43,11,71,94,336,20
Brad Wanamaker,PG,31,GSW,39,0,625,61,173,.353,13,61,.213,48,112,.429,.390,50,56,.893,8,58,66,99,26,6,37,55,185,20
Brad Wanamaker,PG,31,CHO,22,0,428,54,126,.429,3,24,.125,51,102,.500,.440,40,45,.889,10,29,39,75,17,5,34,39,151,20
T.J. Warren,SF,27,IND,4,4,117,27,51,.529,0,7,0,27,44,.614,.529,8,10,.800,2,12,14,5,2,0,4,16,62,20
P.J. Washington,PF,22,CHO,64,61,1954,302,686,.440,112,290,.386,190,396,.480,.522,108,145,.745,93,325,418,161,69,79,128,171,824,20
Yuta Watanabe,SF,26,TOR,50,4,723,79,180,.439,36,90,.400,43,90,.478,.539,24,29,.828,36,123,159,40,26,19,19,57,218,20
Tremont Waters,PG,23,BOS,26,3,238,34,84,.405,15,38,.395,19,46,.413,.494,16,17,.941,5,16,21,62,15,1,27,17,99,20
Paul Watson,SF,26,TOR,27,2,297,38,82,.463,30,64,.469,8,18,.444,.646,5,8,.625,4,41,45,17,6,3,9,36,111,20
Quinndary Weatherspoon,SG,24,SAS,20,0,121,16,35,.457,1,6,.167,15,29,.517,.471,13,16,.813,3,8,11,8,8,2,10,18,46,20
Russell Westbrook,PG,32,WAS,65,65,2369,544,1238,.439,86,273,.315,458,965,.475,.474,271,413,.656,109,641,750,763,89,23,312,190,1445,20
Coby White,PG,20,CHI,69,54,2156,375,902,.416,163,454,.359,212,448,.473,.506,128,142,.901,28,256,284,328,38,15,156,179,1041,20
Derrick White,SG,26,SAS,36,32,1064,186,453,.411,84,243,.346,102,210,.486,.503,97,114,.851,13,94,107,127,26,36,45,91,553,20
Hassan Whiteside,C,31,SAC,36,4,546,126,224,.563,0,1,0,126,223,.565,.563,41,79,.519,61,154,215,20,9,46,40,73,293,20
Greg Whittington,PF,27,DEN,4,0,12,0,3,0,0,2,0,0,1,0,0,0,0,0,0,0,0,0,0,0,0,0,0,20
Andrew Wiggins,PF,25,GSW,71,71,2364,505,1058,.477,140,368,.380,365,690,.529,.543,170,238,.714,82,265,347,167,67,70,126,159,1320,20
Grant Williams,PF,22,BOS,63,9,1138,108,247,.437,48,129,.372,60,118,.508,.534,30,51,.588,48,130,178,64,32,24,56,161,294,20
Kenrich Williams,PF,26,OKC,66,13,1426,219,411,.533,52,117,.444,167,294,.568,.596,36,63,.571,84,189,273,152,55,17,76,143,526,20
Lou Williams,PG,34,TOT,66,4,1423,265,646,.410,69,173,.399,196,473,.414,.464,150,173,.867,21,117,138,225,47,6,108,62,749,20
Lou Williams,PG,34,LAC,42,3,918,181,430,.421,45,119,.378,136,311,.437,.473,103,119,.866,15,73,88,144,39,4,66,42,510,20
Lou Williams,PG,34,ATL,24,1,505,84,216,.389,24,54,.444,60,162,.370,.444,47,54,.870,6,44,50,81,8,2,42,20,239,20
Patrick Williams,PF,19,CHI,71,71,1983,255,528,.483,54,138,.391,201,390,.515,.534,91,125,.728,66,261,327,99,64,46,98,126,655,20
Robert Williams,C,23,BOS,52,13,985,186,258,.721,0,2,0,186,256,.727,.721,45,73,.616,133,225,358,94,43,91,52,105,417,20
Zion Williamson,PF,20,NOP,61,61,2026,634,1037,.611,10,34,.294,624,1003,.622,.616,369,529,.698,167,274,441,226,57,39,167,135,1647,20
D.J. Wilson,PF,24,TOT,35,1,433,68,168,.405,30,87,.345,38,81,.469,.494,17,25,.680,20,92,112,23,11,16,22,44,183,20
D.J. Wilson,PF,24,MIL,12,0,105,16,43,.372,10,28,.357,6,15,.400,.488,1,2,.500,3,22,25,3,1,4,4,13,43,20
D.J. Wilson,PF,24,HOU,23,1,328,52,125,.416,20,59,.339,32,66,.485,.496,16,23,.696,17,70,87,20,10,12,18,31,140,20
Dylan Windler,SF,24,CLE,31,0,513,57,130,.438,26,77,.338,31,53,.585,.538,21,27,.778,20,87,107,33,19,12,32,37,161,20
Justise Winslow,SF,24,MEM,26,1,507,74,210,.352,10,54,.185,64,156,.410,.376,20,35,.571,18,100,118,50,15,12,37,47,178,20
Cassius Winston,PG,22,WAS,22,0,98,14,33,.424,8,17,.471,6,16,.375,.545,5,6,.833,0,9,9,12,2,1,5,8,41,20
James Wiseman,C,19,GSW,39,27,836,191,368,.519,12,38,.316,179,330,.542,.535,54,86,.628,55,171,226,26,11,36,60,121,448,20
Christian Wood,C,25,HOU,41,41,1326,329,640,.514,77,206,.374,252,434,.581,.574,125,198,.631,76,319,395,71,34,48,80,88,860,20
Robert Woodard II,SF,21,SAC,13,0,45,8,20,.400,1,6,.167,7,14,.500,.425,3,8,.375,4,12,16,2,0,3,1,4,20,20
Delon Wright,SG-PG,28,TOT,63,39,1748,240,518,.463,64,172,.372,176,346,.509,.525,101,126,.802,65,204,269,278,101,30,83,75,645,20
Delon Wright,SG,28,DET,36,31,1052,136,293,.464,31,89,.348,105,204,.515,.517,71,90,.789,37,127,164,181,58,19,48,45,374,20
Delon Wright,PG,28,SAC,27,8,696,104,225,.462,33,83,.398,71,142,.500,.536,30,36,.833,28,77,105,97,43,11,35,30,271,20
Thaddeus Young,PF,32,CHI,68,23,1652,370,662,.559,12,45,.267,358,617,.580,.568,71,113,.628,168,255,423,291,74,40,137,152,823,20
Trae Young,PG,22,ATL,63,63,2125,487,1112,.438,136,397,.343,351,715,.491,.499,484,546,.886,38,207,245,594,53,12,261,111,1594,20
Cody Zeller,C,28,CHO,48,21,1005,181,324,.559,4,28,.143,177,296,.598,.565,85,119,.714,119,209,328,86,27,17,51,121,451,20
Ivica Zubac,C,23,LAC,72,33,1609,257,394,.652,1,4,.250,256,390,.656,.654,135,171,.789,189,330,519,90,24,62,81,187,650,20
Precious Achiuwa,C,22,TOR,73,28,1725,265,603,.439,56,156,.359,209,447,.468,.486,78,131,.595,146,327,473,82,37,41,84,151,664,21
Steven Adams,C,28,MEM,76,75,1999,210,384,.547,0,1,0,210,383,.548,.547,108,199,.543,349,411,760,256,65,60,115,153,528,21
Bam Adebayo,C,24,MIA,56,56,1825,406,729,.557,0,6,0,406,723,.562,.557,256,340,.753,137,427,564,190,80,44,148,171,1068,21
Santi Aldama,PF,21,MEM,32,0,360,53,132,.402,6,48,.125,47,84,.560,.424,20,32,.625,33,54,87,21,6,10,16,36,132,21
LaMarcus Aldridge,C,36,BRK,47,12,1050,252,458,.550,14,46,.304,238,412,.578,.566,89,102,.873,73,185,258,42,14,47,44,78,607,21
Nickeil Alexander-Walker,SG,23,TOT,65,21,1466,253,680,.372,105,338,.311,148,342,.433,.449,81,109,.743,37,150,187,156,46,23,93,103,692,21
Nickeil Alexander-Walker,SG,23,NOP,50,19,1317,237,632,.375,95,305,.311,142,327,.434,.450,70,97,.722,36,128,164,139,41,19,85,88,639,21
Nickeil Alexander-Walker,SG,23,UTA,15,2,149,16,48,.333,10,33,.303,6,15,.400,.438,11,12,.917,1,22,23,17,5,4,8,15,53,21
Grayson Allen,SG,26,MIL,66,61,1805,255,569,.448,159,389,.409,96,180,.533,.588,64,74,.865,32,190,222,100,46,18,43,96,733,21
Jarrett Allen,C,23,CLE,56,56,1809,369,545,.677,1,10,.100,368,535,.688,.678,165,233,.708,192,410,602,92,44,75,94,97,904,21
Jose Alvarado,PG,23,NOP,54,1,834,131,294,.446,32,110,.291,99,184,.538,.500,36,53,.679,25,75,100,152,71,7,40,73,330,21
Justin Anderson,SF,28,TOT,16,6,316,36,95,.379,15,59,.254,21,36,.583,.458,15,19,.789,4,42,46,33,8,6,8,22,102,21
Justin Anderson,SF,28,CLE,3,0,47,4,8,.500,2,6,.333,2,2,1.000,.625,3,4,.750,0,6,6,6,1,0,2,4,13,21
Justin Anderson,SF,28,IND,13,6,269,32,87,.368,13,53,.245,19,34,.559,.443,12,15,.800,4,36,40,27,7,6,6,18,89,21
Kyle Anderson,PF,28,MEM,69,11,1484,209,469,.446,36,109,.330,173,360,.481,.484,67,105,.638,69,299,368,183,77,45,71,108,521,21
Giannis Antetokounmpo,PF,27,MIL,67,67,2204,689,1245,.553,71,242,.293,618,1003,.616,.582,553,766,.722,134,644,778,388,72,91,219,212,2002,21
Thanasis Antetokounmpo,SF,29,MIL,48,6,473,70,128,.547,2,14,.143,68,114,.596,.555,29,46,.630,40,61,101,22,16,12,26,68,171,21
Carmelo Anthony,PF,37,LAL,69,3,1793,319,723,.441,149,397,.375,170,326,.521,.544,132,159,.830,62,226,288,68,47,52,59,166,919,21
Cole Anthony,PG,21,ORL,65,65,2059,357,912,.391,132,391,.338,225,521,.432,.464,216,253,.854,32,316,348,369,46,17,170,171,1062,21
OG Anunoby,SF,24,TOR,48,48,1728,309,697,.443,115,317,.363,194,380,.511,.526,89,118,.754,74,190,264,125,71,25,80,131,822,21
Ryan Arcidiacono,PG,27,NYK,10,0,76,6,12,.500,4,9,.444,2,3,.667,.667,0,0,0,0,8,8,4,1,0,3,5,16,21
Trevor Ariza,SF,36,LAL,24,11,462,33,99,.333,20,74,.270,13,25,.520,.434,10,18,.556,10,72,82,27,13,6,11,20,96,21
D.J. Augustin,PG,34,TOT,55,2,883,94,222,.423,68,164,.415,26,58,.448,.577,38,43,.884,11,57,68,107,17,1,56,39,294,21
D.J. Augustin,PG,34,HOU,34,2,510,55,136,.404,39,96,.406,16,40,.400,.548,33,38,.868,7,34,41,74,10,0,45,17,182,21
D.J. Augustin,PG,34,LAL,21,0,373,39,86,.453,29,68,.426,10,18,.556,.622,5,5,1.000,4,23,27,33,7,1,11,22,112,21
Deni Avdija,SF,21,WAS,82,8,1984,250,579,.432,82,259,.317,168,320,.525,.503,103,136,.757,52,373,425,167,59,44,87,190,685,21
Joel Ayayi,SG,21,WAS,7,0,20,1,6,.167,0,1,0,1,5,.200,.167,0,0,0,1,2,3,4,0,0,0,0,2,21
Deandre Ayton,C,23,PHO,58,58,1713,442,697,.634,7,19,.368,435,678,.642,.639,106,142,.746,149,444,593,84,40,40,91,142,997,21
Udoka Azubuike,C,22,UTA,17,6,195,37,49,.755,0,0,0,37,49,.755,.755,6,11,.545,18,53,71,0,1,11,12,25,80,21
Marvin Bagley III,PF,22,TOT,48,25,1146,225,446,.504,23,97,.237,202,349,.579,.530,67,101,.663,105,233,338,36,22,18,39,93,540,21
Marvin Bagley III,PF,22,SAC,30,17,656,114,246,.463,15,62,.242,99,184,.538,.494,35,47,.745,67,148,215,17,9,11,21,50,278,21
Marvin Bagley III,PF,22,DET,18,8,490,111,200,.555,8,35,.229,103,165,.624,.575,32,54,.593,38,85,123,19,13,7,18,43,262,21
LaMelo Ball,PG,20,CHO,75,75,2422,538,1254,.429,220,565,.389,318,689,.462,.517,212,243,.872,108,393,501,571,119,30,245,237,1508,21
Lonzo Ball,PG,24,CHI,35,35,1212,162,383,.423,110,260,.423,52,123,.423,.567,21,28,.750,35,155,190,178,64,31,82,85,455,21
Mo Bamba,C,23,ORL,71,69,1824,296,617,.480,107,281,.381,189,336,.563,.566,57,73,.781,148,424,572,85,38,118,77,182,756,21
Desmond Bane,SG,23,MEM,76,76,2266,508,1101,.461,228,523,.436,280,578,.484,.565,140,155,.903,46,288,334,208,92,29,111,196,1384,21
Dalano Banton,PG,22,TOR,64,1,696,83,202,.411,13,51,.255,70,151,.464,.443,26,44,.591,38,86,124,99,28,10,53,68,205,21
Cat Barber,PG,27,ATL,3,0,13,0,4,0,0,0,0,0,4,0,0,0,4,0,1,2,3,3,0,0,1,1,0,21
Harrison Barnes,PF,29,SAC,77,77,2587,391,834,.469,142,360,.394,249,474,.525,.554,341,413,.826,82,350,432,186,53,14,118,94,1265,21
Scottie Barnes,PF,20,TOR,74,74,2617,459,932,.492,58,193,.301,401,739,.543,.524,158,215,.735,195,362,557,256,80,55,136,192,1134,21
RJ Barrett,SF,21,NYK,70,70,2417,487,1194,.408,138,404,.342,349,790,.442,.466,290,406,.714,66,342,408,208,43,16,151,142,1402,21
Will Barton,SG,31,DEN,71,71,2277,392,896,.438,157,430,.365,235,466,.504,.525,102,127,.803,44,296,340,276,55,31,127,114,1043,21
Paris Bass,SF,26,PHO,2,0,7,2,6,.333,0,2,0,2,4,.500,.333,2,2,1.000,2,2,4,0,1,0,2,2,6,21
Charles Bassey,C,21,PHI,23,0,168,30,47,.638,0,4,0,30,43,.698,.638,9,12,.750,22,40,62,7,5,17,8,32,69,21
Keita Bates-Diop,SF,26,SAS,59,14,956,136,263,.517,17,55,.309,119,208,.572,.549,46,61,.754,62,169,231,41,27,14,45,61,335,21
Nicolas Batum,PF,33,LAC,59,54,1462,179,387,.463,108,270,.400,71,117,.607,.602,25,38,.658,29,225,254,100,58,42,40,80,491,21
Kent Bazemore,SF,32,LAL,39,14,545,45,139,.324,29,80,.363,16,59,.271,.428,13,17,.765,13,56,69,34,25,9,21,70,132,21
Darius Bazley,PF,21,OKC,69,53,1924,274,649,.422,80,269,.297,194,380,.511,.484,117,170,.688,71,365,436,97,58,70,90,68,745,21
Bradley Beal,SG,28,WAS,40,40,1439,348,771,.451,63,210,.300,285,561,.508,.492,169,203,.833,38,151,189,265,36,15,135,95,928,21
Malik Beasley,SG,25,MIN,79,18,1976,332,850,.391,240,637,.377,92,213,.432,.532,49,60,.817,26,201,227,116,43,12,43,88,953,21
Jordan Bell,C,27,CHI,1,0,2,0,0,0,0,0,0,0,0,0,0,0,0,0,1,0,1,0,1,0,0,2,0,21
DeAndre' Bembry,SF,27,TOT,56,20,1026,124,221,.561,15,36,.417,109,185,.589,.595,21,35,.600,42,121,163,66,49,25,31,113,284,21
DeAndre' Bembry,SF,27,BRK,48,20,949,121,213,.568,15,36,.417,106,177,.599,.603,21,35,.600,38,114,152,60,47,25,30,104,278,21
DeAndre' Bembry,SF,27,MIL,8,0,77,3,8,.375,0,0,0,3,8,.375,.375,0,0,0,4,7,11,6,2,0,1,9,6,21
Dāvis Bertāns,PF,29,TOT,56,0,807,99,275,.360,77,230,.335,22,45,.489,.500,36,40,.900,12,105,117,31,17,12,19,85,311,21
Dāvis Bertāns,PF,29,WAS,34,0,501,60,171,.351,46,144,.319,14,27,.519,.485,28,30,.933,6,55,61,16,11,6,14,55,194,21
Dāvis Bertāns,PF,29,DAL,22,0,306,39,104,.375,31,86,.360,8,18,.444,.524,8,10,.800,6,50,56,15,6,6,5,30,117,21
Patrick Beverley,PG,33,MIN,58,54,1476,177,436,.406,83,242,.343,94,194,.485,.501,96,133,.722,62,178,240,268,67,52,73,174,533,21
Saddiq Bey,SF,22,DET,82,82,2704,450,1136,.396,211,610,.346,239,526,.454,.489,210,254,.827,107,334,441,233,73,16,96,128,1321,21
Khem Birch,C,29,TOR,55,28,991,97,200,.485,0,14,0,97,186,.522,.485,53,71,.746,122,117,239,56,30,26,29,104,247,21
Goga Bitadze,C,22,IND,50,16,729,131,252,.520,23,80,.288,108,172,.628,.565,64,94,.681,79,98,177,55,21,42,46,107,349,21
Bismack Biyombo,C,29,PHO,36,3,506,86,145,.593,0,0,0,86,145,.593,.593,38,71,.535,63,104,167,23,12,26,25,70,210,21
Nemanja Bjelica,C,33,GSW,71,0,1142,160,342,.468,54,149,.362,106,193,.549,.547,59,81,.728,62,232,294,159,41,26,87,128,433,21
Eric Bledsoe,PG,32,LAC,54,29,1361,197,468,.421,51,163,.313,146,305,.479,.475,89,117,.761,28,154,182,225,69,19,116,85,534,21
Keljin Blevins,SF,26,POR,31,1,349,34,111,.306,21,72,.292,13,39,.333,.401,6,11,.545,16,29,45,19,13,1,17,29,95,21
Bogdan Bogdanović,SG,29,ATL,63,27,1848,342,794,.431,169,459,.368,173,335,.516,.537,97,115,.843,29,221,250,194,68,14,70,132,950,21
Bojan Bogdanović,PF,32,UTA,69,69,2131,422,928,.455,181,468,.387,241,460,.524,.552,223,260,.858,58,238,296,120,34,1,118,116,1248,21
Bol Bol,PF,22,DEN,14,0,81,15,27,.556,1,4,.250,14,23,.609,.574,2,5,.400,4,16,20,5,1,2,4,4,33,21
Leandro Bolmaro,SF,21,MIN,35,2,241,17,54,.315,5,18,.278,12,36,.333,.361,11,13,.846,16,27,43,21,6,0,13,26,50,21
Isaac Bonga,SF,22,TOR,15,0,69,3,13,.231,1,4,.250,2,9,.222,.269,5,8,.625,4,3,7,4,8,2,2,10,12,21
Devin Booker,SG,25,PHO,68,68,2345,662,1421,.466,183,478,.383,479,943,.508,.530,315,363,.868,45,297,342,329,77,26,162,180,1822,21
Brandon Boston Jr.,SG,20,LAC,51,0,760,125,325,.385,34,111,.306,91,214,.425,.437,59,72,.819,17,94,111,51,26,13,31,43,343,21
Chris Boucher,SF,29,TOR,80,9,1690,268,577,.464,68,229,.297,200,348,.575,.523,150,193,.777,179,315,494,25,49,75,42,174,754,21
James Bouknight,SG,21,CHO,31,0,304,49,141,.348,17,49,.347,32,92,.348,.408,27,31,.871,22,30,52,26,7,1,15,29,142,21
Avery Bradley,SG,31,LAL,62,45,1406,148,350,.423,82,210,.390,66,140,.471,.540,16,18,.889,31,105,136,47,53,9,38,118,394,21
Tony Bradley,C,24,CHI,55,7,549,72,123,.585,0,0,0,72,123,.585,.585,19,29,.655,67,119,186,27,10,33,34,62,163,21
Ignas Brazdeikis,SF,23,ORL,42,1,536,81,188,.431,27,87,.310,54,101,.535,.503,21,32,.656,23,49,72,37,10,3,17,48,210,21
Mikal Bridges,SF,25,PHO,82,82,2854,458,858,.534,115,312,.369,343,546,.628,.601,131,157,.834,74,273,347,185,96,36,68,150,1162,21
Miles Bridges,PF,23,CHO,80,80,2837,596,1214,.491,154,465,.331,442,749,.590,.554,267,333,.802,90,469,559,300,74,67,150,193,1613,21
Oshae Brissett,SF,23,IND,67,25,1564,208,506,.411,83,237,.350,125,269,.465,.493,114,164,.695,108,250,358,72,44,29,54,116,613,21
Malcolm Brogdon,PG,29,IND,36,36,1206,243,543,.448,58,186,.312,185,357,.518,.501,143,167,.856,33,152,185,212,30,14,77,71,687,21
Armoni Brooks,SG-PG,23,TOT,54,11,844,98,289,.339,74,249,.297,24,40,.600,.467,18,21,.857,20,83,103,62,28,11,27,74,288,21
Armoni Brooks,SG,23,HOU,41,8,690,87,251,.347,64,213,.300,23,38,.605,.474,16,19,.842,12,69,81,49,21,8,23,60,254,21
Armoni Brooks,PG,23,TOR,13,3,154,11,38,.289,10,36,.278,1,2,.500,.421,2,2,1.000,8,14,22,13,7,3,4,14,34,21
Dillon Brooks,SF,26,MEM,32,31,885,227,526,.432,46,149,.309,181,377,.480,.475,90,106,.849,29,73,102,88,36,8,50,105,590,21
Bruce Brown,SF,25,BRK,72,45,1774,256,506,.506,38,94,.404,218,412,.529,.543,97,128,.758,100,245,345,148,77,52,56,176,647,21
Charlie Brown Jr.,SG,24,TOT,22,2,177,10,39,.256,1,12,.083,9,27,.333,.269,9,10,.900,14,18,32,6,10,4,5,18,30,21
Charlie Brown Jr.,SG,24,DAL,3,0,15,1,5,.200,0,3,0,1,2,.500,.200,0,0,0,0,1,1,1,2,1,0,2,2,21
Charlie Brown Jr.,SG,24,PHI,19,2,162,9,34,.265,1,9,.111,8,25,.320,.279,9,10,.900,14,17,31,5,8,3,5,16,28,21
Chaundee Brown Jr.,SG-SF,23,TOT,5,2,104,10,32,.313,6,18,.333,4,14,.286,.406,5,6,.833,1,15,16,4,2,0,1,7,31,21
Chaundee Brown Jr.,SF,23,LAL,2,0,21,1,7,.143,0,3,0,1,4,.250,.143,0,0,0,0,2,2,0,0,0,1,0,2,21
Chaundee Brown Jr.,SG,23,ATL,3,2,83,9,25,.360,6,15,.400,3,10,.300,.480,5,6,.833,1,13,14,4,2,0,0,7,29,21
Greg Brown III,SF,20,POR,48,6,640,81,190,.426,19,61,.311,62,129,.481,.476,44,65,.677,38,97,135,35,26,24,36,90,225,21
Jaylen Brown,SF,25,BOS,66,66,2220,576,1217,.473,166,464,.358,410,753,.544,.541,241,318,.758,53,351,404,231,70,18,178,163,1559,21
Moses Brown,C,22,TOT,40,6,345,64,108,.593,0,0,0,64,108,.593,.593,43,72,.597,39,96,135,1,7,16,20,53,171,21
Moses Brown,C,22,DAL,26,1,169,27,50,.540,0,0,0,27,50,.540,.540,27,43,.628,16,45,61,1,3,9,14,28,81,21
Moses Brown,C,22,CLE,14,5,176,37,58,.638,0,0,0,37,58,.638,.638,16,29,.552,23,51,74,0,4,7,6,25,90,21
Sterling Brown,SG,26,DAL,49,3,628,59,155,.381,28,92,.304,31,63,.492,.471,14,15,.933,26,123,149,34,14,7,23,56,160,21
Troy Brown Jr.,SF,22,CHI,66,7,1055,108,258,.419,47,133,.353,61,125,.488,.510,20,26,.769,39,164,203,66,36,5,26,62,283,21
Jalen Brunson,SG,25,DAL,79,61,2524,506,1008,.502,94,252,.373,412,756,.545,.549,179,213,.840,43,266,309,377,66,3,124,151,1285,21
Thomas Bryant,C,24,WAS,27,9,439,77,148,.520,12,42,.286,65,106,.613,.561,35,40,.875,26,82,108,23,6,21,19,43,201,21
Shaq Buchanan,SG,25,MEM,2,0,10,1,4,.250,0,2,0,1,2,.500,.250,0,0,0,1,1,2,2,1,0,2,1,2,21
Reggie Bullock,SF,30,DAL,68,37,1902,201,501,.401,141,392,.360,60,109,.550,.542,40,48,.833,33,208,241,83,41,14,40,111,583,21
Trey Burke,PG,29,DAL,42,0,441,84,215,.391,26,82,.317,58,133,.436,.451,20,23,.870,4,29,33,57,12,0,26,39,214,21
Alec Burks,SG,30,NYK,81,44,2318,285,728,.391,157,389,.404,128,339,.378,.499,217,264,.822,47,350,397,239,85,26,91,215,944,21
Jared Butler,SG,21,UTA,42,1,360,61,151,.404,28,88,.318,33,63,.524,.497,11,16,.688,5,40,45,63,17,8,33,47,161,21
Jimmy Butler,SF,32,MIA,57,57,1931,398,829,.480,27,116,.233,371,713,.520,.496,396,455,.870,102,234,336,312,94,27,121,88,1219,21
Devontae Cacok,PF,25,SAS,15,0,121,21,31,.677,0,0,0,21,31,.677,.677,4,7,.571,8,34,42,6,8,7,3,16,46,21
Kentavious Caldwell-Pope,SG,28,WAS,77,77,2329,361,829,.435,159,408,.390,202,421,.480,.531,137,154,.890,41,220,261,145,83,26,97,139,1018,21
Facundo Campazzo,PG,30,DEN,65,4,1184,107,296,.361,58,193,.301,49,103,.476,.459,60,78,.769,23,94,117,220,63,23,67,124,332,21
Vlatko Čančar,PF,24,DEN,15,1,176,23,41,.561,7,12,.583,16,29,.552,.646,9,14,.643,8,23,31,17,2,3,9,18,62,21
Devin Cannady,PG,25,ORL,5,0,145,15,44,.341,15,37,.405,0,7,0,.511,5,7,.714,1,5,6,10,5,3,5,9,50,21
Clint Capela,C,27,ATL,74,73,2042,370,604,.613,0,1,0,370,603,.614,.613,80,169,.473,279,598,877,92,55,93,44,166,820,21
Vernon Carey Jr.,C,20,TOT,7,1,44,7,13,.538,0,0,0,7,13,.538,.538,6,13,.462,8,4,12,0,2,1,3,4,20,21
Vernon Carey Jr.,C,20,CHO,4,1,17,3,6,.500,0,0,0,3,6,.500,.500,2,3,.667,3,2,5,0,1,0,1,1,8,21
Vernon Carey Jr.,C,20,WAS,3,0,27,4,7,.571,0,0,0,4,7,.571,.571,4,10,.400,5,2,7,0,1,1,2,3,12,21
Jevon Carter,PG,26,TOT,66,3,905,98,253,.387,66,170,.388,32,83,.386,.518,15,18,.833,14,96,110,96,24,14,34,67,277,21
Jevon Carter,PG,26,BRK,46,1,552,58,174,.333,42,127,.331,16,47,.340,.454,7,10,.700,9,58,67,46,14,10,26,45,165,21
Jevon Carter,PG,26,MIL,20,2,353,40,79,.506,24,43,.558,16,36,.444,.658,8,8,1.000,5,38,43,50,10,4,8,22,112,21
Wendell Carter Jr.,PF,22,ORL,62,61,1852,359,684,.525,70,214,.327,289,470,.615,.576,143,207,.691,139,509,648,171,36,43,117,169,931,21
Alex Caruso,SG,27,CHI,41,18,1147,102,256,.398,42,126,.333,60,130,.462,.480,58,73,.795,33,115,148,165,71,15,57,106,304,21
Willie Cauley-Stein,C,28,TOT,20,2,183,16,35,.457,1,2,.500,15,33,.455,.471,1,2,.500,13,27,40,10,6,3,7,19,34,21
Willie Cauley-Stein,C,28,DAL,18,2,177,16,35,.457,1,2,.500,15,33,.455,.471,1,2,.500,13,25,38,9,6,3,7,17,34,21
Willie Cauley-Stein,C,28,PHI,2,0,6,0,0,0,0,0,0,0,0,0,0,0,0,0,0,2,2,1,0,0,0,2,0,21
Ahmad Caver,SG,25,IND,1,0,1,1,1,1.000,0,0,0,1,1,1.000,1.000,0,0,0,0,0,0,0,0,0,0,0,2,21
Justin Champagnie,SF,20,TOR,36,0,281,31,67,.463,10,28,.357,21,39,.538,.537,9,9,1.000,37,35,72,11,8,4,8,32,81,21
Zylan Cheatham,SF,26,UTA,1,0,5,0,3,0,0,2,0,0,1,0,0,0,0,0,0,0,0,0,0,0,0,0,0,21
Chris Chiozza,PG,26,GSW,34,1,372,24,81,.296,17,53,.321,7,28,.250,.401,2,3,.667,9,27,36,65,13,0,32,32,67,21
Marquese Chriss,PF,24,DAL,34,0,346,62,134,.463,8,25,.320,54,109,.495,.493,22,33,.667,33,70,103,17,13,12,17,64,154,21
Josh Christopher,SG,20,HOU,74,2,1334,224,500,.448,56,189,.296,168,311,.540,.504,83,113,.735,52,134,186,150,65,13,114,97,587,21
Gary Clark,PF,27,NOP,38,1,378,33,88,.375,28,70,.400,5,18,.278,.534,7,10,.700,23,67,90,18,13,7,10,20,101,21
Brandon Clarke,PF,25,MEM,64,1,1246,288,447,.644,5,22,.227,283,425,.666,.650,85,130,.654,135,207,342,86,39,68,34,122,666,21
Jordan Clarkson,SG,29,UTA,79,1,2141,466,1113,.419,190,597,.318,276,516,.535,.504,144,174,.828,67,206,273,194,66,16,129,149,1266,21
Nic Claxton,C,22,BRK,47,19,974,178,264,.674,0,0,0,178,264,.674,.674,54,93,.581,91,173,264,43,24,51,38,110,410,21
Amir Coffey,SG,24,LAC,69,30,1567,211,466,.453,96,254,.378,115,212,.542,.556,101,117,.863,26,171,197,124,38,15,45,87,619,21
John Collins,PF,24,ATL,54,53,1663,339,644,.526,64,176,.364,275,468,.588,.576,134,169,.793,93,329,422,98,33,56,60,164,876,21
Zach Collins,C,24,SAS,28,4,502,76,155,.490,14,41,.341,62,114,.544,.535,52,65,.800,46,107,153,61,13,23,45,67,218,21
Darren Collison,PG,34,LAL,3,0,37,2,7,.286,0,3,0,2,4,.500,.286,0,0,0,0,4,4,2,1,0,1,5,4,21
Mike Conley,PG,34,UTA,72,72,2058,344,791,.435,169,414,.408,175,377,.464,.542,129,162,.796,47,170,217,385,96,21,123,142,986,21
Pat Connaughton,SF,29,MIL,65,19,1691,227,496,.458,146,370,.395,81,126,.643,.605,45,54,.833,45,228,273,82,59,15,35,86,645,21
Tyler Cook,PF,24,CHI,20,2,200,23,38,.605,0,0,0,23,38,.605,.605,21,32,.656,16,37,53,3,4,4,7,28,67,21
Sharife Cooper,PG,20,ATL,13,0,39,3,14,.214,1,6,.167,2,8,.250,.250,0,0,0,0,5,5,5,0,0,5,1,7,21
Petr Cornelie,PF,26,DEN,13,0,38,5,15,.333,1,8,.125,4,7,.571,.367,3,4,.750,7,7,14,3,1,1,4,7,14,21
DeMarcus Cousins,C,31,TOT,48,7,718,149,324,.460,37,122,.303,112,202,.554,.517,95,125,.760,74,196,270,71,35,21,85,139,430,21
DeMarcus Cousins,C,31,MIL,17,5,287,55,118,.466,13,48,.271,42,70,.600,.521,31,38,.816,24,74,98,18,16,8,16,46,154,21
DeMarcus Cousins,C,31,DEN,31,2,431,94,206,.456,24,74,.324,70,132,.530,.515,64,87,.736,50,122,172,53,19,13,69,93,276,21
Robert Covington,PF,31,TOT,71,42,1940,209,498,.420,128,339,.378,81,159,.509,.548,58,69,.841,59,332,391,92,103,91,75,190,604,21
Robert Covington,PF,31,POR,48,40,1431,128,336,.381,79,230,.343,49,106,.462,.499,30,36,.833,41,233,274,68,74,63,58,132,365,21
Robert Covington,PF,31,LAC,23,2,509,81,162,.500,49,109,.450,32,53,.604,.651,28,33,.848,18,99,117,24,29,28,17,58,239,21
Torrey Craig,SF,31,TOT,78,16,1596,200,441,.454,77,234,.329,123,207,.594,.541,39,52,.750,86,224,310,91,46,36,67,151,516,21
Torrey Craig,SF,31,IND,51,14,1034,128,281,.456,46,138,.333,82,143,.573,.537,27,35,.771,59,136,195,58,24,19,39,95,329,21
Torrey Craig,SF,31,PHO,27,2,562,72,160,.450,31,96,.323,41,64,.641,.547,12,17,.706,27,88,115,33,22,17,28,56,187,21
Jae Crowder,PF,31,PHO,67,67,1886,217,544,.399,127,365,.348,90,179,.503,.516,71,90,.789,30,324,354,124,95,30,55,173,632,21
Jarrett Culver,SG,22,MEM,37,0,338,51,135,.378,12,47,.255,39,88,.443,.422,16,34,.471,13,35,48,33,20,5,20,42,130,21
Jarron Cumberland,SG,24,POR,3,0,12,1,2,.500,0,1,0,1,1,1.000,.500,0,0,0,1,2,3,1,0,0,0,2,2,21
Cade Cunningham,SG,20,DET,64,64,2088,429,1031,.416,114,363,.314,315,668,.472,.471,142,168,.845,58,296,354,356,78,43,234,200,1114,21
Seth Curry,SG,31,TOT,64,64,2135,360,739,.487,158,374,.422,202,365,.553,.594,82,94,.872,21,179,200,230,53,14,109,148,960,21
Seth Curry,SG,31,PHI,45,45,1566,256,528,.485,100,250,.400,156,278,.561,.580,64,73,.877,17,134,151,181,36,11,84,101,676,21
Seth Curry,SG,31,BRK,19,19,569,104,211,.493,58,124,.468,46,87,.529,.630,18,21,.857,4,45,49,49,17,3,25,47,284,21
Stephen Curry,PG,33,GSW,64,64,2211,535,1224,.437,285,750,.380,250,474,.527,.554,275,298,.923,34,301,335,404,85,23,206,130,1630,21
Anthony Davis,C,28,LAL,40,40,1404,370,695,.532,13,70,.186,357,625,.571,.542,174,244,.713,106,288,394,122,49,90,82,97,927,21
Ed Davis,C,32,CLE,31,3,201,11,16,.688,0,0,0,11,16,.688,.688,6,14,.429,14,50,64,7,3,9,5,33,28,21
Terence Davis,SG,24,SAC,30,11,536,113,267,.423,49,149,.329,64,118,.542,.515,36,44,.818,11,83,94,40,25,11,33,70,311,21
Gabriel Deck,PF,26,OKC,7,0,56,8,14,.571,2,4,.500,6,10,.600,.643,0,0,0,1,5,6,5,1,0,2,2,18,21
Dewayne Dedmon,C,32,MIA,67,15,1065,164,290,.566,19,47,.404,145,243,.597,.598,75,100,.750,105,281,386,47,24,42,70,174,422,21
Sam Dekker,PF,27,TOR,1,0,1,0,0,0,0,0,0,0,0,0,0,0,0,0,0,0,0,0,0,0,0,0,0,21
Javin DeLaurier,C,23,MIL,1,0,3,0,0,0,0,0,0,0,0,0,0,0,0,0,0,1,1,0,1,0,0,1,0,21
DeMar DeRozan,PF,32,CHI,76,76,2743,774,1535,.504,50,142,.352,724,1393,.520,.521,520,593,.877,56,336,392,374,68,24,181,178,2118,21
Mamadi Diakite,PF,25,OKC,13,3,188,25,47,.532,0,5,0,25,42,.595,.532,6,11,.545,17,42,59,2,5,9,7,33,56,21
Cheick Diallo,C,25,DET,3,0,31,3,8,.375,0,0,0,3,8,.375,.375,5,6,.833,4,8,12,0,1,0,1,6,11,21
Hamidou Diallo,SG,23,DET,58,29,1269,261,526,.496,23,93,.247,238,433,.550,.518,91,140,.650,69,208,277,73,71,17,58,143,636,21
Gorgui Dieng,C,32,ATL,44,3,371,53,112,.473,29,68,.426,24,44,.545,.603,19,26,.731,32,89,121,34,11,13,20,52,154,21
Spencer Dinwiddie,PG,28,TOT,67,51,1980,306,735,.416,112,330,.339,194,405,.479,.493,195,252,.774,45,234,279,346,44,13,104,150,919,21
Spencer Dinwiddie,PG,28,WAS,44,44,1330,185,492,.376,70,226,.310,115,266,.432,.447,116,143,.811,36,171,207,256,27,7,73,107,556,21
Spencer Dinwiddie,PG,28,DAL,23,7,650,121,243,.498,42,104,.404,79,139,.568,.584,79,109,.725,9,63,72,90,17,6,31,43,363,21
Donte DiVincenzo,SG,25,TOT,42,1,1006,118,336,.351,74,218,.339,44,118,.373,.461,70,83,.843,40,130,170,118,48,8,72,69,380,21
Donte DiVincenzo,SG,25,MIL,17,0,341,39,118,.331,21,74,.284,18,44,.409,.419,23,27,.852,18,42,60,29,11,3,28,26,122,21
Donte DiVincenzo,SG,25,SAC,25,1,665,79,218,.362,53,144,.368,26,74,.351,.484,47,56,.839,22,88,110,89,37,5,44,43,258,21
Luka Dončić,PG,22,DAL,65,65,2301,641,1403,.457,201,569,.353,440,834,.528,.529,364,489,.744,56,537,593,568,75,36,292,145,1847,21
Luguentz Dort,SG,22,OKC,51,51,1665,293,726,.404,130,391,.332,163,335,.487,.493,161,191,.843,38,174,212,88,46,18,88,149,877,21
Ayo Dosunmu,SG,22,CHI,77,40,2110,278,535,.520,70,186,.376,208,349,.596,.585,53,78,.679,27,187,214,256,60,29,108,182,679,21
Damyean Dotson,SG,27,NYK,2,0,21,2,4,.500,0,1,0,2,3,.667,.500,0,0,0,0,2,2,1,0,0,0,0,4,21
Devon Dotson,PG,22,CHI,11,0,85,11,23,.478,2,9,.222,9,14,.643,.522,5,9,.556,1,8,9,15,1,0,5,11,29,21
Sekou Doumbouya,PF,21,LAL,2,0,16,5,8,.625,1,2,.500,4,6,.667,.688,3,4,.750,2,4,6,0,3,2,2,1,14,21
Jeff Dowtin,PG,24,TOT,9,0,108,8,26,.308,1,9,.111,7,17,.412,.327,2,2,1.000,8,10,18,10,5,1,5,5,19,21
Jeff Dowtin,PG,24,GSW,4,0,28,3,6,.500,0,1,0,3,5,.600,.500,0,0,0,1,6,7,3,0,1,1,2,6,21
Jeff Dowtin,PG,24,MIL,1,0,3,0,1,0,0,1,0,0,0,0,0,0,0,0,0,0,0,0,0,0,0,0,0,21
Jeff Dowtin,PG,24,ORL,4,0,77,5,19,.263,1,7,.143,4,12,.333,.289,2,2,1.000,7,4,11,7,5,0,4,3,13,21
PJ Dozier,SG,25,DEN,18,0,340,36,99,.364,15,48,.313,21,51,.412,.439,10,13,.769,14,49,63,29,11,6,13,33,97,21
Goran Dragić,PG,35,TOT,21,8,498,57,151,.377,16,63,.254,41,88,.466,.430,27,33,.818,13,52,65,86,19,4,34,45,157,21
Goran Dragić,PG,35,TOR,5,2,90,13,34,.382,4,14,.286,9,20,.450,.441,10,10,1.000,2,12,14,9,5,1,1,8,40,21
Goran Dragić,PG,35,BRK,16,6,408,44,117,.376,12,49,.245,32,68,.471,.427,17,23,.739,11,40,51,77,14,3,33,37,117,21
Andre Drummond,C,28,TOT,73,36,1437,247,433,.570,0,3,0,247,430,.574,.570,86,164,.524,229,451,680,131,78,68,115,192,580,21
Andre Drummond,C,28,PHI,49,12,902,128,238,.538,0,2,0,128,236,.542,.538,42,82,.512,136,297,433,97,56,45,79,121,298,21
Andre Drummond,C,28,BRK,24,24,535,119,195,.610,0,1,0,119,194,.613,.610,44,82,.537,93,154,247,34,22,23,36,71,282,21
Chris Duarte,SG,24,IND,55,39,1541,268,621,.432,94,255,.369,174,366,.475,.507,90,112,.804,41,185,226,114,56,10,90,95,720,21
David Duke Jr.,PG,22,BRK,22,7,341,39,108,.361,9,37,.243,30,71,.423,.403,17,21,.810,30,37,67,17,14,7,9,36,104,21
Kris Dunn,PG,27,POR,14,3,336,44,102,.431,1,11,.091,43,91,.473,.436,17,18,.944,9,40,49,79,23,3,32,38,106,21
Kevin Durant,PF,33,BRK,55,55,2047,578,1115,.518,115,300,.383,463,815,.568,.570,372,409,.910,29,378,407,351,48,52,191,113,1643,21
Jaime Echenique,C,24,WAS,1,0,3,0,0,0,0,0,0,0,0,0,0,0,0,0,0,0,0,0,0,0,0,0,0,21
Anthony Edwards,SG,20,MIN,72,72,2466,549,1245,.441,215,602,.357,334,643,.519,.527,220,280,.786,62,281,343,275,105,46,190,164,1533,21
Carsen Edwards,SG,23,DET,4,0,79,9,30,.300,4,16,.250,5,14,.357,.367,1,1,1.000,2,4,6,14,2,0,5,4,23,21
Kessler Edwards,SF,21,BRK,48,23,987,110,267,.412,48,136,.353,62,131,.473,.502,16,19,.842,44,128,172,31,29,24,42,85,284,21
Rob Edwards,SG,25,OKC,2,0,11,1,4,.250,1,4,.250,0,0,0,.375,0,0,0,0,3,3,0,0,0,1,0,3,21
CJ Elleby,SF,21,POR,58,28,1174,121,308,.393,37,126,.294,84,182,.462,.453,60,84,.714,66,161,227,87,35,19,56,116,339,21
Wayne Ellington,SG,34,LAL,43,9,810,98,237,.414,82,211,.389,16,26,.615,.586,9,11,.818,10,67,77,30,23,5,19,42,287,21
Joel Embiid,C,27,PHI,68,68,2297,666,1334,.499,93,251,.371,573,1083,.529,.534,654,803,.814,146,650,796,284,77,99,214,181,2079,21
James Ennis III,SF,31,TOT,7,0,56,11,24,.458,3,8,.375,8,16,.500,.521,4,5,.800,5,7,12,3,2,2,2,5,29,21
James Ennis III,SF,31,BRK,2,0,14,2,7,.286,1,2,.500,1,5,.200,.357,0,0,0,2,3,5,0,1,1,0,0,5,21
James Ennis III,SF,31,LAC,2,0,28,7,11,.636,2,4,.500,5,7,.714,.727,4,4,1.000,2,3,5,0,1,1,1,4,20,21
James Ennis III,SF,31,DEN,3,0,14,2,6,.333,0,2,0,2,4,.500,.333,0,1,0,1,1,2,3,0,0,1,1,4,21
Drew Eubanks,C,24,TOT,71,31,1245,221,371,.596,5,23,.217,216,348,.621,.602,99,130,.762,130,252,382,85,31,40,81,122,546,21
Drew Eubanks,C,24,SAS,49,9,595,84,159,.528,1,8,.125,83,151,.550,.531,59,79,.747,64,132,196,50,13,30,46,61,228,21
Drew Eubanks,C,24,POR,22,22,650,137,212,.646,4,15,.267,133,197,.675,.656,40,51,.784,66,120,186,35,18,10,35,61,318,21
Tacko Fall,C,26,CLE,11,1,59,5,12,.417,0,0,0,5,12,.417,.417,2,7,.286,7,16,23,2,0,6,3,3,12,21
Derrick Favors,C,30,OKC,39,18,653,94,182,.516,2,16,.125,92,166,.554,.522,16,25,.640,58,126,184,25,17,12,9,62,206,21
Bruno Fernando,C,23,TOT,30,0,152,36,55,.655,1,2,.500,35,53,.660,.664,15,24,.625,18,37,55,7,1,11,14,24,88,21
Bruno Fernando,C,23,BOS,20,0,58,7,14,.500,1,1,1.000,6,13,.462,.536,4,5,.800,7,8,15,4,0,3,5,6,19,21
Bruno Fernando,C,23,HOU,10,0,94,29,41,.707,0,1,0,29,40,.725,.707,11,19,.579,11,29,40,3,1,8,9,18,69,21
Dorian Finney-Smith,PF,28,DAL,80,80,2644,326,692,.471,172,435,.395,154,257,.599,.595,56,83,.675,122,253,375,150,88,39,80,183,880,21
Malik Fitts,PF,24,TOT,15,0,63,8,19,.421,5,10,.500,3,9,.333,.553,0,0,0,2,15,17,5,0,0,2,4,21,21
Malik Fitts,PF,24,UTA,7,0,35,2,9,.222,2,4,.500,0,5,0,.333,0,0,0,0,10,10,0,0,0,2,3,6,21
Malik Fitts,PF,24,BOS,8,0,28,6,10,.600,3,6,.500,3,4,.750,.750,0,0,0,2,5,7,5,0,0,0,1,15,21
Malachi Flynn,PG,23,TOR,44,5,537,72,183,.393,30,90,.333,42,93,.452,.475,15,24,.625,10,53,63,70,20,4,13,45,189,21
Bryn Forbes,SG,28,TOT,75,2,1286,231,539,.429,122,295,.414,109,244,.447,.542,79,87,.908,10,83,93,75,25,5,56,95,663,21
Bryn Forbes,SG,28,SAS,40,1,676,128,296,.432,63,151,.417,65,145,.448,.539,44,49,.898,4,59,63,41,17,3,33,42,363,21
Bryn Forbes,SG,28,DEN,35,1,610,103,243,.424,59,144,.410,44,99,.444,.545,35,38,.921,6,24,30,34,8,2,23,53,300,21
Aleem Ford,SF,24,ORL,5,0,74,6,20,.300,2,15,.133,4,5,.800,.350,0,0,0,2,13,15,2,1,0,4,7,14,21
Trent Forrest,PG,23,UTA,60,6,765,76,155,.490,5,27,.185,71,128,.555,.506,38,48,.792,23,76,99,106,30,6,48,43,195,21
Evan Fournier,SG,29,NYK,80,80,2358,402,965,.417,241,619,.389,161,346,.465,.541,80,113,.708,34,176,210,171,79,20,105,180,1125,21
De'Aaron Fox,PG,24,SAC,59,59,2083,516,1092,.473,74,249,.297,442,843,.524,.506,261,348,.750,25,206,231,330,68,25,168,172,1367,21
Melvin Frazier,SG,25,OKC,3,0,120,13,48,.271,1,21,.048,12,27,.444,.281,5,7,.714,5,8,13,1,1,0,3,8,32,21
Tim Frazier,PG,31,TOT,12,3,208,14,45,.311,6,17,.353,8,28,.286,.378,5,9,.556,5,14,19,34,3,1,15,27,39,21
Tim Frazier,PG,31,ORL,10,3,200,13,43,.302,6,17,.353,7,26,.269,.372,5,9,.556,5,14,19,33,3,1,13,24,37,21
Tim Frazier,PG,31,CLE,2,0,8,1,2,.500,0,0,0,1,2,.500,.500,0,0,0,0,0,0,1,0,0,2,3,2,21
Enes Freedom,C,29,BOS,35,1,411,51,97,.526,2,5,.400,49,92,.533,.536,24,28,.857,61,99,160,8,5,14,20,42,128,21
Markelle Fultz,PG,23,ORL,18,3,360,83,175,.474,4,17,.235,79,158,.500,.486,25,31,.806,4,45,49,99,20,5,40,22,195,21
Wenyen Gabriel,PF,24,TOT,26,5,358,54,110,.491,8,28,.286,46,82,.561,.527,25,42,.595,39,58,97,14,5,11,16,68,141,21
Wenyen Gabriel,PF,24,BRK,1,0,1,0,0,0,0,0,0,0,0,0,0,0,0,0,0,1,1,0,0,0,0,0,0,21
Wenyen Gabriel,PF,24,LAC,6,0,46,5,13,.385,2,5,.400,3,8,.375,.462,2,4,.500,5,9,14,2,1,2,3,11,14,21
Wenyen Gabriel,PF,24,LAL,19,5,311,49,97,.505,6,23,.261,43,74,.581,.536,23,38,.605,34,48,82,12,4,9,13,57,127,21
Daniel Gafford,C,23,WAS,72,53,1444,285,411,.693,0,1,0,285,410,.695,.693,107,153,.699,155,252,407,68,30,99,65,170,677,21
Danilo Gallinari,PF,33,ATL,66,18,1672,259,597,.434,112,294,.381,147,303,.485,.528,141,156,.904,35,273,308,101,28,12,38,93,771,21
Langston Galloway,SG,30,TOT,7,0,107,6,26,.231,2,16,.125,4,10,.400,.269,0,0,0,3,15,18,12,1,0,6,7,14,21
Langston Galloway,SG,30,BRK,4,0,58,5,13,.385,2,8,.250,3,5,.600,.462,0,0,0,1,7,8,5,0,0,5,5,12,21
Langston Galloway,SG,30,MIL,3,0,49,1,13,.077,0,8,0,1,5,.200,.077,0,0,0,2,8,10,7,1,0,1,2,2,21
Darius Garland,PG,22,CLE,68,68,2430,542,1173,.462,174,454,.383,368,719,.512,.536,215,241,.892,39,185,224,583,89,7,248,115,1473,21
Marcus Garrett,SG,23,MIA,12,0,128,5,21,.238,1,4,.250,4,17,.235,.262,2,5,.400,9,14,23,7,5,3,2,16,13,21
Usman Garuba,PF,19,HOU,24,2,239,19,44,.432,5,20,.250,14,24,.583,.489,5,7,.714,21,62,83,17,10,11,6,28,48,21
Luka Garza,C,23,DET,32,5,389,66,147,.449,16,49,.327,50,98,.510,.503,38,61,.623,58,42,100,20,9,6,18,55,186,21
Rudy Gay,PF,35,UTA,55,1,1038,157,379,.414,70,203,.345,87,176,.494,.507,62,79,.785,55,187,242,56,25,19,47,95,446,21
Paul George,PF,31,LAC,31,31,1077,268,636,.421,91,257,.354,177,379,.467,.493,127,148,.858,12,201,213,176,67,13,126,74,754,21
Taj Gibson,C,36,NYK,52,4,946,86,166,.518,15,38,.395,71,128,.555,.563,42,52,.808,88,141,229,32,22,40,27,137,229,21
Josh Giddey,SF,19,OKC,54,54,1700,281,670,.419,56,213,.263,225,457,.492,.461,56,79,.709,98,323,421,345,51,20,171,88,674,21
Shai Gilgeous-Alexander,PG,23,OKC,56,56,1942,477,1052,.453,89,297,.300,388,755,.514,.496,328,405,.810,37,241,278,331,71,46,154,142,1371,21
Anthony Gill,PF,29,WAS,44,0,463,62,109,.569,14,26,.538,48,83,.578,.633,42,52,.808,33,52,85,27,5,11,18,58,180,21
Freddie Gillespie,PF,24,ORL,9,2,119,9,22,.409,0,1,0,9,21,.429,.409,3,7,.429,13,23,36,5,3,9,5,18,21,21
Rudy Gobert,C,29,UTA,66,66,2120,362,508,.713,0,4,0,362,504,.718,.713,303,439,.690,241,727,968,72,45,137,119,176,1027,21
Brandon Goodwin,PG,26,CLE,36,5,502,64,154,.416,19,55,.345,45,99,.455,.477,24,38,.632,14,53,67,91,25,1,36,39,171,21
Jordan Goodwin,SG,23,WAS,2,0,6,0,3,0,0,1,0,0,2,0,0,0,0,0,0,1,1,0,0,0,0,1,0,21
Aaron Gordon,PF,26,DEN,75,75,2376,434,834,.520,87,260,.335,347,574,.605,.573,171,230,.743,125,314,439,188,44,44,133,148,1126,21
Eric Gordon,SG,33,HOU,57,46,1669,268,564,.475,124,301,.412,144,263,.548,.585,105,135,.778,15,98,113,154,28,18,107,63,765,21
Devonte' Graham,PG,26,NOP,76,63,2162,296,815,.363,192,563,.341,104,252,.413,.481,118,140,.843,37,140,177,316,71,12,105,95,902,21
Jerami Grant,PF,27,DET,47,47,1500,298,699,.426,91,254,.358,207,445,.465,.491,217,259,.838,28,163,191,111,44,49,85,107,904,21
Hassani Gravett,PG,25,ORL,8,3,171,18,38,.474,11,26,.423,7,12,.583,.618,3,4,.750,1,20,21,20,5,1,9,13,50,21
Danny Green,SF,34,PHI,62,28,1353,126,320,.394,103,271,.380,23,49,.469,.555,11,14,.786,32,125,157,64,60,37,45,105,366,21
Draymond Green,PF,31,GSW,46,44,1329,135,257,.525,16,54,.296,119,203,.586,.556,60,91,.659,45,291,336,320,61,50,139,136,346,21
Jalen Green,SG,19,HOU,67,67,2138,406,954,.426,157,458,.343,249,496,.502,.508,188,236,.797,33,193,226,176,44,18,135,103,1157,21
JaMychal Green,PF,31,DEN,67,8,1085,159,327,.486,33,124,.266,126,203,.621,.537,81,93,.871,81,200,281,59,43,26,57,158,432,21
Javonte Green,SF,28,CHI,65,45,1519,176,325,.542,36,101,.356,140,224,.625,.597,80,96,.833,91,185,276,60,67,32,30,132,468,21
Jeff Green,PF,35,DEN,75,63,1849,277,529,.524,53,168,.315,224,361,.620,.574,165,198,.833,41,190,231,96,28,27,71,151,772,21
Josh Green,SG,21,DAL,67,3,1039,130,256,.508,28,78,.359,102,178,.573,.563,31,45,.689,52,109,161,79,45,14,44,115,319,21
Blake Griffin,C,32,BRK,56,24,958,133,313,.425,38,145,.262,95,168,.565,.486,55,76,.724,60,168,228,105,27,14,31,95,359,21
Quentin Grimes,SG,21,NYK,46,6,786,95,235,.404,72,189,.381,23,46,.500,.557,13,19,.684,24,70,94,44,31,11,28,72,275,21
Kyle Guy,SG,24,MIA,19,0,186,26,65,.400,14,40,.350,12,25,.480,.508,8,12,.667,4,13,17,17,7,1,13,12,74,21
Rui Hachimura,PF,23,WAS,42,13,943,187,381,.491,55,123,.447,132,258,.512,.563,46,66,.697,25,135,160,48,23,9,33,53,475,21
Tyrese Haliburton,SG-PG,21,TOT,77,77,2695,430,909,.473,161,389,.414,269,520,.517,.562,160,190,.842,61,250,311,628,134,49,199,121,1181,21
Tyrese Haliburton,SG,21,SAC,51,51,1757,268,586,.457,104,252,.413,164,334,.491,.546,87,104,.837,39,160,199,379,86,34,115,71,727,21
Tyrese Haliburton,PG,21,IND,26,26,938,162,323,.502,57,137,.416,105,186,.565,.590,73,86,.849,22,90,112,249,48,15,84,50,454,21
Tyler Hall,SG,24,NYK,1,0,2,0,0,0,0,0,0,0,0,0,0,0,0,0,0,0,0,0,0,0,0,0,0,21
R.J. Hampton,SG,20,ORL,64,14,1402,175,457,.383,64,183,.350,111,274,.405,.453,75,117,.641,23,171,194,158,42,13,87,101,489,21
Tim Hardaway Jr.,SG,29,DAL,42,20,1245,209,530,.394,102,304,.336,107,226,.473,.491,78,103,.757,13,143,156,92,38,6,34,74,598,21
James Harden,PG,32,TOT,65,65,2419,407,992,.410,148,448,.330,259,544,.476,.485,470,536,.877,55,445,500,667,82,36,284,153,1432,21
James Harden,PG,32,BRK,44,44,1627,292,706,.414,102,307,.332,190,399,.476,.486,304,350,.869,42,309,351,447,56,31,212,105,990,21
James Harden,PG,32,PHI,21,21,792,115,286,.402,46,141,.326,69,145,.476,.483,166,186,.892,13,136,149,220,26,5,72,48,442,21
Maurice Harkless,SF,28,SAC,47,24,863,83,181,.459,31,101,.307,52,80,.650,.544,20,28,.714,12,100,112,23,29,24,31,77,217,21
Jared Harper,PG,24,NOP,5,0,43,14,26,.538,5,12,.417,9,14,.643,.635,4,4,1.000,2,0,2,14,4,1,2,5,37,21
Montrezl Harrell,C,28,TOT,71,3,1641,358,555,.645,4,17,.235,354,538,.658,.649,212,296,.716,149,282,431,145,29,43,72,137,932,21
Montrezl Harrell,C,28,WAS,46,3,1117,247,383,.645,4,15,.267,243,368,.660,.650,149,205,.727,96,213,309,96,18,31,50,88,647,21
Montrezl Harrell,C,28,CHO,25,0,524,111,172,.645,0,2,0,111,170,.653,.645,63,91,.692,53,69,122,49,11,12,22,49,285,21
Gary Harris,SG,27,ORL,61,30,1730,240,553,.434,116,302,.384,124,251,.494,.539,83,95,.874,36,86,122,108,59,9,61,112,679,21
Joe Harris,SF,30,BRK,14,14,423,56,124,.452,41,88,.466,15,36,.417,.617,5,6,.833,5,51,56,14,7,2,16,31,158,21
Tobias Harris,PF,29,PHI,73,73,2543,493,1022,.482,101,275,.367,392,747,.525,.532,170,202,.842,77,419,496,252,47,43,116,164,1257,21
Shaquille Harrison,SG,28,BRK,2,0,23,2,6,.333,0,2,0,2,4,.500,.333,0,0,0,1,3,4,3,1,1,2,3,4,21
Josh Hart,SG,26,TOT,54,53,1791,287,569,.504,73,213,.343,214,356,.601,.569,160,211,.758,62,326,388,224,61,13,114,150,807,21
Josh Hart,SG,26,NOP,41,40,1374,195,386,.505,42,130,.323,153,256,.598,.560,116,154,.753,53,265,318,168,45,11,81,118,548,21
Josh Hart,SG,26,POR,13,13,417,92,183,.503,31,83,.373,61,100,.610,.587,44,57,.772,9,61,70,56,16,2,33,32,259,21
Isaiah Hartenstein,C,23,LAC,68,0,1216,229,366,.626,14,30,.467,215,336,.640,.645,91,132,.689,117,215,332,160,50,77,84,167,563,21
Udonis Haslem,C,41,MIA,13,0,83,14,31,.452,1,4,.250,13,27,.481,.468,3,3,1.000,4,21,25,4,1,1,5,15,32,21
Sam Hauser,SF,24,BOS,26,0,158,23,50,.460,19,44,.432,4,6,.667,.650,0,0,0,5,24,29,10,1,2,2,7,65,21
Jaxson Hayes,C,21,NOP,70,28,1398,245,398,.616,20,57,.351,225,341,.660,.641,144,188,.766,115,200,315,43,33,55,54,155,654,21
Killian Hayes,PG,20,DET,66,40,1647,176,459,.383,44,167,.263,132,292,.452,.431,57,74,.770,36,174,210,277,78,35,111,183,453,21
Gordon Hayward,SF,31,CHO,49,48,1564,283,617,.459,86,220,.391,197,397,.496,.528,126,149,.846,38,186,224,177,47,22,81,85,778,21
Aaron Henry,SF,22,PHI,6,0,17,1,5,.200,0,1,0,1,4,.250,.200,0,0,0,0,1,1,0,0,2,2,2,2,21
Juancho Hernangómez,PF,26,TOT,40,9,445,44,106,.415,24,69,.348,20,37,.541,.528,19,34,.559,28,72,100,20,14,10,16,25,131,21
Juancho Hernangómez,PF,26,BOS,18,0,96,5,27,.185,3,18,.167,2,9,.222,.241,6,9,.667,9,16,25,3,4,2,6,7,19,21
Juancho Hernangómez,PF,26,SAS,5,0,51,2,6,.333,0,3,0,2,3,.667,.333,3,4,.750,4,11,15,3,1,1,2,0,7,21
Juancho Hernangómez,PF,26,UTA,17,9,298,37,73,.507,21,48,.438,16,25,.640,.651,10,21,.476,15,45,60,14,9,7,8,18,105,21
Willy Hernangómez,C,27,NOP,50,8,839,170,327,.520,4,12,.333,166,315,.527,.526,109,141,.773,143,195,338,63,21,19,51,97,453,21
Tyler Herro,SG,22,MIA,66,10,2151,501,1122,.447,175,439,.399,326,683,.477,.525,190,219,.868,32,297,329,263,44,8,174,95,1367,21
Buddy Hield,SG,29,TOT,81,32,2499,446,1098,.406,262,716,.366,184,382,.482,.526,111,127,.874,66,287,353,229,73,25,153,184,1265,21
Buddy Hield,SG,29,SAC,55,6,1574,265,693,.382,182,495,.368,83,198,.419,.514,80,92,.870,43,178,221,105,48,15,90,113,792,21
Buddy Hield,SG,29,IND,26,26,925,181,405,.447,80,221,.362,101,184,.549,.546,31,35,.886,23,109,132,124,25,10,63,71,473,21
Haywood Highsmith,SF,25,MIA,19,1,163,16,46,.348,9,28,.321,7,18,.389,.446,2,5,.400,10,16,26,6,2,3,3,13,43,21
George Hill,PG,35,MIL,54,17,1253,118,275,.429,41,134,.306,77,141,.546,.504,57,62,.919,38,117,155,120,42,6,41,70,334,21
Malcolm Hill,SF-SG,26,TOT,19,0,212,24,52,.462,13,36,.361,11,16,.688,.587,11,14,.786,11,24,35,8,7,3,3,24,72,21
Malcolm Hill,SG,26,ATL,3,0,46,5,8,.625,3,5,.600,2,3,.667,.813,4,4,1.000,2,4,6,1,4,1,0,7,17,21
Malcolm Hill,SF,26,CHI,16,0,166,19,44,.432,10,31,.323,9,13,.692,.545,7,10,.700,9,20,29,7,3,2,3,17,55,21
Solomon Hill,SF,30,ATL,13,1,139,3,20,.150,2,13,.154,1,7,.143,.200,0,0,0,6,17,23,12,4,2,1,16,8,21
Nate Hinton,SG,22,IND,2,0,2,0,1,0,0,0,0,0,1,0,0,0,0,0,0,0,0,0,0,0,1,0,0,21
Jaylen Hoard,SF,22,OKC,7,5,240,44,90,.489,9,25,.360,35,65,.538,.539,6,14,.429,30,54,84,17,6,5,8,14,103,21
Aaron Holiday,PG,25,TOT,63,15,1021,151,338,.447,39,103,.379,112,235,.477,.504,59,68,.868,24,98,122,153,42,9,67,92,400,21
Aaron Holiday,PG,25,WAS,41,14,663,100,214,.467,23,67,.343,77,147,.524,.521,28,35,.800,9,58,67,78,24,9,39,60,251,21
Aaron Holiday,PG,25,PHO,22,1,358,51,124,.411,16,36,.444,35,88,.398,.476,31,33,.939,15,40,55,75,18,0,28,32,149,21
Jrue Holiday,PG,31,MIL,67,64,2207,478,954,.501,132,321,.411,346,633,.547,.570,137,180,.761,69,232,301,457,108,29,183,133,1225,21
Justin Holiday,SF-SG,32,TOT,74,65,2057,261,662,.394,177,482,.367,84,180,.467,.528,50,62,.806,29,161,190,128,57,33,70,154,749,21
Justin Holiday,SF,32,IND,49,40,1416,190,458,.415,127,336,.378,63,122,.516,.553,34,41,.829,18,117,135,90,36,18,49,105,541,21
Justin Holiday,SG,32,SAC,25,25,641,71,204,.348,50,146,.342,21,58,.362,.471,16,21,.762,11,44,55,38,21,15,21,49,208,21
Richaun Holmes,C,28,SAC,45,37,1074,198,300,.660,2,5,.400,196,295,.664,.663,70,90,.778,93,224,317,48,17,41,56,128,468,21
Rodney Hood,PF-SF,29,TOT,52,0,709,58,157,.369,30,91,.330,28,66,.424,.465,17,19,.895,15,62,77,38,15,6,11,31,163,21
Rodney Hood,PF,29,MIL,39,0,581,46,131,.351,24,80,.300,22,51,.431,.443,13,14,.929,13,54,67,30,12,4,7,27,129,21
Rodney Hood,SF,29,LAC,13,0,128,12,26,.462,6,11,.545,6,15,.400,.577,4,5,.800,2,8,10,8,3,2,4,4,34,21
Scotty Hopson,SG,32,OKC,1,0,18,2,4,.500,0,1,0,2,3,.667,.500,0,0,0,0,1,1,1,0,0,2,1,4,21
Al Horford,C,35,BOS,69,69,2005,266,569,.467,89,265,.336,177,304,.582,.546,80,95,.842,108,422,530,232,49,92,65,130,701,21
Talen Horton-Tucker,SG,21,LAL,60,19,1511,224,538,.416,49,182,.269,175,356,.492,.462,100,125,.800,37,156,193,159,59,29,82,148,597,21
Danuel House Jr.,SF,28,TOT,42,7,727,80,198,.404,44,117,.376,36,81,.444,.515,44,58,.759,18,93,111,44,21,17,33,51,248,21
Danuel House Jr.,SF,28,HOU,16,1,233,25,74,.338,10,34,.294,15,40,.375,.405,17,19,.895,4,39,43,19,5,5,18,16,77,21
Danuel House Jr.,SF,28,NYK,1,0,3,0,1,0,0,1,0,0,0,0,0,0,0,0,0,0,0,0,0,0,0,0,0,21
Danuel House Jr.,SF,28,UTA,25,6,491,55,123,.447,34,82,.415,21,41,.512,.585,27,39,.692,14,54,68,25,16,12,15,35,171,21
Dwight Howard,C,36,LAL,60,27,971,134,219,.612,8,15,.533,126,204,.618,.630,96,146,.658,118,238,356,35,34,36,47,115,372,21
Markus Howard,SG,22,DEN,31,0,176,39,101,.386,28,70,.400,11,31,.355,.525,20,23,.870,2,10,12,7,9,0,7,17,126,21
Kevin Huerter,SF,23,ATL,74,60,2188,345,760,.454,160,411,.389,185,349,.530,.559,42,52,.808,32,222,254,203,55,26,91,185,892,21
Jay Huff,C,23,LAL,4,0,20,0,3,0,0,2,0,0,1,0,0,0,0,0,1,3,4,1,1,1,1,1,0,21
Elijah Hughes,SG-SF,23,TOT,36,4,434,47,144,.326,25,95,.263,22,49,.449,.413,7,9,.778,6,52,58,22,14,8,17,39,126,21
Elijah Hughes,SF,23,UTA,14,1,112,15,36,.417,10,28,.357,5,8,.625,.556,3,3,1.000,2,15,17,6,4,1,7,7,43,21
Elijah Hughes,SG,23,POR,22,3,322,32,108,.296,15,67,.224,17,41,.415,.366,4,6,.667,4,37,41,16,10,7,10,32,83,21
Feron Hunt,SF,22,NYK,2,0,8,0,2,0,0,0,0,0,2,0,0,0,0,0,1,0,1,1,1,0,1,1,0,21
De'Andre Hunter,SF,24,ATL,53,52,1577,254,575,.442,74,195,.379,180,380,.474,.506,127,166,.765,26,150,176,68,36,21,69,155,709,21
Chandler Hutchison,SF,25,PHO,6,0,22,1,2,.500,0,0,0,1,2,.500,.500,2,2,1.000,0,5,5,2,0,0,4,1,4,21
Bones Hyland,SG,21,DEN,69,4,1310,230,571,.403,131,358,.366,99,213,.465,.518,107,125,.856,14,174,188,191,41,20,86,153,698,21
Serge Ibaka,C,32,TOT,54,12,877,148,296,.500,37,99,.374,111,197,.563,.563,32,44,.727,62,188,250,49,11,33,43,102,365,21
Serge Ibaka,C,32,LAC,35,10,538,94,192,.490,24,62,.387,70,130,.538,.552,20,29,.690,40,110,150,36,7,26,33,56,232,21
Serge Ibaka,C,32,MIL,19,2,339,54,104,.519,13,37,.351,41,67,.612,.582,12,15,.800,22,78,100,13,4,7,10,46,133,21
Andre Iguodala,SF,38,GSW,31,0,603,46,121,.380,17,74,.230,29,47,.617,.450,15,20,.750,21,79,100,114,27,22,28,34,124,21
Joe Ingles,SF,34,UTA,45,15,1122,115,285,.404,78,225,.347,37,60,.617,.540,17,22,.773,12,119,131,158,23,5,46,82,325,21
Brandon Ingram,SF,24,NOP,55,55,1869,453,983,.461,74,226,.327,379,757,.501,.498,266,322,.826,35,285,320,307,34,26,151,119,1246,21
Kyrie Irving,PG,29,BRK,29,29,1091,289,616,.469,100,239,.418,189,377,.501,.550,118,129,.915,16,111,127,167,41,17,73,81,796,21
Wes Iwundu,SF,27,ATL,3,1,82,8,18,.444,3,5,.600,5,13,.385,.528,3,4,.750,3,10,13,0,1,0,1,8,22,21
Frank Jackson,PG,23,DET,53,7,1164,194,483,.402,86,279,.308,108,204,.529,.491,86,104,.827,19,68,87,55,27,9,38,89,560,21
Isaiah Jackson,C,20,IND,36,15,541,116,206,.563,5,16,.313,111,190,.584,.575,60,88,.682,60,89,149,10,25,52,40,92,297,21
Jaren Jackson Jr.,PF,22,MEM,78,78,2126,430,1036,.415,128,401,.319,302,635,.476,.477,284,345,.823,119,335,454,86,73,177,130,272,1272,21
Josh Jackson,SF,24,TOT,51,3,830,120,300,.400,33,130,.254,87,170,.512,.455,55,77,.714,21,120,141,54,26,22,47,88,328,21
Josh Jackson,SF,24,DET,39,3,707,103,251,.410,30,113,.265,73,138,.529,.470,40,56,.714,17,106,123,49,21,18,38,71,276,21
Josh Jackson,SF,24,SAC,12,0,123,17,49,.347,3,17,.176,14,32,.438,.378,15,21,.714,4,14,18,5,5,4,9,17,52,21
Justin Jackson,SF,26,TOT,7,0,37,5,15,.333,3,9,.333,2,6,.333,.433,2,2,1.000,1,6,7,2,0,0,1,3,15,21
Justin Jackson,SF,26,BOS,1,0,2,0,1,0,0,0,0,0,1,0,0,2,2,1.000,0,0,0,0,0,0,0,0,2,21
Justin Jackson,SF,26,PHO,6,0,35,5,14,.357,3,9,.333,2,5,.400,.464,0,0,0,1,6,7,2,0,0,1,3,13,21
Reggie Jackson,SG,31,LAC,75,75,2337,479,1222,.392,167,512,.326,312,710,.439,.460,138,163,.847,39,232,271,359,55,15,173,159,1263,21
LeBron James,C,37,LAL,56,56,2084,640,1221,.524,161,448,.359,479,773,.620,.590,254,336,.756,63,396,459,349,73,59,196,121,1695,21
DeJon Jarreau,SG,24,IND,1,0,1,0,0,0,0,0,0,0,0,0,0,0,0,0,0,0,0,0,0,0,0,0,0,21
DaQuan Jeffries,SG,24,MEM,3,0,9,1,2,.500,0,1,0,1,1,1.000,.500,0,0,0,0,2,2,1,0,0,0,1,2,21
Ty Jerome,SG,24,OKC,48,4,801,124,328,.378,54,186,.290,70,142,.493,.460,38,47,.809,19,59,78,109,30,5,37,73,340,21
Isaiah Joe,SG,22,PHI,55,1,609,62,177,.350,45,135,.333,17,42,.405,.477,29,31,.935,6,50,56,35,14,3,19,47,198,21
Alize Johnson,PF,25,TOT,23,0,167,17,39,.436,0,4,0,17,35,.486,.436,7,12,.583,28,33,61,9,5,0,12,18,41,21
Alize Johnson,PF,25,CHI,16,0,121,12,23,.522,0,2,0,12,21,.571,.522,4,7,.571,16,20,36,8,3,0,8,15,28,21
Alize Johnson,PF,25,WAS,3,0,18,2,6,.333,0,2,0,2,4,.500,.333,0,1,0,5,7,12,0,0,0,3,0,4,21
Alize Johnson,PF,25,NOP,4,0,28,3,10,.300,0,0,0,3,10,.300,.300,3,4,.750,7,6,13,1,2,0,1,3,9,21
B.J. Johnson,SF,26,ORL,4,0,65,11,25,.440,4,10,.400,7,15,.467,.520,0,0,0,6,9,15,0,0,1,0,4,26,21
Cameron Johnson,PF,25,PHO,66,16,1730,279,607,.460,166,391,.425,113,216,.523,.596,98,114,.860,42,231,273,99,57,16,47,113,822,21
David Johnson,SG,20,TOR,2,0,2,0,1,0,0,1,0,0,0,0,0,0,0,0,0,0,0,0,0,0,0,0,0,21
Jalen Johnson,PF,20,ATL,22,0,120,22,41,.537,3,13,.231,19,28,.679,.573,5,7,.714,2,24,26,3,3,2,9,9,52,21
James Johnson,PF,34,BRK,62,10,1191,144,307,.469,23,85,.271,121,222,.545,.507,29,55,.527,51,164,215,130,30,34,48,162,340,21
Joe Johnson,SG,40,BOS,1,0,2,1,1,1.000,0,0,0,1,1,1.000,1.000,0,0,0,0,0,0,0,0,0,0,0,2,21
Keldon Johnson,SF,22,SAS,75,74,2392,471,1011,.466,159,399,.398,312,612,.510,.545,177,234,.756,80,377,457,158,58,14,92,148,1278,21
Keon Johnson,SG,19,TOT,37,12,697,96,272,.353,34,100,.340,62,172,.360,.415,41,51,.804,24,57,81,76,28,12,46,69,267,21
Keon Johnson,SG,19,LAC,15,0,135,17,51,.333,3,11,.273,14,40,.350,.363,16,21,.762,6,15,21,13,7,2,7,21,53,21
Keon Johnson,SG,19,POR,22,12,562,79,221,.357,31,89,.348,48,132,.364,.428,25,30,.833,18,42,60,63,21,10,39,48,214,21
Stanley Johnson,PF,25,LAL,48,27,1094,117,251,.466,33,105,.314,84,146,.575,.532,53,74,.716,34,121,155,80,43,14,35,109,320,21
Tyler Johnson,PG,29,TOT,6,0,91,6,20,.300,5,13,.385,1,7,.143,.425,0,0,0,3,9,12,7,3,3,2,7,17,21
Tyler Johnson,PG,29,PHI,3,0,38,4,10,.400,3,7,.429,1,3,.333,.550,0,0,0,1,5,6,2,1,1,1,4,11,21
Tyler Johnson,PG,29,SAS,3,0,53,2,10,.200,2,6,.333,0,4,0,.300,0,0,0,2,4,6,5,2,2,1,3,6,21
Nikola Jokić,C,26,DEN,74,74,2476,764,1311,.583,97,288,.337,667,1023,.652,.620,379,468,.810,206,813,1019,584,109,63,281,191,2004,21
Carlik Jones,PG,24,TOT,5,0,23,1,9,.111,0,1,0,1,8,.125,.111,2,2,1.000,1,2,3,5,1,0,3,0,4,21
Carlik Jones,PG,24,DAL,3,0,19,0,7,0,0,1,0,0,6,0,0,2,2,1.000,1,2,3,5,1,0,3,0,2,21
Carlik Jones,PG,24,DEN,2,0,4,1,2,.500,0,0,0,1,2,.500,.500,0,0,0,0,0,0,0,0,0,0,0,2,21
Damian Jones,C,26,SAC,56,15,1017,175,266,.658,10,29,.345,165,237,.696,.677,94,131,.718,75,171,246,69,26,47,59,130,454,21
Derrick Jones Jr.,PF,24,CHI,51,8,899,105,195,.538,20,61,.328,85,134,.634,.590,56,70,.800,60,109,169,30,25,33,30,105,286,21
Herbert Jones,PF,23,NOP,78,69,2335,274,576,.476,57,169,.337,217,407,.533,.525,137,163,.840,98,198,296,167,130,60,100,238,742,21
Jemerrio Jones,SF,26,LAL,2,0,15,2,3,.667,0,0,0,2,3,.667,.667,0,0,0,2,1,3,0,1,0,0,2,4,21
Kai Jones,C,21,CHO,21,0,63,9,14,.643,1,2,.500,8,12,.667,.679,3,8,.375,3,8,11,4,1,2,6,8,22,21
Mason Jones,SG,23,LAL,4,0,51,7,15,.467,1,4,.250,6,11,.545,.500,12,15,.800,1,9,10,4,2,0,1,8,27,21
Tre Jones,PG,22,SAS,69,11,1148,166,339,.490,10,51,.196,156,288,.542,.504,71,91,.780,29,126,155,233,42,7,46,78,413,21
Tyus Jones,PG,25,MEM,73,23,1549,249,552,.451,80,205,.390,169,347,.487,.524,54,66,.818,17,159,176,324,66,2,46,32,632,21
DeAndre Jordan,C,33,TOT,48,20,622,92,143,.643,0,0,0,92,143,.643,.643,22,40,.550,83,181,264,21,12,35,37,71,206,21
DeAndre Jordan,C,33,LAL,32,19,408,60,89,.674,0,0,0,60,89,.674,.674,12,26,.462,51,121,172,13,10,26,21,50,132,21
DeAndre Jordan,C,33,PHI,16,1,214,32,54,.593,0,0,0,32,54,.593,.593,10,14,.714,32,60,92,8,2,9,16,21,74,21
Cory Joseph,PG,30,DET,65,39,1600,178,400,.445,65,157,.414,113,243,.465,.526,100,113,.885,29,145,174,237,42,17,85,147,521,21
Georgios Kalaitzakis,SF,23,TOT,13,4,214,31,67,.463,10,26,.385,21,41,.512,.537,14,30,.467,6,15,21,12,11,2,20,19,86,21
Georgios Kalaitzakis,SF,23,MIL,9,0,48,5,11,.455,2,4,.500,3,7,.429,.545,4,9,.444,4,4,8,0,1,1,4,8,16,21
Georgios Kalaitzakis,SF,23,OKC,4,4,166,26,56,.464,8,22,.364,18,34,.529,.536,10,21,.476,2,11,13,12,10,1,16,11,70,21
Frank Kaminsky,C,28,PHO,9,0,181,36,66,.545,5,15,.333,31,51,.608,.583,18,20,.900,11,30,41,13,8,7,5,14,95,21
Luke Kennard,SG,25,LAC,70,13,1919,287,639,.449,190,423,.449,97,216,.449,.598,69,77,.896,20,209,229,146,42,6,60,101,833,21
Braxton Key,SF,24,TOT,11,0,197,33,72,.458,6,21,.286,27,51,.529,.500,7,13,.538,13,37,50,11,10,11,11,26,79,21
Braxton Key,SF,24,PHI,2,0,6,1,2,.500,0,1,0,1,1,1.000,.500,0,0,0,1,1,2,1,1,0,2,1,2,21
Braxton Key,SF,24,DET,9,0,191,32,70,.457,6,20,.300,26,50,.520,.500,7,13,.538,12,36,48,10,9,11,9,25,77,21
George King,SF,28,DAL,4,0,19,0,5,0,0,4,0,0,1,0,0,1,2,.500,0,5,5,0,0,0,1,4,1,21
Louis King,SF,22,SAC,10,0,104,15,47,.319,8,27,.296,7,20,.350,.404,7,10,.700,0,12,12,9,2,1,0,14,45,21
Corey Kispert,SF,22,WAS,77,36,1801,234,514,.455,112,320,.350,122,194,.629,.564,54,62,.871,53,156,209,85,35,22,50,93,634,21
Maxi Kleber,PF,30,DAL,59,21,1450,141,354,.398,83,255,.325,58,99,.586,.516,46,65,.708,70,280,350,68,30,58,47,137,411,21
Brandon Knight,PG,30,DAL,5,0,65,10,25,.400,4,17,.235,6,8,.750,.480,8,8,1.000,0,8,8,8,1,0,4,5,32,21
Nathan Knight,PF,24,MIN,37,2,267,45,88,.511,4,13,.308,41,75,.547,.534,44,60,.733,32,53,85,22,7,8,18,42,138,21
Kevin Knox,SF,22,TOT,30,0,222,31,85,.365,15,54,.278,16,31,.516,.453,16,22,.727,14,30,44,10,4,2,7,19,93,21
Kevin Knox,SF,22,NYK,13,0,111,15,40,.375,10,28,.357,5,12,.417,.500,7,10,.700,8,14,22,3,2,1,5,5,47,21
Kevin Knox,SF,22,ATL,17,0,111,16,45,.356,5,26,.192,11,19,.579,.411,9,12,.750,6,16,22,7,2,1,2,14,46,21
John Konchar,SG,25,MEM,72,7,1292,135,262,.515,52,126,.413,83,136,.610,.615,27,49,.551,87,242,329,109,45,22,29,90,349,21
Furkan Korkmaz,SG,24,PHI,67,19,1414,182,470,.387,77,266,.289,105,204,.515,.469,68,84,.810,22,153,175,127,33,9,48,58,509,21
Luke Kornet,C,26,TOT,15,0,103,13,27,.481,0,5,0,13,22,.591,.481,4,6,.667,13,16,29,9,3,3,0,9,30,21
Luke Kornet,C,26,CLE,2,0,15,1,5,.200,0,1,0,1,4,.250,.200,2,3,.667,2,1,3,1,0,1,0,1,4,21
Luke Kornet,C,26,MIL,1,0,3,0,1,0,0,0,0,0,1,0,0,0,0,0,1,0,1,0,0,0,0,1,0,21
Luke Kornet,C,26,BOS,12,0,85,12,21,.571,0,4,0,12,17,.706,.571,2,3,.667,10,15,25,8,3,2,0,7,26,21
Vit Krejci,SG,21,OKC,30,8,690,68,167,.407,32,98,.327,36,69,.522,.503,19,22,.864,18,83,101,57,19,8,29,65,187,21
Arnoldas Kulboka,SF,24,CHO,2,0,5,0,1,0,0,1,0,0,0,0,0,0,0,0,0,0,0,0,0,0,0,1,0,21
Jonathan Kuminga,SF,19,GSW,70,12,1185,236,460,.513,50,149,.336,186,311,.598,.567,130,190,.684,54,180,234,64,31,22,74,146,652,21
Kyle Kuzma,PF,26,WAS,66,66,2204,423,936,.452,128,375,.341,295,561,.526,.520,156,219,.712,70,491,561,233,42,57,169,128,1130,21
Anthony Lamb,SF,24,SAS,2,0,8,0,2,0,0,2,0,0,0,0,0,0,0,0,0,1,1,2,0,0,0,0,0,21
Jeremy Lamb,SF-SG,29,TOT,56,0,935,133,347,.383,55,170,.324,78,177,.441,.463,89,106,.840,26,128,154,81,31,22,37,59,410,21
Jeremy Lamb,SF,29,IND,39,0,613,85,228,.373,39,117,.333,46,111,.414,.458,67,80,.838,15,79,94,51,23,14,24,44,276,21
Jeremy Lamb,SG,29,SAC,17,0,322,48,119,.403,16,53,.302,32,66,.485,.471,22,26,.846,11,49,60,30,8,8,13,15,134,21
Jock Landale,C,26,SAS,54,1,589,101,204,.495,29,89,.326,72,115,.626,.566,34,41,.829,63,75,138,45,10,14,31,53,265,21
Romeo Langford,SG,22,TOT,48,5,771,83,191,.435,29,85,.341,54,106,.509,.510,23,42,.548,30,78,108,21,22,16,16,47,218,21
Romeo Langford,SG,22,BOS,44,5,728,79,184,.429,29,83,.349,50,101,.495,.508,20,34,.588,30,74,104,19,21,16,16,46,207,21
Romeo Langford,SG,22,SAS,4,0,43,4,7,.571,0,2,0,4,5,.800,.571,3,8,.375,0,4,4,2,1,0,0,1,11,21
Zach LaVine,SG,26,CHI,67,67,2328,565,1186,.476,185,475,.389,380,711,.534,.554,320,375,.853,22,286,308,303,41,23,171,120,1635,21
Jake Layman,SF,27,MIN,34,1,231,30,73,.411,8,35,.229,22,38,.579,.466,13,18,.722,6,30,36,9,7,5,10,12,81,21
Damion Lee,SG,29,GSW,63,5,1256,169,383,.441,63,187,.337,106,196,.541,.523,66,75,.880,27,176,203,63,39,6,38,95,467,21
Saben Lee,PG,22,DET,37,0,604,69,177,.390,14,60,.233,55,117,.470,.429,56,71,.789,18,69,87,107,36,12,36,44,208,21
Alex Len,C,28,SAC,39,10,620,94,176,.534,6,21,.286,88,155,.568,.551,41,63,.651,52,109,161,45,13,25,43,100,235,21
Caris LeVert,SG,27,TOT,58,49,1781,379,854,.444,82,256,.320,297,598,.497,.492,146,193,.756,43,171,214,248,51,23,108,131,986,21
Caris LeVert,SG,27,IND,39,39,1214,278,622,.447,61,189,.323,217,433,.501,.496,111,146,.760,30,120,150,173,35,18,75,91,728,21
Caris LeVert,SG,27,CLE,19,10,567,101,232,.435,21,67,.313,80,165,.485,.481,35,47,.745,13,51,64,75,16,5,33,40,258,21
Kira Lewis Jr.,PG,20,NOP,24,0,341,59,146,.404,13,58,.224,46,88,.523,.449,10,12,.833,9,30,39,49,11,1,26,17,141,21
Scottie Lewis,SG,21,CHO,2,0,7,0,0,0,0,0,0,0,0,0,0,1,2,.500,0,0,0,1,1,0,0,0,1,21
Damian Lillard,PG,31,POR,29,29,1056,222,552,.402,92,284,.324,130,268,.485,.486,159,181,.878,13,107,120,212,17,11,83,37,695,21
Nassir Little,SF,21,POR,42,23,1088,145,315,.460,51,154,.331,94,161,.584,.541,69,94,.734,58,178,236,54,25,36,40,82,410,21
Isaiah Livers,SF,23,DET,19,5,383,41,90,.456,27,64,.422,14,26,.538,.606,12,14,.857,15,42,57,21,13,7,15,37,121,21
Kevon Looney,C,25,GSW,82,80,1732,208,364,.571,0,1,0,208,363,.573,.571,75,125,.600,208,388,596,165,50,52,67,215,491,21
Brook Lopez,C,33,MIL,13,11,298,61,131,.466,19,53,.358,42,78,.538,.538,20,23,.870,19,34,53,6,8,15,12,34,161,21
Robin Lopez,C,33,ORL,36,9,612,110,199,.553,2,6,.333,108,193,.560,.558,32,54,.593,68,58,126,54,2,18,44,67,254,21
Didi Louzada,SG-SF,22,TOT,9,1,129,12,33,.364,9,23,.391,3,10,.300,.500,2,2,1.000,5,12,17,5,2,2,5,13,35,21
Didi Louzada,SF,22,NOP,2,0,7,0,3,0,0,3,0,0,0,0,0,0,0,0,2,0,2,1,0,0,0,0,0,21
Didi Louzada,SG,22,POR,7,1,122,12,30,.400,9,20,.450,3,10,.300,.550,2,2,1.000,3,12,15,4,2,2,5,13,35,21
Kevin Love,C,33,CLE,74,4,1665,327,761,.430,187,477,.392,140,284,.493,.553,166,198,.838,87,449,536,160,26,18,98,101,1007,21
Kyle Lowry,PG,35,MIA,63,63,2133,276,627,.440,144,382,.377,132,245,.539,.555,148,174,.851,33,249,282,474,67,17,168,177,844,21
Gabriel Lundberg,SG,27,PHO,4,0,44,5,19,.263,3,8,.375,2,11,.182,.342,0,0,0,2,5,7,11,3,0,3,7,13,21
Timothé Luwawu-Cabarrot,SF,26,ATL,52,18,685,74,186,.398,44,122,.361,30,64,.469,.516,35,41,.854,17,65,82,40,18,6,20,76,227,21
Trey Lyles,PF,26,TOT,75,23,1537,262,562,.466,67,209,.321,195,353,.552,.526,195,243,.802,89,290,379,88,29,32,73,123,786,21
Trey Lyles,PF,26,DET,51,3,990,175,384,.456,44,146,.301,131,238,.550,.513,138,176,.784,60,184,244,58,22,26,54,91,532,21
Trey Lyles,PF,26,SAC,24,20,547,87,178,.489,23,63,.365,64,115,.557,.553,57,67,.851,29,106,135,30,7,6,19,32,254,21
Théo Maledon,PG,20,OKC,51,7,908,119,317,.375,44,150,.293,75,167,.449,.445,79,100,.790,20,111,131,111,31,11,65,67,361,21
Sandro Mamukelashvili,PF,22,MIL,41,3,407,57,115,.496,22,52,.423,35,63,.556,.591,18,22,.818,35,47,82,22,9,9,15,28,154,21
Terance Mann,SF,25,LAC,81,33,2317,334,690,.484,76,208,.365,258,482,.535,.539,128,164,.780,104,321,425,209,55,21,84,178,872,21
Tre Mann,PG,20,OKC,60,26,1367,231,588,.393,98,272,.360,133,316,.421,.476,65,82,.793,25,146,171,91,47,12,71,102,625,21
Boban Marjanović,C,33,DAL,23,0,128,42,70,.600,1,4,.250,41,66,.621,.607,13,22,.591,8,31,39,3,0,3,15,24,98,21
Lauri Markkanen,SF,24,CLE,61,61,1878,313,703,.445,136,380,.358,177,323,.548,.542,138,159,.868,59,286,345,81,45,30,54,130,900,21
Naji Marshall,SF,24,NOP,55,4,735,109,269,.405,21,105,.200,88,164,.537,.444,74,93,.796,38,104,142,62,33,8,46,69,313,21
Caleb Martin,SF,26,MIA,60,12,1372,208,410,.507,64,155,.413,144,255,.565,.585,71,93,.763,70,160,230,64,58,30,52,104,551,21
Cody Martin,SF,26,CHO,71,11,1866,204,423,.482,61,159,.384,143,264,.542,.554,75,107,.701,82,203,285,179,88,32,61,116,544,21
Kelan Martin,SF,26,TOT,30,1,450,70,171,.409,22,75,.293,48,96,.500,.474,9,13,.692,17,38,55,21,13,9,14,36,171,21
Kelan Martin,SF,26,IND,27,1,444,70,168,.417,22,74,.297,48,94,.511,.482,9,13,.692,16,37,53,21,13,9,14,36,171,21
Kelan Martin,SF,26,BOS,3,0,6,0,3,0,0,1,0,0,2,0,0,0,0,0,1,1,2,0,0,0,0,0,0,21
Kenyon Martin Jr.,SF,21,HOU,79,2,1656,279,523,.533,60,168,.357,219,355,.617,.591,78,123,.634,80,217,297,101,34,40,60,113,696,21
Garrison Mathews,SG,25,HOU,65,33,1712,184,461,.399,139,386,.360,45,75,.600,.550,143,180,.794,32,158,190,64,57,24,41,168,650,21
Dakota Mathias,SG,26,MEM,6,0,16,2,6,.333,2,6,.333,0,0,0,.500,0,0,0,0,2,2,1,1,0,0,1,6,21
Wesley Matthews,SG,35,MIL,49,14,1002,87,220,.395,53,157,.338,34,63,.540,.516,22,28,.786,30,62,92,36,23,8,18,87,249,21
Tyrese Maxey,PG,21,PHI,75,74,2650,483,995,.485,132,309,.427,351,686,.512,.552,213,246,.866,26,214,240,321,55,32,88,156,1311,21
Skylar Mays,SG,24,ATL,28,5,220,32,64,.500,8,25,.320,24,39,.615,.563,8,9,.889,5,20,25,17,7,0,10,9,80,21
Miles McBride,PG,21,NYK,40,2,372,32,108,.296,17,68,.250,15,40,.375,.375,8,12,.667,4,38,42,41,14,1,5,45,89,21
Mac McClung,SG-PG,23,TOT,2,0,25,3,6,.500,1,3,.333,2,3,.667,.583,1,1,1.000,0,3,3,1,1,1,3,5,8,21
Mac McClung,PG,23,CHI,1,0,3,1,1,1.000,0,0,0,1,1,1.000,1.000,0,0,0,0,0,0,0,0,0,1,0,2,21
Mac McClung,SG,23,LAL,1,0,22,2,5,.400,1,3,.333,1,2,.500,.500,1,1,1.000,0,3,3,1,1,1,2,5,6,21
CJ McCollum,SG,30,TOT,62,62,2145,536,1164,.460,182,469,.388,354,695,.509,.539,116,170,.682,53,216,269,315,70,22,127,121,1370,21
CJ McCollum,SG,30,POR,36,36,1267,290,665,.436,111,289,.384,179,376,.476,.520,48,68,.706,34,119,153,163,36,21,70,77,739,21
CJ McCollum,SG,30,NOP,26,26,878,246,499,.493,71,180,.394,175,319,.549,.564,68,102,.667,19,97,116,152,34,1,57,44,631,21
T.J. McConnell,PG,29,IND,27,8,652,100,208,.481,10,33,.303,90,175,.514,.505,19,23,.826,20,70,90,131,29,10,29,53,229,21
Jaden McDaniels,PF,21,MIN,70,31,1803,255,554,.460,80,252,.317,175,302,.579,.532,57,71,.803,76,217,293,79,52,54,75,224,647,21
Jalen McDaniels,SF,24,CHO,55,2,895,123,254,.484,41,108,.380,82,146,.562,.565,53,72,.736,37,133,170,58,26,22,36,93,340,21
Doug McDermott,PF,30,SAS,51,51,1223,215,465,.462,108,256,.422,107,209,.512,.578,40,51,.784,18,97,115,64,13,6,43,79,578,21
JaVale McGee,C,34,PHO,74,17,1172,288,458,.629,2,9,.222,286,449,.637,.631,102,146,.699,163,333,496,42,22,81,98,181,680,21
Cameron McGriff,SF,24,POR,3,0,46,5,14,.357,2,6,.333,3,8,.375,.429,2,2,1.000,6,9,15,3,0,1,0,7,14,21
Rodney McGruder,SG,30,DET,51,2,754,98,225,.436,58,146,.397,40,79,.506,.564,19,26,.731,31,80,111,48,21,7,24,58,273,21
Alfonzo McKinnie,SF,29,CHI,17,3,206,24,61,.393,9,27,.333,15,34,.441,.467,2,8,.250,13,20,33,5,2,3,7,26,59,21
JaQuori McLaughlin,PG,24,DAL,4,0,11,0,2,0,0,1,0,0,1,0,0,0,0,0,0,0,0,2,0,0,0,1,0,21
Jordan McLaughlin,PG,25,MIN,62,3,902,88,200,.440,27,85,.318,61,115,.530,.508,30,40,.750,22,72,94,180,57,10,38,54,233,21
Ben McLemore,SG,28,POR,64,6,1285,216,539,.401,151,417,.362,65,122,.533,.541,72,88,.818,12,91,103,59,38,10,55,103,655,21
De'Anthony Melton,SG,23,MEM,73,15,1657,281,695,.404,139,372,.374,142,323,.440,.504,90,120,.750,64,264,328,194,104,39,112,128,791,21
Sam Merrill,SG,25,MEM,6,0,58,8,24,.333,7,23,.304,1,1,1.000,.479,2,4,.500,1,6,7,4,0,0,2,3,25,21
Chimezie Metu,C,24,SAC,60,20,1279,203,449,.452,57,186,.306,146,263,.555,.516,71,91,.780,34,301,335,60,51,32,61,93,534,21
Khris Middleton,SF,30,MIL,66,66,2141,452,1021,.443,162,434,.373,290,587,.494,.522,259,291,.890,41,315,356,358,76,18,190,160,1325,21
C.J. Miles,SG,34,BOS,1,0,2,0,0,0,0,0,0,0,0,0,0,0,0,0,0,0,0,0,0,0,0,1,0,21
Patty Mills,SG,33,BRK,81,48,2346,324,794,.408,227,568,.400,97,226,.429,.551,48,59,.814,18,138,156,183,51,17,73,112,923,21
Paul Millsap,C,36,TOT,33,1,376,45,115,.391,8,35,.229,37,80,.463,.426,17,24,.708,41,73,114,29,10,13,19,67,115,21
Paul Millsap,C,36,BRK,24,0,270,32,85,.376,6,27,.222,26,58,.448,.412,12,17,.706,29,60,89,24,5,11,11,48,82,21
Paul Millsap,C,36,PHI,9,1,106,13,30,.433,2,8,.250,11,22,.500,.467,5,7,.714,12,13,25,5,5,2,8,19,33,21
Shake Milton,SG,25,PHI,55,6,1179,173,403,.429,43,133,.323,130,270,.481,.483,61,73,.836,30,112,142,139,28,17,44,99,450,21
Davion Mitchell,PG,23,SAC,75,19,2076,352,843,.418,101,320,.316,251,523,.480,.477,56,85,.659,33,133,166,313,55,24,114,141,861,21
Donovan Mitchell,SG,25,UTA,67,67,2266,617,1376,.448,232,654,.355,385,722,.533,.533,267,313,.853,55,227,282,358,99,12,200,164,1733,21
Evan Mobley,PF,20,CLE,69,69,2331,422,830,.508,23,92,.250,399,738,.541,.522,167,252,.663,143,427,570,174,56,115,133,147,1034,21
Malik Monk,SG,23,LAL,76,37,2139,391,826,.473,173,442,.391,218,384,.568,.578,93,117,.795,37,219,256,218,61,29,122,138,1048,21
Greg Monroe,C,31,TOT,14,0,195,32,57,.561,0,0,0,32,57,.561,.561,12,23,.522,30,34,64,22,8,10,12,24,76,21
Greg Monroe,C,31,MIN,4,0,81,13,22,.591,0,0,0,13,22,.591,.591,3,7,.429,6,18,24,16,4,6,7,9,29,21
Greg Monroe,C,31,WAS,2,0,18,4,8,.500,0,0,0,4,8,.500,.500,0,0,0,7,3,10,1,1,1,2,2,8,21
Greg Monroe,C,31,MIL,5,0,70,11,22,.500,0,0,0,11,22,.500,.500,5,9,.556,11,10,21,2,3,2,3,7,27,21
Greg Monroe,C,31,UTA,3,0,26,4,5,.800,0,0,0,4,5,.800,.800,4,7,.571,6,3,9,3,0,1,0,6,12,21
Moses Moody,SG,19,GSW,52,11,607,80,183,.437,40,110,.364,40,73,.548,.546,28,36,.778,17,63,80,23,7,10,13,43,228,21
Xavier Moon,SG,27,LAC,10,0,137,25,51,.490,5,14,.357,20,37,.541,.539,3,5,.600,2,12,14,24,7,3,6,9,58,21
Matt Mooney,SG,24,NYK,1,0,2,0,1,0,0,1,0,0,0,0,0,0,0,0,0,0,0,0,1,0,1,0,0,21
Ja Morant,PG,22,MEM,57,57,1889,580,1177,.493,88,256,.344,492,921,.534,.530,316,415,.761,77,248,325,384,66,22,196,86,1564,21
Juwan Morgan,PF,24,TOT,2,0,31,2,3,.667,1,2,.500,1,1,1.000,.833,0,0,0,2,2,4,1,0,0,0,3,5,21
Juwan Morgan,PF,24,TOR,1,0,27,2,3,.667,1,2,.500,1,1,1.000,.833,0,0,0,2,2,4,1,0,0,0,3,5,21
Juwan Morgan,PF,24,BOS,1,0,4,0,0,0,0,0,0,0,0,0,0,0,0,0,0,0,0,0,0,0,0,0,0,21
Jaylen Morris,SG,26,SAS,3,0,16,0,6,0,0,2,0,0,4,0,0,2,4,.500,0,2,2,2,0,0,1,2,2,21
Marcus Morris,PF,32,LAC,54,54,1564,300,691,.434,101,275,.367,199,416,.478,.507,129,148,.872,26,213,239,113,28,18,69,115,830,21
Markieff Morris,PF,32,MIA,17,1,298,54,114,.474,13,39,.333,41,75,.547,.531,8,9,.889,17,28,45,23,6,1,20,33,129,21
Monte Morris,PG,26,DEN,75,74,2239,374,773,.484,124,314,.395,250,459,.545,.564,73,84,.869,27,199,226,333,56,14,78,92,945,21
Emmanuel Mudiay,PG,25,SAC,2,0,11,0,2,0,0,0,0,0,2,0,0,3,4,.750,0,0,0,4,1,0,1,1,3,21
Mychal Mulder,PG,27,TOT,17,3,239,24,77,.312,17,54,.315,7,23,.304,.422,4,4,1.000,2,22,24,5,4,2,8,13,69,21
Mychal Mulder,PG,27,ORL,15,2,195,20,67,.299,13,46,.283,7,21,.333,.396,2,2,1.000,2,19,21,3,4,1,8,12,55,21
Mychal Mulder,PG,27,MIA,2,1,44,4,10,.400,4,8,.500,0,2,0,.600,2,2,1.000,0,3,3,2,0,1,0,1,14,21
Ade Murkey,SG,24,SAC,1,0,1,0,0,0,0,0,0,0,0,0,0,0,0,0,0,0,0,0,0,0,0,0,0,21
Trey Murphy III,SF,21,NOP,62,1,864,109,277,.394,71,186,.382,38,91,.418,.522,45,51,.882,47,100,147,38,23,7,16,60,334,21
Dejounte Murray,PG,25,SAS,68,68,2366,573,1241,.462,96,294,.327,477,947,.504,.500,196,247,.794,80,483,563,627,138,23,180,138,1438,21
Mike Muscala,C,30,OKC,43,0,592,113,248,.456,70,163,.429,43,85,.506,.597,48,57,.842,21,108,129,22,18,26,14,58,344,21
Svi Mykhailiuk,SF,24,TOR,56,5,716,91,234,.389,41,134,.306,50,100,.500,.476,32,37,.865,20,72,92,45,26,4,32,54,255,21
Abdel Nader,SF,28,PHO,14,0,145,12,35,.343,4,14,.286,8,21,.381,.400,6,10,.600,4,23,27,7,8,4,11,20,34,21
Larry Nance Jr.,C-PF,29,TOT,46,11,1040,129,247,.522,23,70,.329,106,177,.599,.569,40,57,.702,72,176,248,81,43,20,37,84,321,21
Larry Nance Jr.,C,29,POR,37,11,858,102,198,.515,19,62,.306,83,136,.610,.563,32,49,.653,58,151,209,73,38,13,27,67,255,21
Larry Nance Jr.,PF,29,NOP,9,0,182,27,49,.551,4,8,.500,23,41,.561,.592,8,8,1.000,14,25,39,8,5,7,10,17,66,21
RJ Nembhard Jr.,SG,22,CLE,14,0,63,6,18,.333,0,2,0,6,16,.375,.333,3,4,.750,3,4,7,12,1,0,3,2,15,21
Aaron Nesmith,SF,22,BOS,52,3,574,72,182,.396,31,115,.270,41,67,.612,.481,21,26,.808,15,74,89,22,20,5,31,70,196,21
Raul Neto,PG,29,WAS,70,19,1372,204,441,.463,35,120,.292,169,321,.526,.502,83,108,.769,13,121,134,217,55,3,79,104,526,21
Malik Newman,PG,24,CLE,1,0,8,3,5,.600,0,1,0,3,4,.750,.600,2,2,1.000,0,1,1,1,0,0,1,0,8,21
Georges Niang,PF,28,PHI,76,7,1736,246,563,.437,156,387,.403,90,176,.511,.575,52,59,.881,25,178,203,102,30,13,59,190,700,21
Daishen Nix,SG,19,HOU,24,0,261,27,67,.403,7,26,.269,20,41,.488,.455,16,30,.533,7,26,33,40,15,0,26,21,77,21
Zeke Nnaji,PF,21,DEN,41,1,698,96,186,.516,37,80,.463,59,106,.557,.616,41,65,.631,56,91,147,17,16,13,23,79,270,21
Nerlens Noel,C,27,NYK,25,11,562,32,60,.533,0,3,0,32,57,.561,.533,21,30,.700,48,93,141,23,30,31,20,67,85,21
Jaylen Nowell,SG,22,MIN,62,1,975,196,413,.475,63,160,.394,133,253,.526,.551,72,92,.783,22,101,123,130,27,10,36,73,527,21
Frank Ntilikina,SG,23,DAL,58,5,685,89,223,.399,38,111,.342,51,112,.455,.484,24,25,.960,12,67,79,69,27,7,31,61,240,21
Jusuf Nurkić,C,27,POR,56,56,1579,321,600,.535,15,56,.268,306,544,.563,.548,185,268,.690,167,452,619,157,62,34,143,189,842,21
David Nwaba,SF,29,HOU,46,4,609,85,176,.483,15,49,.306,70,127,.551,.526,48,67,.716,41,110,151,35,28,20,21,55,233,21
Jordan Nwora,SF,23,MIL,62,13,1185,186,462,.403,79,227,.348,107,235,.455,.488,36,43,.837,37,184,221,59,25,17,57,78,487,21
Royce O'Neale,SF,28,UTA,77,77,2406,203,444,.457,119,306,.389,84,138,.609,.591,45,56,.804,64,304,368,191,86,32,79,183,570,21
Semi Ojeleye,PF,27,TOT,30,0,406,30,99,.303,15,50,.300,15,49,.306,.379,23,29,.793,27,47,74,9,7,6,9,30,98,21
Semi Ojeleye,PF,27,MIL,20,0,308,18,70,.257,11,41,.268,7,29,.241,.336,10,13,.769,25,33,58,5,5,5,5,26,57,21
Semi Ojeleye,PF,27,LAC,10,0,98,12,29,.414,4,9,.444,8,20,.400,.483,13,16,.813,2,14,16,4,2,1,4,4,41,21
Chuma Okeke,PF,23,ORL,70,20,1749,216,575,.376,118,371,.318,98,204,.480,.478,55,65,.846,47,300,347,118,97,42,57,95,605,21
Josh Okogie,SG,23,MIN,49,6,516,42,104,.404,14,47,.298,28,57,.491,.471,35,51,.686,29,41,70,25,26,12,23,53,133,21
Onyeka Okongwu,C,21,ATL,48,6,992,156,226,.690,0,0,0,156,226,.690,.690,80,110,.727,115,168,283,53,31,60,44,149,392,21
Isaac Okoro,SF,21,CLE,67,61,1981,207,431,.480,55,157,.350,152,274,.555,.544,119,155,.768,72,129,201,121,56,22,58,164,588,21
KZ Okpala,PF,22,MIA,21,0,244,30,69,.435,9,26,.346,21,43,.488,.500,8,11,.727,11,30,41,14,4,7,5,25,77,21
Victor Oladipo,SG,29,MIA,8,1,173,35,73,.479,15,36,.417,20,37,.541,.582,14,19,.737,3,20,23,28,5,1,16,13,99,21
Cameron Oliver,SF,25,ATL,2,0,43,10,15,.667,1,3,.333,9,12,.750,.700,2,3,.667,2,4,6,3,1,1,0,5,23,21
Kelly Olynyk,C,30,DET,40,1,764,128,286,.448,40,119,.336,88,167,.527,.517,69,89,.775,54,123,177,111,31,19,58,100,365,21
Eugene Omoruyi,SF,24,DAL,4,0,18,2,5,.400,1,2,.500,1,3,.333,.500,2,4,.500,2,5,7,2,0,0,0,2,7,21
Miye Oni,SG,24,UTA,16,0,44,2,9,.222,1,8,.125,1,1,1.000,.278,0,1,0,1,6,7,5,0,0,1,7,5,21
Cedi Osman,SF,26,CLE,66,3,1462,247,572,.432,128,359,.357,119,213,.559,.544,87,131,.664,25,121,146,135,52,10,67,127,709,21
Daniel Oturu,C,22,TOR,3,0,27,3,6,.500,0,1,0,3,5,.600,.500,3,5,.600,1,4,5,0,0,2,0,1,9,21
Kelly Oubre Jr.,SF,26,CHO,76,13,1999,410,932,.440,191,553,.345,219,379,.578,.542,126,189,.667,79,223,302,84,77,31,67,189,1137,21
Jaysean Paige,PG,27,DET,1,0,7,0,3,0,0,2,0,0,1,0,0,0,0,0,0,1,1,1,0,0,1,2,0,21
Trayvon Palmer,SG,27,DET,1,0,17,0,1,0,0,0,0,0,1,0,0,0,0,0,0,2,2,0,0,0,1,2,0,21
Kevin Pangos,PG,29,CLE,24,3,166,15,46,.326,6,26,.231,9,20,.450,.391,3,4,.750,2,9,11,30,3,0,7,11,39,21
Jabari Parker,PF,26,BOS,12,0,112,18,38,.474,8,16,.500,10,22,.455,.579,9,9,1.000,5,23,28,6,4,1,8,13,53,21
Eric Paschall,PF,25,UTA,58,3,736,114,235,.485,40,108,.370,74,127,.583,.570,66,86,.767,30,76,106,36,9,5,27,51,334,21
Chris Paul,PG,36,PHO,65,65,2139,363,736,.493,63,199,.317,300,537,.559,.536,169,202,.837,22,261,283,702,121,20,153,134,958,21
Cameron Payne,PG,27,PHO,58,12,1278,240,587,.409,71,211,.336,169,376,.449,.469,75,89,.843,24,151,175,282,40,17,103,119,626,21
Elfrid Payton,PG,27,PHO,50,1,549,67,175,.383,4,18,.222,63,157,.401,.394,12,32,.375,21,67,88,99,25,6,47,38,150,21
Gary Payton II,SG,29,GSW,71,16,1247,212,344,.616,43,120,.358,169,224,.754,.679,35,58,.603,72,175,247,64,96,22,40,131,502,21
Norvel Pelle,C,28,UTA,3,0,19,3,5,.600,0,0,0,3,5,.600,.600,0,0,0,3,3,6,0,0,1,2,1,6,21
Reggie Perry,PF,21,TOT,10,1,187,40,79,.506,3,16,.188,37,63,.587,.525,9,15,.600,15,32,47,12,9,6,11,33,92,21
Reggie Perry,PF,21,POR,9,1,177,39,78,.500,3,16,.188,36,62,.581,.519,9,15,.600,15,31,46,12,9,6,11,30,90,21
Reggie Perry,PF,21,IND,1,0,10,1,1,1.000,0,0,0,1,1,1.000,1.000,0,0,0,0,1,1,0,0,0,0,3,2,21
Jamorko Pickett,PF,24,DET,13,0,176,18,50,.360,13,39,.333,5,11,.455,.490,1,2,.500,6,26,32,7,0,7,5,12,50,21
Theo Pinson,SF,26,DAL,19,0,148,14,39,.359,10,30,.333,4,9,.444,.487,10,10,1.000,2,19,21,17,5,2,5,12,48,21
Mason Plumlee,C,31,CHO,73,73,1793,205,320,.641,0,2,0,205,318,.645,.641,67,171,.392,176,389,565,226,61,52,100,224,477,21
Jakob Poeltl,C,26,SAS,68,67,1970,410,663,.618,1,1,1.000,409,662,.618,.619,94,190,.495,262,372,634,189,45,118,109,212,915,21
Aleksej Pokusevski,PF,20,OKC,61,12,1233,186,456,.408,57,197,.289,129,259,.498,.470,35,50,.700,73,245,318,131,39,38,94,88,464,21
Yves Pons,SF,22,MEM,12,0,71,5,16,.313,3,9,.333,2,7,.286,.406,0,2,0,5,7,12,1,1,4,1,6,13,21
Jordan Poole,SG,22,GSW,76,51,2283,474,1058,.448,211,580,.364,263,478,.550,.548,246,266,.925,34,226,260,304,60,23,187,206,1405,21
Kevin Porter Jr.,PG,21,HOU,61,61,1907,335,808,.415,155,413,.375,180,395,.456,.511,124,193,.642,43,224,267,376,69,22,192,156,949,21
Michael Porter Jr.,SF,23,DEN,9,9,265,37,103,.359,10,48,.208,27,55,.491,.408,5,9,.556,9,50,59,17,10,2,12,16,89,21
Otto Porter Jr.,PF,28,GSW,63,15,1396,193,416,.464,80,216,.370,113,200,.565,.560,49,61,.803,86,276,362,94,68,29,37,83,515,21
Bobby Portis,C,26,MIL,72,59,2028,417,871,.479,133,338,.393,284,533,.533,.555,85,113,.752,180,477,657,86,53,51,90,174,1052,21
Kristaps Porziņģis,PF,26,TOT,51,51,1481,352,767,.459,78,252,.310,274,515,.532,.510,248,286,.867,102,309,411,119,37,84,81,137,1030,21
Kristaps Porziņģis,PF,26,DAL,34,34,1002,229,508,.451,49,173,.283,180,335,.537,.499,147,170,.865,64,197,261,69,25,59,53,88,654,21
Kristaps Porziņģis,PF,26,WAS,17,17,479,123,259,.475,29,79,.367,94,180,.522,.531,101,116,.871,38,112,150,50,12,25,28,49,376,21
Micah Potter,C,23,DET,3,0,31,5,11,.455,0,2,0,5,9,.556,.455,2,2,1.000,4,5,9,0,1,1,1,4,12,21
Dwight Powell,C,30,DAL,82,71,1798,269,401,.671,13,37,.351,256,364,.703,.687,166,212,.783,173,231,404,97,37,39,64,220,717,21
Myles Powell,PG,24,PHI,11,0,52,5,17,.294,1,6,.167,4,11,.364,.324,2,2,1.000,1,5,6,3,1,0,3,8,13,21
Norman Powell,SF-SG,28,TOT,45,41,1458,279,605,.461,106,253,.419,173,352,.491,.549,189,233,.811,20,125,145,96,42,21,69,106,853,21
Norman Powell,SF,28,POR,40,39,1333,247,542,.456,93,229,.406,154,313,.492,.542,159,198,.803,17,114,131,82,40,17,62,92,746,21
Norman Powell,SG,28,LAC,5,2,125,32,63,.508,13,24,.542,19,39,.487,.611,30,35,.857,3,11,14,14,2,4,7,14,107,21
Joshua Primo,SF,19,SAS,50,16,965,101,270,.374,42,137,.307,59,133,.444,.452,44,59,.746,32,81,113,81,20,23,57,79,288,21
Taurean Prince,PF,27,MIN,69,8,1177,177,390,.454,86,229,.376,91,161,.565,.564,62,82,.756,26,148,174,68,47,23,53,116,502,21
Payton Pritchard,PG,24,BOS,71,2,1001,160,373,.429,101,245,.412,59,128,.461,.564,21,21,1.000,32,102,134,139,25,6,41,61,442,21
Trevelin Queen,SG,24,HOU,10,0,74,15,33,.455,9,24,.375,6,9,.667,.591,4,4,1.000,7,9,16,4,5,1,7,6,43,21
Neemias Queta,C,22,SAC,15,0,120,17,38,.447,0,0,0,17,38,.447,.447,11,17,.647,14,17,31,6,1,8,6,18,45,21
Immanuel Quickley,PG,22,NYK,78,3,1802,284,724,.392,137,396,.346,147,328,.448,.487,177,201,.881,31,216,247,275,54,3,99,167,882,21
Jahmi'us Ramsey,SG,20,SAC,19,0,134,24,58,.414,5,18,.278,19,40,.475,.457,7,14,.500,4,9,13,7,1,1,5,10,60,21
Julius Randle,PF,27,NYK,72,72,2544,512,1246,.411,120,390,.308,392,856,.458,.459,303,401,.756,125,591,716,370,53,39,245,205,1447,21
Austin Reaves,SG,23,LAL,61,19,1418,146,318,.459,53,167,.317,93,151,.616,.542,99,118,.839,45,148,193,110,29,20,40,87,444,21
Cam Reddish,SF,22,TOT,49,7,1012,165,408,.404,66,184,.359,99,224,.442,.485,101,112,.902,25,80,105,48,47,15,57,60,497,21
Cam Reddish,SF,22,ATL,34,7,797,138,343,.402,58,153,.379,80,190,.421,.487,72,80,.900,20,64,84,38,35,11,44,45,406,21
Cam Reddish,SF,22,NYK,15,0,215,27,65,.415,8,31,.258,19,34,.559,.477,29,32,.906,5,16,21,10,12,4,13,15,91,21
Davon Reed,SG,26,DEN,48,5,668,81,161,.503,37,86,.430,44,75,.587,.618,10,15,.667,14,94,108,53,24,9,16,63,209,21
Paul Reed,C,22,PHI,38,2,302,54,96,.563,2,8,.250,52,88,.591,.573,6,14,.429,44,48,92,16,33,14,10,57,116,21
Naz Reid,C,22,MIN,77,6,1215,233,476,.489,57,166,.343,176,310,.568,.549,114,149,.765,102,199,301,71,40,71,82,172,637,21
Nick Richards,C,24,CHO,50,5,367,60,90,.667,0,0,0,60,90,.667,.667,30,43,.698,34,52,86,13,9,21,24,51,150,21
Josh Richardson,SG,28,TOT,65,7,1600,234,534,.438,102,246,.415,132,288,.458,.534,96,108,.889,42,143,185,115,56,29,66,116,666,21
Josh Richardson,SG,28,BOS,44,0,1087,152,343,.443,62,156,.397,90,187,.481,.534,61,71,.859,26,99,125,66,34,23,39,82,427,21
Josh Richardson,SG,28,SAS,21,7,513,82,191,.429,40,90,.444,42,101,.416,.534,35,37,.946,16,44,60,49,22,6,27,34,239,21
Austin Rivers,SG,29,DEN,67,18,1480,146,350,.417,79,231,.342,67,119,.563,.530,32,44,.727,19,95,114,90,51,6,54,121,403,21
Duncan Robinson,SG,27,MIA,79,68,2043,290,726,.399,232,624,.372,58,102,.569,.559,51,61,.836,24,179,203,129,42,14,60,201,863,21
Justin Robinson,PG,24,TOT,25,0,304,28,93,.301,18,61,.295,10,32,.313,.398,4,8,.500,4,17,21,32,9,1,17,27,78,21
Justin Robinson,PG,24,MIL,17,0,198,18,57,.316,10,37,.270,8,20,.400,.404,2,2,1.000,2,11,13,21,8,0,11,17,48,21
Justin Robinson,PG,24,SAC,3,0,15,1,8,.125,0,3,0,1,5,.200,.125,0,0,0,0,1,1,2,0,0,1,2,2,21
Justin Robinson,PG,24,DET,5,0,91,9,28,.321,8,21,.381,1,7,.143,.464,2,6,.333,2,5,7,9,1,1,5,8,28,21
Mitchell Robinson,C,23,NYK,72,62,1848,261,343,.761,0,0,0,261,343,.761,.761,88,181,.486,295,322,617,38,58,133,60,195,610,21
Jeremiah Robinson-Earl,C,21,OKC,49,36,1087,134,324,.414,58,165,.352,76,159,.478,.503,40,54,.741,75,199,274,49,29,15,39,75,366,21
Isaiah Roby,PF,23,OKC,45,28,948,166,323,.514,44,99,.444,122,224,.545,.582,78,116,.672,75,142,217,71,36,34,43,109,454,21
Rajon Rondo,PG,35,TOT,39,1,697,68,176,.386,31,88,.352,37,88,.420,.474,19,26,.731,15,93,108,170,30,6,68,56,186,21
Rajon Rondo,PG,35,LAL,18,0,289,23,71,.324,8,30,.267,15,41,.366,.380,1,2,.500,10,39,49,67,12,5,34,25,55,21
Rajon Rondo,PG,35,CLE,21,1,408,45,105,.429,23,58,.397,22,47,.468,.538,18,24,.750,5,54,59,103,18,1,34,31,131,21
Derrick Rose,PG,33,NYK,26,4,636,122,274,.445,37,92,.402,85,182,.467,.513,30,31,.968,21,57,78,103,22,12,39,15,311,21
Terrence Ross,SG,30,ORL,63,0,1448,220,554,.397,77,264,.292,143,290,.493,.467,112,130,.862,20,141,161,116,28,12,75,68,629,21
Terry Rozier,SG,27,CHO,73,73,2458,518,1167,.444,222,593,.374,296,574,.516,.539,150,176,.852,56,259,315,326,93,25,96,119,1408,21
Ricky Rubio,PG,31,CLE,34,8,970,149,411,.363,59,174,.339,90,237,.380,.434,88,103,.854,15,126,141,225,49,7,90,75,445,21
D'Angelo Russell,PG,25,MIN,65,65,2077,401,975,.411,176,518,.340,225,457,.492,.502,198,240,.825,25,191,216,460,62,22,165,130,1176,21
Matt Ryan,SF,24,BOS,1,0,5,1,5,.200,1,5,.200,0,0,0,.300,0,0,0,0,0,0,0,1,0,0,0,3,21
Domantas Sabonis,PF,25,TOT,62,61,2136,443,773,.573,39,125,.312,404,648,.623,.598,246,332,.741,201,551,752,323,59,27,195,203,1171,21
Domantas Sabonis,PF,25,IND,47,46,1632,331,571,.580,35,108,.324,296,463,.639,.610,191,258,.740,155,412,567,236,46,22,143,146,888,21
Domantas Sabonis,PF,25,SAC,15,15,504,112,202,.554,4,17,.235,108,185,.584,.564,55,74,.743,46,139,185,87,13,5,52,57,283,21
Olivier Sarr,C,22,OKC,22,2,421,58,101,.574,13,29,.448,45,72,.625,.639,24,29,.828,34,59,93,19,6,15,22,52,153,21
Tomáš Satoranský,SG-PG-SF,30,TOT,55,13,906,72,191,.377,11,53,.208,61,138,.442,.406,43,54,.796,27,99,126,184,29,5,46,71,198,21
Tomáš Satoranský,SG,30,NOP,32,3,481,32,107,.299,5,31,.161,27,76,.355,.322,19,25,.760,18,46,64,76,14,1,23,33,88,21
Tomáš Satoranský,SF,30,SAS,1,0,9,0,0,0,0,0,0,0,0,0,0,3,4,.750,0,1,1,0,0,0,0,0,3,21
Tomáš Satoranský,PG,30,WAS,22,10,416,40,84,.476,6,22,.273,34,62,.548,.512,21,25,.840,9,52,61,108,15,4,23,38,107,21
Jordan Schakel,SG,23,WAS,4,0,30,1,11,.091,1,6,.167,0,5,0,.136,2,2,1.000,2,6,8,0,1,0,1,0,5,21
Admiral Schofield,SF,24,ORL,38,1,469,54,129,.419,26,79,.329,28,50,.560,.519,12,15,.800,17,72,89,25,4,5,21,58,146,21
Dennis Schröder,SG-PG,28,TOT,64,29,1837,312,724,.431,86,250,.344,226,474,.477,.490,157,184,.853,34,180,214,296,53,8,143,154,867,21
Dennis Schröder,SG,28,BOS,49,25,1433,257,584,.440,67,192,.349,190,392,.485,.497,123,145,.848,28,136,164,208,41,5,104,116,704,21
Dennis Schröder,PG,28,HOU,15,4,404,55,140,.393,19,58,.328,36,82,.439,.461,34,39,.872,6,44,50,88,12,3,39,38,163,21
Tre Scott,SF,25,CLE,2,0,11,3,6,.500,0,1,0,3,5,.600,.500,0,0,0,1,1,2,0,1,1,0,2,6,21
Jay Scrubb,SG,21,LAC,18,0,121,18,46,.391,6,21,.286,12,25,.480,.457,7,10,.700,2,14,16,8,4,3,7,9,49,21
Wayne Selden,SG,27,NYK,3,0,19,1,4,.250,1,2,.500,0,2,0,.375,2,4,.500,0,1,1,1,0,0,0,1,5,21
Alperen Şengün,C,19,HOU,72,13,1489,249,525,.474,29,117,.248,220,408,.539,.502,165,232,.711,138,255,393,185,59,68,145,214,692,21
Collin Sexton,SG,23,CLE,11,11,316,68,151,.450,11,45,.244,57,106,.538,.487,29,39,.744,13,23,36,23,10,0,31,25,176,21
Landry Shamet,SG,24,PHO,69,14,1437,191,485,.394,123,334,.368,68,151,.450,.521,68,81,.840,16,110,126,108,28,9,41,92,573,21
Day'Ron Sharpe,PF,20,BRK,32,8,391,86,149,.577,2,7,.286,84,142,.592,.584,24,41,.585,81,79,160,17,10,15,30,60,198,21
Pascal Siakam,PF,27,TOR,68,68,2578,596,1207,.494,75,218,.344,521,989,.527,.525,284,379,.749,128,452,580,360,85,42,181,225,1551,21
Chris Silva,PF,25,TOT,10,0,91,8,15,.533,0,0,0,8,15,.533,.533,10,12,.833,13,23,36,7,0,1,8,20,26,21
Chris Silva,PF,25,MIN,1,0,3,0,0,0,0,0,0,0,0,0,0,0,0,0,0,1,1,0,0,0,0,0,0,21
Chris Silva,PF,25,MIA,9,0,88,8,15,.533,0,0,0,8,15,.533,.533,10,12,.833,13,22,35,7,0,1,8,20,26,21
Marko Simonovic,C,22,CHI,9,0,35,4,15,.267,1,5,.200,3,10,.300,.300,8,11,.727,5,5,10,0,1,1,2,6,17,21
Anfernee Simons,SG,22,POR,57,30,1681,353,797,.443,179,442,.405,174,355,.490,.555,103,116,.888,26,125,151,221,30,6,115,110,988,21
Zavier Simpson,PG,24,OKC,4,4,174,19,52,.365,1,8,.125,18,44,.409,.375,5,5,1.000,2,19,21,30,5,4,10,15,44,21
Jericho Sims,PF,23,NYK,41,5,555,39,54,.722,0,0,0,39,54,.722,.722,12,29,.414,61,108,169,21,11,22,20,66,90,21
Deividas Sirvydis,SG,21,DET,3,0,27,1,10,.100,1,7,.143,0,3,0,.150,0,0,0,0,6,6,1,3,1,0,4,3,21
Javonte Smart,PG,22,TOT,17,1,200,19,60,.317,8,27,.296,11,33,.333,.383,5,6,.833,5,19,24,16,6,3,11,12,51,21
Javonte Smart,PG,22,MIL,13,1,160,11,43,.256,4,18,.222,7,25,.280,.302,5,6,.833,4,15,19,14,4,2,9,11,31,21
Javonte Smart,PG,22,MIA,4,0,40,8,17,.471,4,9,.444,4,8,.500,.588,0,0,0,1,4,5,2,2,1,2,1,20,21
Marcus Smart,PG,27,BOS,71,71,2296,300,718,.418,119,360,.331,181,358,.506,.501,142,179,.793,42,228,270,417,119,18,159,160,861,21
Dennis Smith Jr.,PG,24,POR,37,4,638,79,189,.418,6,27,.222,73,162,.451,.434,42,64,.656,20,68,88,132,45,12,51,52,206,21
Ish Smith,PG,33,TOT,65,1,1126,185,430,.430,25,67,.373,160,363,.441,.459,15,24,.625,25,115,140,244,47,23,78,78,410,21
Ish Smith,PG,33,CHO,37,1,511,73,185,.395,10,25,.400,63,160,.394,.422,12,19,.632,11,46,57,98,20,10,36,34,168,21
Ish Smith,PG,33,WAS,28,0,615,112,245,.457,15,42,.357,97,203,.478,.488,3,5,.600,14,69,83,146,27,13,42,44,242,21
Jalen Smith,PF,21,TOT,51,8,925,176,350,.503,40,122,.328,136,228,.596,.560,78,102,.765,101,206,307,24,15,41,42,96,470,21
Jalen Smith,PF,21,PHO,29,4,382,63,137,.460,9,39,.231,54,98,.551,.493,40,52,.769,55,84,139,6,6,18,22,52,175,21
Jalen Smith,PF,21,IND,22,4,543,113,213,.531,31,83,.373,82,130,.631,.603,38,50,.760,46,122,168,18,9,23,20,44,295,21
Xavier Sneed,SF,24,TOT,9,0,39,2,10,.200,1,8,.125,1,2,.500,.250,0,0,0,2,4,6,1,0,0,0,2,5,21
Xavier Sneed,SF,24,MEM,2,0,8,0,2,0,0,2,0,0,0,0,0,0,0,0,1,1,2,0,0,0,0,2,0,21
Xavier Sneed,SF,24,UTA,7,0,31,2,8,.250,1,6,.167,1,2,.500,.313,0,0,0,1,3,4,1,0,0,0,0,5,21
Tony Snell,SG,30,TOT,53,12,823,69,171,.404,45,128,.352,24,43,.558,.535,4,4,1.000,16,87,103,28,16,9,19,70,187,21
Tony Snell,SG,30,POR,38,10,546,36,97,.371,24,75,.320,12,22,.545,.495,3,3,1.000,11,61,72,20,8,7,11,44,99,21
Tony Snell,SG,30,NOP,15,2,277,33,74,.446,21,53,.396,12,21,.571,.588,1,1,1.000,5,26,31,8,8,2,8,26,88,21
Jaden Springer,SG,19,PHI,2,0,6,1,1,1.000,0,0,0,1,1,1.000,1.000,0,0,0,1,1,2,0,0,2,1,0,2,21
Cassius Stanley,SG,22,DET,9,1,155,19,46,.413,4,17,.235,15,29,.517,.457,10,10,1.000,5,14,19,4,5,2,6,17,52,21
Nik Stauskas,SG,28,TOT,8,0,39,5,14,.357,4,10,.400,1,4,.250,.500,4,6,.667,1,2,3,2,0,0,1,1,18,21
Nik Stauskas,SG,28,MIA,2,0,24,3,8,.375,2,4,.500,1,4,.250,.500,3,4,.750,1,2,3,1,0,0,0,1,11,21
Nik Stauskas,SG,28,BOS,6,0,15,2,6,.333,2,6,.333,0,0,0,.500,1,2,.500,0,0,0,1,0,0,1,0,7,21
Lance Stephenson,PG-SG,31,TOT,46,1,814,147,323,.455,27,90,.300,120,233,.515,.497,63,80,.788,12,115,127,165,24,4,72,96,384,21
Lance Stephenson,SG,31,ATL,6,0,70,5,13,.385,0,3,0,5,10,.500,.385,1,2,.500,1,14,15,11,0,0,4,8,11,21
Lance Stephenson,PG,31,IND,40,1,744,142,310,.458,27,87,.310,115,223,.516,.502,62,78,.795,11,101,112,154,24,4,68,88,373,21
Lamar Stevens,PF,24,CLE,63,13,1015,156,319,.489,18,65,.277,138,254,.543,.517,53,75,.707,47,117,164,44,31,18,41,106,383,21
Isaiah Stewart,C,20,DET,71,71,1816,250,490,.510,15,46,.326,235,444,.529,.526,74,103,.718,226,391,617,82,22,78,85,211,589,21
Max Strus,SF,25,MIA,68,16,1587,249,564,.441,181,442,.410,68,122,.557,.602,42,53,.792,24,178,202,92,28,16,57,116,721,21
Jalen Suggs,PG,20,ORL,48,45,1307,198,548,.361,42,196,.214,156,352,.443,.400,126,163,.773,26,145,171,209,59,19,143,142,564,21
Craig Sword,SG,28,WAS,3,0,19,3,4,.750,0,1,0,3,3,1.000,.750,0,0,0,0,0,0,1,4,0,1,7,6,21
Keifer Sykes,PG,28,IND,32,11,566,69,190,.363,27,90,.300,42,100,.420,.434,15,17,.882,8,37,45,62,12,4,33,51,180,21
Jae'Sean Tate,PF,26,HOU,78,77,2056,363,729,.498,63,202,.312,300,527,.569,.541,130,184,.707,135,285,420,222,72,41,139,286,919,21
Jayson Tatum,SF,23,BOS,76,76,2731,708,1564,.453,230,651,.353,478,913,.524,.526,400,469,.853,85,524,609,334,75,49,217,174,2046,21
Terry Taylor,PF,22,IND,33,7,714,135,220,.614,12,38,.316,123,182,.676,.641,36,51,.706,95,77,172,41,14,8,23,61,318,21
Garrett Temple,SG,35,NOP,59,16,1098,111,295,.376,59,185,.319,52,110,.473,.476,28,41,.683,29,114,143,74,43,23,42,81,309,21
Emanuel Terry,PF,25,PHO,3,0,18,0,5,0,0,0,0,0,5,0,0,0,0,0,8,7,15,2,1,0,5,4,0,21
Tyrell Terry,PG,21,MEM,2,0,3,1,1,1.000,0,0,0,1,1,1.000,1.000,0,0,0,0,0,0,0,0,0,0,1,2,21
Jon Teske,C,24,MEM,3,0,8,0,1,0,0,0,0,0,1,0,0,0,2,0,0,2,2,1,1,0,0,1,0,21
Daniel Theis,C,29,TOT,47,27,977,151,291,.519,33,107,.308,118,184,.641,.576,49,72,.681,59,169,228,41,20,31,46,111,384,21
Daniel Theis,C,29,HOU,26,21,584,84,179,.469,23,79,.291,61,100,.610,.534,27,40,.675,32,98,130,20,11,17,31,62,218,21
Daniel Theis,C,29,BOS,21,6,393,67,112,.598,10,28,.357,57,84,.679,.643,22,32,.688,27,71,98,21,9,14,15,49,166,21
Brodric Thomas,SG,25,BOS,12,0,60,8,18,.444,2,9,.222,6,9,.667,.500,3,5,.600,2,8,10,11,1,1,6,7,21,21
Cam Thomas,SG,20,BRK,67,2,1176,218,503,.433,47,174,.270,171,329,.520,.480,87,105,.829,16,145,161,78,33,8,55,66,570,21
Isaiah Thomas,PG,32,TOT,22,1,333,67,167,.401,28,83,.337,39,84,.464,.485,22,26,.846,4,25,29,34,7,5,15,34,184,21
Isaiah Thomas,PG,32,LAL,4,1,101,12,39,.308,5,22,.227,7,17,.412,.372,8,11,.727,1,7,8,6,0,2,5,12,37,21
Isaiah Thomas,PG,32,DAL,1,0,13,3,8,.375,0,3,0,3,5,.600,.375,0,0,0,0,0,0,4,0,0,0,0,6,21
Isaiah Thomas,PG,32,CHO,17,0,219,52,120,.433,23,58,.397,29,62,.468,.529,14,15,.933,3,18,21,24,7,3,10,22,141,21
Matt Thomas,SG,27,CHI,40,0,459,55,134,.410,35,91,.385,20,43,.465,.541,16,20,.800,3,47,50,20,8,3,8,18,161,21
Klay Thompson,SG,31,GSW,32,32,941,246,573,.429,114,296,.385,132,277,.477,.529,46,51,.902,15,110,125,88,16,17,43,54,652,21
Tristan Thompson,PF,30,TOT,57,6,897,141,267,.528,1,3,.333,140,264,.530,.530,61,116,.526,120,168,288,34,23,21,45,98,344,21
Tristan Thompson,PF,30,SAC,30,3,455,76,151,.503,1,1,1.000,75,150,.500,.507,32,60,.533,72,89,161,18,11,12,29,52,185,21
Tristan Thompson,PF,30,IND,4,0,66,13,24,.542,0,0,0,13,24,.542,.542,3,8,.375,7,11,18,2,0,2,4,7,29,21
Tristan Thompson,PF,30,CHI,23,3,376,52,92,.565,0,2,0,52,90,.578,.565,26,48,.542,41,68,109,14,12,7,12,39,130,21
JT Thor,PF,19,CHO,33,0,262,24,55,.436,7,27,.259,17,28,.607,.500,12,20,.600,11,32,43,19,8,11,10,26,67,21
Matisse Thybulle,SG,24,PHI,66,50,1685,150,300,.500,45,144,.313,105,156,.673,.575,34,43,.791,42,109,151,75,115,71,39,158,379,21
Killian Tillie,C,23,MEM,36,3,461,43,127,.339,27,86,.314,16,41,.390,.445,5,8,.625,21,39,60,22,23,15,13,58,118,21
Xavier Tillman Sr.,PF,23,MEM,53,2,701,98,216,.454,10,49,.204,88,167,.527,.477,46,71,.648,66,95,161,62,49,15,34,63,252,21
Isaiah Todd,PF,20,WAS,12,0,74,7,26,.269,4,16,.250,3,10,.300,.346,2,6,.333,3,9,12,4,4,2,4,4,20,21
Obi Toppin,PF,23,NYK,72,10,1230,251,473,.531,52,169,.308,199,304,.655,.586,94,124,.758,69,199,268,77,25,33,56,102,648,21
Juan Toscano-Anderson,SF,28,GSW,73,6,994,115,235,.489,28,87,.322,87,148,.588,.549,40,70,.571,28,148,176,127,48,17,68,115,298,21
Karl-Anthony Towns,C,26,MIN,74,74,2476,642,1214,.529,150,366,.410,492,848,.580,.591,384,467,.822,194,533,727,269,72,83,226,267,1818,21
Gary Trent Jr.,SG,23,TOR,70,69,2448,450,1086,.414,209,545,.383,241,541,.445,.511,174,204,.853,26,165,191,141,122,19,73,144,1283,21
P.J. Tucker,PF,36,MIA,71,70,1981,207,428,.484,80,193,.415,127,235,.540,.577,45,61,.738,100,287,387,149,58,15,66,161,539,21
Rayjon Tucker,SG,24,TOT,5,0,71,6,9,.667,4,5,.800,2,4,.500,.889,5,7,.714,3,5,8,10,4,0,1,5,21,21
Rayjon Tucker,SG,24,DEN,3,0,29,1,2,.500,1,2,.500,0,0,0,.750,3,4,.750,1,3,4,4,1,0,0,3,6,21
Rayjon Tucker,SG,24,MIL,2,0,42,5,7,.714,3,3,1.000,2,4,.500,.929,2,3,.667,2,2,4,6,3,0,1,2,15,21
Myles Turner,C,25,IND,42,42,1235,200,393,.509,61,183,.333,139,210,.662,.587,79,105,.752,65,232,297,44,28,118,54,119,540,21
Jonas Valančiūnas,C,29,NOP,74,74,2240,510,938,.544,57,158,.361,453,780,.581,.574,237,289,.820,226,617,843,190,41,60,179,247,1314,21
Denzel Valentine,SG,28,TOT,24,0,222,25,66,.379,19,47,.404,6,19,.316,.523,0,0,0,9,33,42,11,8,0,12,20,69,21
Denzel Valentine,SG,28,CLE,22,0,204,23,62,.371,18,44,.409,5,18,.278,.516,0,0,0,9,29,38,11,7,0,10,17,64,21
Denzel Valentine,SG,28,UTA,2,0,18,2,4,.500,1,3,.333,1,1,1.000,.625,0,0,0,0,4,4,0,1,0,2,3,5,21
Jarred Vanderbilt,PF,22,MIN,74,67,1880,212,361,.587,2,14,.143,210,347,.605,.590,86,131,.656,215,409,624,94,99,46,73,181,512,21
Fred VanVleet,PG,27,TOR,65,65,2462,442,1097,.403,242,642,.377,200,455,.440,.513,194,222,.874,44,245,289,434,111,35,170,162,1320,21
Devin Vassell,SF,21,SAS,71,32,1937,326,764,.427,137,380,.361,189,384,.492,.516,83,99,.838,44,262,306,136,76,41,58,143,872,21
Gabe Vincent,PG,25,MIA,68,27,1589,214,513,.417,119,323,.368,95,190,.500,.533,44,54,.815,22,104,126,210,62,12,98,158,591,21
Nikola Vučević,C,31,CHI,73,73,2418,546,1154,.473,104,331,.314,442,823,.537,.518,92,121,.760,142,662,804,236,70,71,136,181,1288,21
Dean Wade,PF,25,CLE,51,28,980,99,217,.456,51,142,.359,48,75,.640,.574,20,30,.667,31,119,150,52,29,7,16,88,269,21
Franz Wagner,SF,20,ORL,79,79,2429,456,975,.468,96,271,.354,360,704,.511,.517,189,219,.863,84,272,356,231,68,34,119,164,1197,21
Moritz Wagner,C,24,ORL,63,3,960,197,396,.497,66,201,.328,131,195,.672,.581,104,129,.806,42,190,232,87,20,13,56,123,564,21
Ish Wainright,PF,27,PHO,45,0,359,41,104,.394,19,59,.322,22,45,.489,.486,7,12,.583,27,27,54,15,20,6,13,49,108,21
Kemba Walker,PG,31,NYK,37,37,948,149,370,.403,73,199,.367,76,171,.444,.501,60,71,.845,14,97,111,131,26,7,48,37,431,21
Lonnie Walker IV,SG,23,SAS,70,6,1612,311,764,.407,111,353,.314,200,411,.487,.480,116,148,.784,18,163,181,152,44,19,71,98,849,21
M.J. Walker,SG,23,PHO,2,0,8,0,4,0,0,2,0,0,2,0,0,0,0,0,0,1,1,1,2,0,0,1,0,21
Tyrone Wallace,SG,27,NOP,6,0,75,7,20,.350,2,8,.250,5,12,.417,.400,1,5,.200,0,8,8,1,3,1,2,7,17,21
Derrick Walton,PG,26,DET,3,3,108,6,26,.231,3,13,.231,3,13,.231,.288,4,4,1.000,2,8,10,21,7,4,11,8,19,21
Brad Wanamaker,PG,32,TOT,23,2,320,28,77,.364,4,17,.235,24,60,.400,.390,23,25,.920,6,33,39,55,7,6,23,45,83,21
Brad Wanamaker,PG,32,IND,22,1,293,26,72,.361,4,17,.235,22,55,.400,.389,20,22,.909,6,29,35,48,5,6,23,42,76,21
Brad Wanamaker,PG,32,WAS,1,1,27,2,5,.400,0,0,0,2,5,.400,.400,3,3,1.000,0,4,4,7,2,0,0,3,7,21
Duane Washington Jr.,PG,21,IND,48,7,968,173,427,.405,81,215,.377,92,212,.434,.500,46,61,.754,4,79,83,85,26,3,57,66,473,21
P.J. Washington,C,23,CHO,65,28,1768,250,532,.470,110,301,.365,140,231,.606,.573,58,81,.716,82,255,337,147,57,61,82,152,668,21
Yuta Watanabe,SF,27,TOR,38,4,445,56,138,.406,27,79,.342,29,59,.492,.504,24,40,.600,18,74,92,21,11,16,19,38,163,21
Lindy Waters III,SG,24,OKC,25,1,465,71,175,.406,53,146,.363,18,29,.621,.557,4,5,.800,6,67,73,24,19,8,11,31,199,21
Tremont Waters,PG,24,TOT,3,0,50,4,14,.286,2,9,.222,2,5,.400,.357,0,0,0,0,4,4,7,5,0,4,4,10,21
Tremont Waters,PG,24,TOR,2,0,42,3,12,.250,2,9,.222,1,3,.333,.333,0,0,0,0,4,4,7,4,0,4,2,8,21
Tremont Waters,PG,24,WAS,1,0,8,1,2,.500,0,0,0,1,2,.500,.500,0,0,0,0,0,0,0,1,0,0,2,2,21
Trendon Watford,SF,21,POR,48,10,869,142,267,.532,9,38,.237,133,229,.581,.549,71,94,.755,57,142,199,81,25,28,44,116,364,21
Paul Watson,SF,27,OKC,9,3,156,12,35,.343,6,26,.231,6,9,.667,.429,1,2,.500,3,24,27,8,3,3,4,10,31,21
Quinndary Weatherspoon,SG,25,GSW,11,0,73,12,21,.571,1,5,.200,11,16,.688,.595,5,5,1.000,2,12,14,5,1,1,3,15,30,21
Russell Westbrook,PG,33,LAL,78,78,2678,548,1233,.444,79,265,.298,469,968,.485,.476,266,399,.667,110,470,580,550,75,20,295,235,1441,21
Coby White,PG,21,CHI,61,17,1675,279,644,.433,136,353,.385,143,291,.491,.539,78,91,.857,17,165,182,176,29,11,70,137,772,21
Derrick White,SG,27,TOT,75,52,2199,337,800,.421,115,369,.312,222,431,.515,.493,203,235,.864,38,223,261,366,64,58,119,172,992,21
Derrick White,SG,27,SAS,49,48,1486,243,570,.426,81,258,.314,162,312,.519,.497,139,160,.869,25,148,173,274,49,42,87,116,706,21
Derrick White,SG,27,BOS,26,4,713,94,230,.409,34,111,.306,60,119,.504,.483,64,75,.853,13,75,88,92,15,16,32,56,286,21
Hassan Whiteside,C,32,UTA,65,8,1162,215,330,.652,0,0,0,215,330,.652,.652,104,167,.623,166,328,494,26,22,103,53,179,534,21
Joe Wieskamp,SG,22,SAS,29,0,205,20,56,.357,14,43,.326,6,13,.462,.482,7,13,.538,4,10,14,9,4,3,2,14,61,21
Aaron Wiggins,SG,23,OKC,50,35,1209,156,337,.463,42,138,.304,114,199,.573,.525,62,85,.729,51,127,178,68,30,10,54,93,416,21
Andrew Wiggins,SF,26,GSW,73,73,2329,475,1019,.466,157,399,.393,318,620,.513,.543,149,235,.634,85,240,325,161,76,51,111,158,1256,21
Lindell Wigginton,PG,23,MIL,19,0,199,26,61,.426,9,26,.346,17,35,.486,.500,19,35,.543,3,22,25,23,5,1,12,17,80,21
Brandon Williams,PG,22,POR,24,16,640,105,282,.372,31,106,.292,74,176,.420,.427,68,97,.701,19,55,74,94,24,10,58,52,309,21
Grant Williams,PF,23,BOS,77,21,1875,205,432,.475,106,258,.411,99,174,.569,.597,86,95,.905,64,210,274,78,38,57,62,186,602,21
Kenrich Williams,SF,27,OKC,49,0,1072,146,317,.461,41,121,.339,105,196,.536,.525,30,55,.545,75,145,220,108,44,10,46,81,363,21
Lou Williams,PG,35,ATL,56,0,799,125,320,.391,37,102,.363,88,218,.404,.448,67,78,.859,16,71,87,105,28,3,43,48,354,21
Patrick Williams,PF,20,CHI,17,9,422,54,102,.529,15,29,.517,39,73,.534,.603,30,41,.732,17,52,69,15,9,9,16,28,153,21
Robert Williams,C,24,BOS,61,61,1804,271,368,.736,0,1,0,271,367,.738,.736,65,90,.722,238,350,588,121,56,134,63,137,607,21
Ziaire Williams,SF,20,MEM,62,31,1346,191,424,.450,76,242,.314,115,182,.632,.540,43,55,.782,26,103,129,65,35,12,41,113,501,21
D.J. Wilson,PF,25,TOR,4,1,54,11,15,.733,0,2,0,11,13,.846,.733,8,10,.800,1,15,16,5,5,1,2,6,30,21
Dylan Windler,SF,25,CLE,50,0,459,37,98,.378,21,70,.300,16,28,.571,.485,15,18,.833,21,68,89,34,14,3,16,47,110,21
Justise Winslow,PF,25,TOT,48,11,774,110,257,.428,15,66,.227,95,191,.497,.457,39,66,.591,50,152,202,84,35,25,49,67,274,21
Justise Winslow,PF,25,LAC,37,1,479,63,141,.447,5,29,.172,58,112,.518,.465,25,41,.610,30,103,133,52,21,18,37,46,156,21
Justise Winslow,PF,25,POR,11,10,295,47,116,.405,10,37,.270,37,79,.468,.448,14,25,.560,20,49,69,32,14,7,12,21,118,21
Cassius Winston,PG,23,WAS,7,0,39,4,11,.364,2,6,.333,2,5,.400,.455,4,4,1.000,0,1,1,7,0,0,3,9,14,21
Christian Wood,C,26,HOU,68,67,2094,440,878,.501,131,336,.390,309,542,.570,.576,207,332,.623,110,576,686,155,54,65,126,171,1218,21
Robert Woodard II,SF,22,SAC,12,0,42,2,16,.125,1,4,.250,1,12,.083,.156,2,2,1.000,5,6,11,3,1,1,1,3,7,21
Delon Wright,SG,29,ATL,77,8,1452,122,269,.454,44,116,.379,78,153,.510,.535,54,63,.857,50,170,220,188,93,19,45,56,342,21
McKinley Wright IV,PG,23,MIN,5,0,19,2,3,.667,1,2,.500,1,1,1.000,.833,0,0,0,0,0,0,3,0,0,1,1,5,21
Moses Wright,PF,23,TOT,4,0,14,1,4,.250,0,1,0,1,3,.333,.250,3,3,1.000,1,2,3,2,0,1,0,0,5,21
Moses Wright,PF,23,LAC,1,0,1,0,0,0,0,0,0,0,0,0,0,0,0,0,0,0,0,1,0,0,0,0,0,21
Moses Wright,PF,23,DAL,3,0,13,1,4,.250,0,1,0,1,3,.333,.250,3,3,1.000,1,2,3,1,0,1,0,0,5,21
Gabe York,SG,28,IND,2,0,21,2,7,.286,1,6,.167,1,1,1.000,.357,3,5,.600,0,2,2,4,2,1,1,4,8,21
Thaddeus Young,PF,33,TOT,52,1,845,141,272,.518,17,48,.354,124,224,.554,.550,23,49,.469,80,128,208,104,54,18,52,81,322,21
Thaddeus Young,PF,33,SAS,26,1,370,74,128,.578,0,5,0,74,123,.602,.578,10,22,.455,40,53,93,59,23,7,30,38,158,21
Thaddeus Young,PF,33,TOR,26,0,475,67,144,.465,17,43,.395,50,101,.495,.524,13,27,.481,40,75,115,45,31,11,22,43,164,21
Trae Young,PG,23,ATL,76,76,2652,711,1544,.460,233,610,.382,478,934,.512,.536,500,553,.904,50,234,284,737,72,7,303,128,2155,21
Omer Yurtseven,C,23,MIA,56,12,706,130,247,.526,1,11,.091,129,236,.547,.528,38,61,.623,85,209,294,49,17,20,41,84,299,21
Cody Zeller,C,29,POR,27,0,355,51,90,.567,0,4,0,51,86,.593,.567,38,49,.776,50,75,125,22,8,6,19,56,140,21
Ivica Zubac,C,24,LAC,76,76,1852,310,495,.626,0,0,0,310,495,.626,.626,165,227,.727,217,427,644,120,36,77,114,203,785,21
Precious Achiuwa,C,23,TOR,55,12,1140,196,404,.485,29,108,.269,167,296,.564,.521,87,124,.702,100,228,328,50,31,30,59,102,508,22
Steven Adams,C,29,MEM,42,42,1133,157,263,.597,0,1,0,157,262,.599,.597,47,129,.364,214,271,485,97,36,46,79,98,361,22
Bam Adebayo,C,25,MIA,75,75,2598,602,1114,.540,1,12,.083,601,1102,.545,.541,324,402,.806,184,504,688,240,88,61,187,208,1529,22
Ochai Agbaji,SG,22,UTA,59,22,1209,165,386,.427,81,228,.355,84,158,.532,.532,56,69,.812,43,78,121,67,16,15,41,99,467,22
Santi Aldama,PF,22,MEM,77,20,1682,247,525,.470,94,266,.353,153,259,.591,.560,108,144,.750,85,286,371,97,45,48,60,143,696,22
Nickeil Alexander-Walker,SG,24,TOT,59,3,884,131,295,.444,61,159,.384,70,136,.515,.547,40,60,.667,15,86,101,108,32,21,55,88,363,22
Nickeil Alexander-Walker,SG,24,UTA,36,3,528,83,170,.488,35,87,.402,48,83,.578,.591,27,39,.692,8,51,59,76,24,14,45,58,228,22
Nickeil Alexander-Walker,SG,24,MIN,23,0,356,48,125,.384,26,72,.361,22,53,.415,.488,13,21,.619,7,35,42,32,8,7,10,30,135,22
Grayson Allen,SG,27,MIL,72,70,1972,245,557,.440,146,366,.399,99,191,.518,.571,114,126,.905,61,176,237,163,62,14,72,117,750,22
Jarrett Allen,C,24,CLE,68,68,2220,403,626,.644,1,10,.100,402,616,.653,.645,162,221,.733,221,445,666,113,54,84,93,153,969,22
Jose Alvarado,PG,24,NOP,61,10,1310,201,489,.411,83,247,.336,118,242,.488,.496,65,80,.813,28,113,141,186,67,10,81,125,550,22
Kyle Anderson,PF,29,MIN,69,46,1957,252,495,.509,43,105,.410,209,390,.536,.553,100,136,.735,66,302,368,335,78,63,103,146,647,22
Giannis Antetokounmpo,PF,28,MIL,63,63,2024,707,1278,.553,47,171,.275,660,1107,.596,.572,498,772,.645,137,605,742,359,52,51,246,197,1959,22
Thanasis Antetokounmpo,SF,30,MIL,37,0,206,20,46,.435,0,8,0,20,38,.526,.435,11,22,.500,15,29,44,15,3,3,12,22,51,22
Cole Anthony,PG,22,ORL,60,4,1552,277,610,.454,75,206,.364,202,404,.500,.516,152,170,.894,47,241,288,235,37,31,91,158,781,22
OG Anunoby,SF,25,TOR,67,67,2386,421,885,.476,142,367,.387,279,518,.539,.556,140,167,.838,95,237,332,131,128,50,132,200,1124,22
Ryan Arcidiacono,PG,28,TOT,20,4,172,9,37,.243,8,23,.348,1,14,.071,.351,0,0,0,0,15,15,23,5,0,7,17,26,22
Ryan Arcidiacono,PG,28,NYK,11,0,26,1,5,.200,1,3,.333,0,2,0,.300,0,0,0,0,4,4,2,2,0,1,3,3,22
Ryan Arcidiacono,PG,28,POR,9,4,146,8,32,.250,7,20,.350,1,12,.083,.359,0,0,0,0,11,11,21,3,0,6,14,23,22
Deni Avdija,SF,22,WAS,76,40,2020,253,579,.437,69,232,.297,184,347,.530,.497,122,165,.739,74,413,487,211,65,29,123,209,697,22
Deandre Ayton,C,24,PHO,67,67,2035,522,887,.589,7,24,.292,515,863,.597,.592,152,200,.760,172,495,667,115,37,53,120,190,1203,22
Udoka Azubuike,C,23,UTA,36,4,359,59,72,.819,0,0,0,59,72,.819,.819,7,20,.350,31,88,119,11,6,15,18,34,125,22
Marvin Bagley III,C,23,DET,42,25,990,202,382,.529,19,66,.288,183,316,.579,.554,81,108,.750,94,175,269,36,19,30,46,81,504,22
Patrick Baldwin Jr.,SF,20,GSW,31,0,226,43,109,.394,32,84,.381,11,25,.440,.541,4,6,.667,1,39,40,11,6,4,11,14,122,22
LaMelo Ball,PG,21,CHO,36,36,1268,296,721,.411,144,383,.376,152,338,.450,.510,102,122,.836,42,189,231,304,46,11,129,118,838,22
Mo Bamba,C,24,TOT,49,7,769,117,241,.485,48,124,.387,69,117,.590,.585,41,62,.661,58,167,225,46,13,43,30,105,323,22
Mo Bamba,C,24,ORL,40,6,681,106,214,.495,43,108,.398,63,106,.594,.596,35,51,.686,47,137,184,42,12,38,22,86,290,22
Mo Bamba,C,24,LAL,9,1,88,11,27,.407,5,16,.313,6,11,.545,.500,6,11,.545,11,30,41,4,1,5,8,19,33,22
Paolo Banchero,PF,20,ORL,72,72,2430,479,1122,.427,85,285,.298,394,837,.471,.465,394,534,.738,84,413,497,269,60,39,200,160,1437,22
Desmond Bane,SG,24,MEM,58,58,1841,450,939,.479,166,407,.408,284,532,.534,.568,181,205,.883,43,248,291,254,56,22,126,150,1247,22
Dalano Banton,PG,23,TOR,31,2,279,55,130,.423,15,51,.294,40,79,.506,.481,17,24,.708,11,34,45,36,13,13,18,34,142,22
Dominick Barlow,SF,19,SAS,28,0,408,46,86,.535,0,4,0,46,82,.561,.535,18,25,.720,46,56,102,24,10,19,15,56,110,22
Harrison Barnes,PF,30,SAC,82,82,2662,374,791,.473,132,353,.374,242,438,.553,.556,350,413,.847,87,279,366,128,57,10,86,103,1230,22
Scottie Barnes,PF,21,TOR,77,76,2678,463,1016,.456,63,224,.281,400,792,.505,.487,190,246,.772,179,333,512,371,83,61,154,170,1179,22
RJ Barrett,SG,22,NYK,73,73,2475,510,1176,.434,121,390,.310,389,786,.495,.485,290,392,.740,60,308,368,201,31,15,164,179,1431,22
Will Barton,SG,32,TOT,56,2,993,138,364,.379,66,180,.367,72,184,.391,.470,37,47,.787,15,122,137,112,28,13,48,56,379,22
Will Barton,SG,32,WAS,40,0,782,110,285,.386,52,138,.377,58,147,.395,.477,35,45,.778,10,101,111,95,17,10,45,39,307,22
Will Barton,SG,32,TOR,16,2,211,28,79,.354,14,42,.333,14,37,.378,.443,2,2,1.000,5,21,26,17,11,3,3,17,72,22
Charles Bassey,C,22,SAS,35,2,508,87,135,.644,3,8,.375,84,127,.661,.656,22,37,.595,75,118,193,47,16,33,41,74,199,22
Keita Bates-Diop,SF,27,SAS,67,42,1452,236,465,.508,56,142,.394,180,323,.557,.568,119,150,.793,65,183,248,103,46,20,56,63,647,22
Nicolas Batum,PF,34,LAC,78,19,1709,160,381,.420,124,317,.391,36,64,.563,.583,34,48,.708,62,237,299,121,54,44,50,149,478,22
Darius Bazley,PF,22,TOT,43,1,616,83,183,.454,20,53,.377,63,130,.485,.508,38,70,.543,34,104,138,38,22,34,27,44,224,22
Darius Bazley,PF,22,OKC,36,1,555,71,158,.449,18,45,.400,53,113,.469,.506,36,65,.554,29,93,122,32,19,29,22,35,196,22
Darius Bazley,PF,22,PHO,7,0,61,12,25,.480,2,8,.250,10,17,.588,.520,2,5,.400,5,11,16,6,3,5,5,9,28,22
Bradley Beal,SG,29,WAS,50,50,1673,444,878,.506,80,219,.365,364,659,.552,.551,192,228,.842,41,155,196,271,45,33,145,107,1160,22
Malik Beasley,SG,26,TOT,81,27,2093,370,937,.395,235,658,.357,135,279,.484,.520,50,65,.769,35,248,283,124,65,9,90,107,1025,22
Malik Beasley,SG,26,UTA,55,13,1472,265,669,.396,169,471,.359,96,198,.485,.522,37,44,.841,27,170,197,93,44,8,60,75,736,22
Malik Beasley,SG,26,LAL,26,14,621,105,268,.392,66,187,.353,39,81,.481,.515,13,21,.619,8,78,86,31,21,1,30,32,289,22
MarJon Beauchamp,SF,22,MIL,52,11,701,96,243,.395,47,142,.331,49,101,.485,.492,27,37,.730,38,77,115,35,21,7,45,71,266,22
Dāvis Bertāns,PF,30,DAL,45,1,492,69,160,.431,55,141,.390,14,19,.737,.603,13,15,.867,10,43,53,21,11,8,10,53,206,22
Patrick Beverley,PG,34,TOT,67,67,1816,144,360,.400,80,239,.335,64,121,.529,.511,47,65,.723,44,203,247,194,63,41,60,187,415,22
Patrick Beverley,PG,34,LAL,45,45,1211,97,241,.402,55,158,.348,42,83,.506,.517,39,50,.780,24,116,140,118,40,25,42,124,288,22
Patrick Beverley,PG,34,CHI,22,22,605,47,119,.395,25,81,.309,22,38,.579,.500,8,15,.533,20,87,107,76,23,16,18,63,127,22
Saddiq Bey,SF,23,TOT,77,37,2129,353,836,.422,151,418,.361,202,418,.483,.513,205,238,.861,98,264,362,118,70,13,71,123,1062,22
Saddiq Bey,SF,23,DET,52,30,1500,245,606,.404,101,293,.345,144,313,.460,.488,180,209,.861,59,183,242,84,50,12,54,86,771,22
Saddiq Bey,SF,23,ATL,25,7,629,108,230,.470,50,125,.400,58,105,.552,.578,25,29,.862,39,81,120,34,20,1,17,37,291,22
Khem Birch,C,30,TOR,20,0,162,19,32,.594,1,2,.500,18,30,.600,.609,4,5,.800,8,17,25,7,5,5,8,24,43,22
Goga Bitadze,C,23,TOT,38,1,457,69,125,.552,6,26,.231,63,99,.636,.576,23,42,.548,61,76,137,39,16,26,22,64,167,22
Goga Bitadze,C,23,IND,21,0,202,27,52,.519,4,14,.286,23,38,.605,.558,11,24,.458,25,24,49,18,9,10,12,34,69,22
Goga Bitadze,C,23,ORL,17,1,255,42,73,.575,2,12,.167,40,61,.656,.589,12,18,.667,36,52,88,21,7,16,10,30,98,22
Bismack Biyombo,C,30,PHO,61,14,874,119,206,.578,0,0,0,119,206,.578,.578,25,70,.357,89,171,260,56,18,88,51,114,263,22
Buddy Boeheim,PG,23,DET,10,0,90,5,27,.185,4,25,.160,1,2,.500,.259,2,2,1.000,2,4,6,4,2,0,0,6,16,22
Bogdan Bogdanović,SG,30,ATL,54,9,1508,273,611,.447,146,360,.406,127,251,.506,.566,64,77,.831,23,142,165,150,43,18,65,86,756,22
Bojan Bogdanović,PF,33,DET,59,59,1893,430,882,.488,145,353,.411,285,529,.539,.570,268,303,.884,36,187,223,152,34,8,135,113,1273,22
Bol Bol,PF,23,ORL,70,33,1505,261,478,.546,30,113,.265,231,365,.633,.577,82,108,.759,69,336,405,69,30,85,112,92,634,22
Leandro Bolmaro,SG,22,UTA,14,0,68,3,20,.150,0,4,0,3,16,.188,.150,0,0,0,4,3,7,7,3,1,7,10,6,22
Devin Booker,SG,26,PHO,53,53,1835,527,1067,.494,111,316,.351,416,751,.554,.546,306,358,.855,46,194,240,293,51,18,145,159,1471,22
Brandon Boston Jr.,SG,21,LAC,22,1,248,51,122,.418,12,29,.414,39,93,.419,.467,29,38,.763,7,23,30,20,9,0,12,21,143,22
Chris Boucher,PF,30,TOR,76,0,1523,261,529,.493,62,189,.328,199,340,.585,.552,128,168,.762,157,264,421,29,47,64,41,143,712,22
James Bouknight,SG,22,CHO,34,0,515,69,193,.358,33,109,.303,36,84,.429,.443,20,30,.667,8,64,72,41,14,5,32,49,191,22
Jamaree Bouyea,PG,23,TOT,5,0,71,6,14,.429,2,6,.333,4,8,.500,.500,1,2,.500,1,5,6,4,4,2,4,6,15,22
Jamaree Bouyea,PG,23,MIA,4,0,65,6,13,.462,2,5,.400,4,8,.500,.538,1,2,.500,1,4,5,4,4,2,4,5,15,22
Jamaree Bouyea,PG,23,WAS,1,0,6,0,1,0,0,1,0,0,0,0,0,0,0,0,0,1,1,0,0,0,0,1,0,22
Tony Bradley,C,25,CHI,12,0,33,6,12,.500,3,5,.600,3,7,.429,.625,4,4,1.000,1,10,11,1,1,1,1,2,19,22
Malaki Branham,SF,19,SAS,66,32,1550,269,611,.440,77,255,.302,192,356,.539,.503,58,70,.829,28,153,181,127,33,7,76,115,673,22
Jarrell Brantley,PF,26,UTA,4,0,39,8,14,.571,4,9,.444,4,5,.800,.714,2,2,1.000,1,5,6,3,0,2,2,3,22,22
Christian Braun,SG,21,DEN,76,6,1181,143,289,.495,34,96,.354,109,193,.565,.554,40,64,.625,48,133,181,59,41,17,35,101,360,22
Mikal Bridges,SF,26,TOT,83,83,2963,593,1267,.468,169,442,.382,424,825,.514,.535,316,353,.895,79,285,364,273,91,61,127,159,1671,22
Mikal Bridges,SF,26,PHO,56,56,2040,354,764,.463,101,261,.387,253,503,.503,.529,156,174,.897,56,187,243,201,65,45,78,115,965,22
Mikal Bridges,SF,26,BRK,27,27,923,239,503,.475,68,181,.376,171,322,.531,.543,160,179,.894,23,98,121,72,26,16,49,44,706,22
Oshae Brissett,SF,24,IND,65,2,1083,123,319,.386,48,155,.310,75,164,.457,.461,104,145,.717,62,156,218,44,33,13,34,79,398,22
Malcolm Brogdon,PG,30,BOS,67,0,1744,354,732,.484,132,297,.444,222,435,.510,.574,160,184,.870,42,238,280,248,45,18,98,109,1000,22
Dillon Brooks,SF,27,MEM,73,73,2214,392,991,.396,143,439,.326,249,552,.451,.468,120,154,.779,45,199,244,189,65,16,104,240,1047,22
Bruce Brown,SG,26,DEN,80,31,2280,358,741,.483,91,254,.358,267,487,.548,.545,116,153,.758,63,265,328,268,87,51,123,190,923,22
Greg Brown III,PF,21,POR,16,0,93,11,28,.393,1,7,.143,10,21,.476,.411,5,12,.417,2,17,19,3,4,5,6,13,28,22
Jaylen Brown,SF,26,BOS,67,67,2405,679,1383,.491,163,487,.335,516,896,.576,.550,263,344,.765,78,381,459,232,75,26,197,172,1784,22
Kendall Brown,SG,19,IND,6,0,40,4,7,.571,0,1,0,4,6,.667,.571,1,2,.500,2,4,6,3,4,0,2,9,9,22
Moses Brown,C,23,TOT,36,1,294,61,96,.635,0,0,0,61,96,.635,.635,33,72,.458,57,82,139,4,4,14,15,39,155,22
Moses Brown,C,23,LAC,34,1,288,61,96,.635,0,0,0,61,96,.635,.635,33,72,.458,57,82,139,4,3,14,14,38,155,22
Moses Brown,C,23,BRK,2,0,6,0,0,0,0,0,0,0,0,0,0,0,0,0,0,0,0,0,1,0,1,1,0,22
Sterling Brown,SG,27,LAL,4,0,24,0,4,0,0,2,0,0,2,0,0,0,0,0,3,5,8,2,3,0,0,4,0,22
Troy Brown Jr.,SF,23,LAL,76,45,1860,200,465,.430,107,281,.381,93,184,.505,.545,34,39,.872,62,246,308,95,59,16,49,120,541,22
Jalen Brunson,PG,26,NYK,68,68,2379,587,1195,.491,134,322,.416,453,873,.519,.547,325,392,.829,40,201,241,421,61,15,142,152,1633,22
Thomas Bryant,C,25,TOT,59,26,1081,230,369,.623,26,59,.441,204,310,.658,.659,93,126,.738,86,253,339,31,16,30,38,102,579,22
Thomas Bryant,C,25,LAL,41,25,876,197,301,.654,22,50,.440,175,251,.697,.691,80,108,.741,67,212,279,29,14,23,28,77,496,22
Thomas Bryant,C,25,DEN,18,1,205,33,68,.485,4,9,.444,29,59,.492,.515,13,18,.722,19,41,60,2,2,7,10,25,83,22
Reggie Bullock,SF,31,DAL,78,55,2364,192,470,.409,151,397,.380,41,73,.562,.569,26,37,.703,32,251,283,108,54,13,36,166,561,22
Alec Burks,SG,31,DET,51,8,1122,200,459,.436,99,239,.414,101,220,.459,.544,153,188,.814,19,139,158,114,38,8,58,98,652,22
Deonte Burton,SG,29,SAC,2,0,6,0,2,0,0,1,0,0,1,0,0,0,0,0,0,0,0,0,0,0,0,0,0,22
Jared Butler,SG,22,OKC,6,1,77,15,32,.469,7,14,.500,8,18,.444,.578,0,0,0,1,3,4,8,5,0,5,5,37,22
Jimmy Butler,SF,33,MIA,64,64,2138,479,888,.539,36,103,.350,443,785,.564,.560,472,555,.850,141,234,375,340,117,21,101,80,1466,22
John Butler,C,20,POR,19,1,221,17,53,.321,8,35,.229,9,18,.500,.396,3,4,.750,3,14,17,11,7,9,1,22,45,22
Jamal Cain,SF,23,MIA,18,0,240,37,66,.561,7,20,.350,30,46,.652,.614,17,22,.773,15,37,52,12,11,1,6,21,98,22
Kentavious Caldwell-Pope,SG,29,DEN,76,76,2381,292,632,.462,135,319,.423,157,313,.502,.569,103,125,.824,35,173,208,183,112,35,86,145,822,22
Facundo Campazzo,PG,31,DAL,8,0,52,3,13,.231,3,11,.273,0,2,0,.346,1,2,.500,0,2,2,9,6,0,3,3,10,22
Vlatko Čančar,PF,25,DEN,60,9,889,108,227,.476,43,115,.374,65,112,.580,.570,38,41,.927,24,104,128,80,22,14,37,84,297,22
Clint Capela,C,28,ATL,65,63,1730,350,536,.653,0,1,0,350,535,.654,.653,79,131,.603,258,459,717,58,45,79,54,139,779,22
Vernon Carey Jr.,C,21,WAS,11,0,28,2,8,.250,0,0,0,2,8,.250,.250,2,2,1.000,3,8,11,3,2,2,2,5,6,22
Jevon Carter,PG,27,MIL,81,39,1810,239,565,.423,142,337,.421,97,228,.425,.549,31,38,.816,35,167,202,197,66,29,78,158,651,22
Wendell Carter Jr.,C,23,ORL,57,54,1690,322,613,.525,80,225,.356,242,388,.624,.591,144,195,.738,120,377,497,132,30,33,106,159,868,22
Michael Carter-Williams,PG,31,ORL,4,0,44,6,14,.429,1,3,.333,5,11,.455,.464,4,7,.571,1,4,5,7,1,1,4,5,17,22
Alex Caruso,PG,28,CHI,67,36,1575,130,286,.455,55,151,.364,75,135,.556,.551,59,73,.808,42,154,196,193,98,46,77,159,374,22
Julian Champagnie,SF,21,TOT,17,3,320,59,130,.454,33,82,.402,26,48,.542,.581,14,17,.824,10,50,60,10,6,5,11,26,165,22
Julian Champagnie,SF,21,PHI,2,0,7,0,2,0,0,1,0,0,1,0,0,0,0,0,0,0,0,0,1,0,0,0,0,22
Julian Champagnie,SF,21,SAS,15,3,313,59,128,.461,33,81,.407,26,47,.553,.590,14,17,.824,10,50,60,10,5,5,11,26,165,22
Justin Champagnie,SF,21,TOT,5,0,34,5,15,.333,1,5,.200,4,10,.400,.367,0,0,0,3,5,8,4,1,0,0,2,11,22
Justin Champagnie,SF,21,TOR,3,0,11,3,3,1.000,0,0,0,3,3,1.000,1.000,0,0,0,1,3,4,1,0,0,0,1,6,22
Justin Champagnie,SF,21,BOS,2,0,23,2,12,.167,1,5,.200,1,7,.143,.208,0,0,0,2,2,4,3,1,0,0,1,5,22
Kennedy Chandler,PG,20,MEM,36,0,281,35,83,.422,2,15,.133,33,68,.485,.434,6,13,.462,9,29,38,58,12,5,18,15,78,22
Max Christie,SG,19,LAL,41,3,512,44,106,.415,26,62,.419,18,44,.409,.538,14,16,.875,7,68,75,21,9,7,13,33,128,22
Josh Christopher,SG,21,HOU,64,2,786,153,329,.465,21,89,.236,132,240,.550,.497,45,60,.750,20,51,71,73,33,15,60,59,372,22
Brandon Clarke,PF,26,MEM,56,8,1090,229,349,.656,1,6,.167,228,343,.665,.658,99,137,.723,92,218,310,72,34,37,55,131,558,22
Jordan Clarkson,SG,30,UTA,61,61,1988,458,1031,.444,155,459,.338,303,572,.530,.519,200,245,.816,72,174,246,270,33,13,186,120,1271,22
Nic Claxton,C,23,BRK,76,76,2271,414,587,.705,0,2,0,414,585,.708,.705,133,246,.541,184,518,702,144,65,189,96,212,961,22
Amir Coffey,SG,25,LAC,50,9,625,56,145,.386,11,40,.275,45,105,.429,.424,49,63,.778,17,36,53,53,7,5,21,50,172,22
John Collins,PF,25,ATL,71,71,2130,359,707,.508,70,240,.292,289,467,.619,.557,143,178,.803,77,385,462,85,42,73,79,220,931,22
Zach Collins,C,25,SAS,63,26,1441,284,548,.518,55,147,.374,229,401,.571,.568,108,142,.761,116,286,402,180,37,49,129,199,731,22
Chance Comanche,C,26,POR,1,0,21,3,5,.600,0,0,0,3,5,.600,.600,1,4,.250,2,1,3,0,0,1,0,0,7,22
Mike Conley,PG,35,TOT,67,66,2029,261,610,.428,135,351,.385,126,259,.486,.539,141,169,.834,33,149,182,450,73,14,103,139,798,22
Mike Conley,PG,35,UTA,43,42,1276,153,375,.408,77,213,.362,76,162,.469,.511,78,96,.813,17,90,107,330,44,10,74,94,461,22
Mike Conley,PG,35,MIN,24,24,753,108,235,.460,58,138,.420,50,97,.515,.583,63,73,.863,16,59,75,120,29,4,29,45,337,22
Pat Connaughton,SG,30,MIL,61,33,1443,165,421,.392,109,322,.339,56,99,.566,.521,27,41,.659,50,233,283,77,37,11,33,69,466,22
Xavier Cooks,PF,27,WAS,10,1,126,17,28,.607,0,1,0,17,27,.630,.607,4,10,.400,16,22,38,6,6,4,8,13,38,22
Robert Covington,PF,32,LAC,48,0,779,102,229,.445,54,136,.397,48,93,.516,.563,30,40,.750,31,135,166,57,38,33,32,86,288,22
Torrey Craig,SF,32,PHO,79,60,1948,228,500,.456,100,253,.395,128,247,.518,.556,32,45,.711,145,281,426,117,50,62,73,179,588,22
Jae Crowder,SF,32,MIL,18,3,340,45,94,.479,24,55,.436,21,39,.538,.606,10,12,.833,17,52,69,27,12,6,7,27,124,22
Jarrett Culver,SG,23,ATL,10,1,137,17,43,.395,1,12,.083,16,31,.516,.407,9,13,.692,10,28,38,6,6,2,7,14,44,22
Cade Cunningham,PG,21,DET,12,12,400,93,224,.415,17,61,.279,76,163,.466,.453,36,43,.837,12,62,74,72,10,7,39,34,239,22
Seth Curry,SG,32,BRK,61,7,1211,208,449,.463,94,232,.405,114,217,.525,.568,51,55,.927,13,87,100,99,36,7,51,96,561,22
Stephen Curry,PG,34,GSW,56,56,1941,559,1133,.493,273,639,.427,286,494,.579,.614,257,281,.915,39,302,341,352,52,20,179,117,1648,22
Dyson Daniels,PG,19,NOP,59,11,1042,87,208,.418,27,86,.314,60,122,.492,.483,26,40,.650,36,152,188,134,43,11,57,99,227,22
Anthony Davis,C,29,LAL,56,54,1904,542,962,.563,19,74,.257,523,888,.589,.573,348,444,.784,195,507,702,148,59,114,122,146,1451,22
Johnny Davis,SG,20,WAS,28,5,423,66,171,.386,17,70,.243,49,101,.485,.436,14,27,.519,10,55,65,28,10,8,17,48,163,22
Terence Davis,SG,25,SAC,64,5,841,154,364,.423,89,243,.366,65,121,.537,.545,34,43,.791,20,119,139,67,43,12,53,104,431,22
JD Davison,PG,20,BOS,12,0,66,8,19,.421,2,7,.286,6,12,.500,.474,1,2,.500,2,7,9,11,2,2,4,5,19,22
Darius Days,PF,23,HOU,4,0,25,5,12,.417,3,10,.300,2,2,1.000,.542,2,2,1.000,1,5,6,1,0,1,0,2,15,22
Dewayne Dedmon,C,33,TOT,38,1,426,77,151,.510,12,39,.308,65,112,.580,.550,33,49,.673,34,100,134,26,9,19,25,75,199,22
Dewayne Dedmon,C,33,MIA,30,0,350,64,129,.496,11,37,.297,53,92,.576,.539,32,44,.727,28,81,109,16,7,14,19,61,171,22
Dewayne Dedmon,C,33,PHI,8,1,76,13,22,.591,1,2,.500,12,20,.600,.614,1,5,.200,6,19,25,10,2,5,6,14,28,22
Matthew Dellavedova,PG,32,SAC,32,0,213,17,50,.340,9,27,.333,8,23,.348,.430,4,7,.571,1,12,13,41,7,0,10,20,47,22
DeMar DeRozan,SF,33,CHI,74,74,2682,657,1303,.504,46,142,.324,611,1161,.526,.522,456,523,.872,34,309,343,377,83,36,153,186,1816,22
Moussa Diabaté,PF,21,LAC,22,1,195,24,47,.511,1,2,.500,23,45,.511,.521,10,16,.625,31,19,50,4,7,8,9,15,59,22
Mamadi Diakite,PF,26,CLE,22,2,176,24,50,.480,7,21,.333,17,29,.586,.550,2,2,1.000,8,22,30,8,4,9,12,26,57,22
Hamidou Diallo,SG,24,DET,56,0,996,215,375,.573,5,21,.238,210,354,.593,.580,87,148,.588,57,137,194,55,53,16,71,124,522,22
Gorgui Dieng,C,33,SAS,31,1,358,45,117,.385,21,75,.280,24,42,.571,.474,10,13,.769,27,80,107,53,4,14,32,57,121,22
Ousmane Dieng,SF,19,OKC,39,1,569,76,181,.420,26,98,.265,50,83,.602,.492,15,23,.652,19,86,105,46,14,7,26,42,193,22
Spencer Dinwiddie,PG,29,TOT,79,79,2725,460,1050,.438,181,490,.369,279,560,.498,.524,268,330,.812,28,242,270,515,67,24,145,187,1369,22
Spencer Dinwiddie,PG,29,DAL,53,53,1808,316,694,.455,138,341,.405,178,353,.504,.555,170,207,.821,19,144,163,279,39,16,90,124,940,22
Spencer Dinwiddie,PG,29,BRK,26,26,917,144,356,.404,43,149,.289,101,207,.488,.465,98,123,.797,9,98,107,236,28,8,55,63,429,22
Donte DiVincenzo,SG,26,GSW,72,36,1894,235,540,.435,150,378,.397,85,162,.525,.574,58,71,.817,80,245,325,252,97,10,112,133,678,22
Luka Dončić,PG,23,DAL,66,66,2391,719,1449,.496,185,541,.342,534,908,.588,.560,515,694,.742,54,515,569,529,90,33,236,166,2138,22
Tyler Dorsey,SG,26,DAL,3,0,8,4,5,.800,1,2,.500,3,3,1.000,.900,0,0,0,1,1,2,0,0,0,0,0,9,22
Luguentz Dort,SG,23,OKC,74,73,2272,339,873,.388,135,409,.330,204,464,.440,.466,200,259,.772,128,216,344,154,75,23,92,243,1013,22
Ayo Dosunmu,SG,23,CHI,80,51,2098,281,570,.493,59,189,.312,222,381,.583,.545,66,82,.805,45,175,220,206,62,26,99,182,687,22
Devon Dotson,PG,23,WAS,6,0,53,1,10,.100,1,4,.250,0,6,0,.150,0,0,0,6,4,10,8,5,0,3,9,3,22
Jeff Dowtin,PG,25,TOR,25,0,259,25,57,.439,5,16,.313,20,41,.488,.482,6,9,.667,6,17,23,31,9,3,5,13,61,22
PJ Dozier,SG,26,SAC,16,0,79,10,33,.303,2,16,.125,8,17,.471,.333,0,0,0,1,13,14,10,6,1,5,7,22,22
Goran Dragić,PG,36,TOT,58,0,870,141,335,.421,52,145,.359,89,190,.468,.499,31,45,.689,16,65,81,151,13,4,63,65,365,22
Goran Dragić,PG,36,CHI,51,0,787,127,299,.425,45,128,.352,82,171,.480,.500,27,41,.659,13,56,69,139,11,4,56,63,326,22
Goran Dragić,PG,36,MIL,7,0,83,14,36,.389,7,17,.412,7,19,.368,.486,4,4,1.000,3,9,12,12,2,0,7,2,39,22
Andre Drummond,C,29,CHI,67,0,849,166,274,.606,0,3,0,166,271,.613,.606,67,125,.536,138,306,444,33,45,27,75,117,399,22
Chris Duarte,SF,25,IND,46,12,897,123,333,.369,55,174,.316,68,159,.428,.452,61,72,.847,19,96,115,64,25,9,41,65,362,22
David Duke Jr.,SG,23,BRK,23,0,228,36,78,.462,1,12,.083,35,66,.530,.468,12,17,.706,11,18,29,21,10,1,18,31,85,22
Kris Dunn,PG,28,UTA,22,3,568,116,216,.537,17,36,.472,99,180,.550,.576,41,53,.774,9,91,100,124,25,10,35,58,290,22
Kevin Durant,PF-SF,34,TOT,47,47,1672,483,862,.560,93,230,.404,390,632,.617,.614,307,334,.919,17,296,313,235,34,67,156,99,1366,22
Kevin Durant,PF,34,BRK,39,39,1403,410,734,.559,71,189,.376,339,545,.622,.607,267,286,.934,14,248,262,207,32,57,136,92,1158,22
Kevin Durant,SF,34,PHO,8,8,269,73,128,.570,22,41,.537,51,87,.586,.656,40,48,.833,3,48,51,28,2,10,20,7,208,22
Jalen Duren,C,19,DET,67,31,1670,258,398,.648,0,2,0,258,396,.652,.648,96,157,.611,229,366,595,75,44,59,92,182,612,22
Tari Eason,PF,21,HOU,82,5,1767,296,660,.448,59,172,.343,237,488,.486,.493,109,145,.752,195,301,496,88,96,47,101,189,760,22
Anthony Edwards,SG,21,MIN,79,79,2842,707,1541,.459,213,578,.369,494,963,.513,.528,319,422,.756,47,411,458,350,125,58,259,186,1946,22
Kessler Edwards,SF,22,TOT,36,4,385,36,93,.387,17,55,.309,19,38,.500,.478,11,15,.733,23,38,61,23,14,6,13,40,100,22
Kessler Edwards,SF,22,BRK,14,1,79,6,24,.250,2,12,.167,4,12,.333,.292,1,2,.500,6,8,14,2,3,1,4,3,15,22
Kessler Edwards,SF,22,SAC,22,3,306,30,69,.435,15,43,.349,15,26,.577,.543,10,13,.769,17,30,47,21,11,5,9,37,85,22
Keon Ellis,SG,23,SAC,16,0,71,7,16,.438,6,12,.500,1,4,.250,.625,4,7,.571,4,4,8,6,5,1,1,10,24,22
Joel Embiid,C,28,PHI,66,66,2284,728,1328,.548,66,200,.330,662,1128,.587,.573,661,771,.857,113,557,670,274,66,112,226,205,2183,22
Drew Eubanks,C,25,POR,78,28,1584,214,334,.641,7,18,.389,207,316,.655,.651,83,125,.664,132,286,418,103,40,102,67,169,518,22
Bruno Fernando,C,24,TOT,39,4,405,59,112,.527,0,4,0,59,108,.546,.527,35,50,.700,54,83,137,31,6,34,25,74,153,22
Bruno Fernando,C,24,HOU,31,4,364,48,93,.516,0,1,0,48,92,.522,.516,30,44,.682,48,74,122,30,6,31,20,68,126,22
Bruno Fernando,C,24,ATL,8,0,41,11,19,.579,0,3,0,11,16,.688,.579,5,6,.833,6,9,15,1,0,3,5,6,27,22
Dorian Finney-Smith,PF,29,TOT,66,66,2009,196,501,.391,114,338,.337,82,163,.503,.505,45,59,.763,114,202,316,100,55,36,62,144,551,22
Dorian Finney-Smith,PF,29,DAL,40,40,1288,129,310,.416,77,217,.355,52,93,.559,.540,30,40,.750,67,121,188,59,38,20,36,80,365,22
Dorian Finney-Smith,PF,29,BRK,26,26,721,67,191,.351,37,121,.306,30,70,.429,.448,15,19,.789,47,81,128,41,17,16,26,64,186,22
Malachi Flynn,PG,24,TOR,53,2,691,87,242,.360,47,133,.353,40,109,.367,.457,25,33,.758,15,61,76,70,21,4,25,65,246,22
Simone Fontecchio,SF,27,UTA,52,6,766,115,312,.369,63,191,.330,52,121,.430,.470,35,44,.795,31,55,86,42,15,8,39,62,328,22
Bryn Forbes,SG,29,MIN,25,0,268,30,83,.361,14,46,.304,16,37,.432,.446,15,15,1.000,4,11,15,17,7,2,12,22,89,22
Trent Forrest,PG,24,ATL,23,3,277,25,60,.417,0,2,0,25,58,.431,.417,2,3,.667,5,32,37,38,7,2,15,17,52,22
Michael Foster Jr.,PF,20,PHI,1,0,1,0,0,0,0,0,0,0,0,0,0,0,0,0,0,0,0,0,0,0,0,0,0,22
Evan Fournier,SG,30,NYK,27,7,459,56,166,.337,35,114,.307,21,52,.404,.443,18,21,.857,4,45,49,36,16,3,22,46,165,22
De'Aaron Fox,PG,25,SAC,73,73,2435,682,1331,.512,119,367,.324,563,964,.584,.557,343,440,.780,40,266,306,447,83,23,181,172,1826,22
Markelle Fultz,PG,24,ORL,60,60,1778,349,679,.514,27,87,.310,322,592,.544,.534,112,143,.783,69,165,234,341,87,26,139,131,837,22
Wenyen Gabriel,PF,25,LAL,68,2,1024,155,260,.596,10,36,.278,145,224,.647,.615,52,84,.619,116,170,286,36,26,35,46,144,372,22
Daniel Gafford,C,24,WAS,78,47,1604,289,395,.732,0,0,0,289,395,.732,.732,127,187,.679,163,270,433,84,33,99,85,187,705,22
Darius Garland,PG,23,CLE,69,69,2447,522,1129,.462,169,412,.410,353,717,.492,.537,277,321,.863,28,157,185,538,85,9,199,148,1490,22
Usman Garuba,PF,20,HOU,75,1,970,86,177,.486,24,59,.407,62,118,.525,.554,29,47,.617,120,187,307,64,44,29,47,135,225,22
Luka Garza,C,24,MIN,28,0,243,63,116,.543,14,39,.359,49,77,.636,.603,41,52,.788,33,30,63,18,3,2,14,43,181,22
Rudy Gay,PF,36,UTA,56,0,816,109,287,.380,33,130,.254,76,157,.484,.437,42,49,.857,33,130,163,57,19,18,37,68,293,22
Paul George,SG,32,LAC,56,56,1939,459,1004,.457,158,426,.371,301,578,.521,.536,256,294,.871,45,297,342,288,83,20,176,159,1332,22
Taj Gibson,C,37,WAS,49,2,480,65,125,.520,8,24,.333,57,101,.564,.552,30,42,.714,32,61,93,34,15,12,26,84,168,22
Josh Giddey,SG,20,OKC,76,76,2367,539,1118,.482,76,234,.325,463,884,.524,.516,106,145,.731,148,451,599,469,57,31,211,143,1260,22
Shai Gilgeous-Alexander,PG,24,OKC,68,68,2416,704,1381,.510,58,168,.345,646,1213,.533,.531,669,739,.905,59,270,329,371,112,65,192,192,2135,22
Anthony Gill,PF,30,WAS,59,8,624,71,132,.538,4,29,.138,67,103,.650,.553,49,67,.731,37,62,99,34,7,12,15,70,195,22
Jacob Gilyard,PG,24,MEM,1,0,41,1,3,.333,1,3,.333,0,0,0,.500,0,0,0,0,4,4,7,3,0,2,3,3,22
Rudy Gobert,C,30,MIN,70,70,2148,360,546,.659,0,3,0,360,543,.663,.659,219,340,.644,231,583,814,87,56,95,122,210,939,22
Jordan Goodwin,PG,24,WAS,62,7,1106,158,353,.448,38,118,.322,120,235,.511,.501,53,69,.768,57,148,205,168,58,26,57,95,407,22
Aaron Gordon,PF,27,DEN,68,68,2055,429,761,.564,60,173,.347,369,588,.628,.603,191,314,.608,164,282,446,203,54,51,98,129,1109,22
Eric Gordon,SG,34,TOT,69,58,1965,291,653,.446,132,356,.371,159,297,.535,.547,142,173,.821,16,118,134,183,43,25,104,78,856,22
Eric Gordon,SG,34,HOU,47,47,1418,210,478,.439,85,245,.347,125,233,.536,.528,110,135,.815,12,85,97,136,30,17,83,45,615,22
Eric Gordon,SG,34,LAC,22,11,547,81,175,.463,47,111,.423,34,64,.531,.597,32,38,.842,4,33,37,47,13,8,21,33,241,22
Devonte' Graham,PG,27,TOT,73,8,1338,161,431,.374,119,338,.352,42,93,.452,.512,98,131,.748,19,103,122,196,45,16,53,79,539,22
Devonte' Graham,PG,27,NOP,53,0,811,85,231,.368,66,190,.347,19,41,.463,.511,44,59,.746,12,60,72,116,30,10,27,48,280,22
Devonte' Graham,PG,27,SAS,20,8,527,76,200,.380,53,148,.358,23,52,.442,.513,54,72,.750,7,43,50,80,15,6,26,31,259,22
Jerami Grant,PF,28,POR,63,63,2246,434,913,.475,144,359,.401,290,554,.523,.554,278,342,.813,53,230,283,150,51,53,116,152,1290,22
RaiQuan Gray,PF,23,BRK,1,0,35,6,12,.500,2,5,.400,4,7,.571,.583,2,2,1.000,3,6,9,7,0,1,4,5,16,22
A.J. Green,SG,23,MIL,35,1,345,53,125,.424,44,105,.419,9,20,.450,.600,4,4,1.000,6,39,45,22,6,0,9,31,154,22
Danny Green,SG,35,TOT,11,0,138,22,49,.449,16,37,.432,6,12,.500,.612,1,1,1.000,3,11,14,6,6,3,10,16,61,22
Danny Green,SG,35,MEM,3,0,43,3,11,.273,3,8,.375,0,3,0,.409,0,0,0,1,3,4,2,1,0,3,6,9,22
Danny Green,SG,35,CLE,8,0,95,19,38,.500,13,29,.448,6,9,.667,.671,1,1,1.000,2,8,10,4,5,3,7,10,52,22
Draymond Green,PF,32,GSW,73,73,2297,250,474,.527,40,131,.305,210,343,.612,.570,77,108,.713,66,459,525,500,74,60,204,229,617,22
Jalen Green,SG,20,HOU,76,76,2602,566,1359,.416,187,554,.338,379,805,.471,.485,364,463,.786,43,241,284,281,59,18,200,131,1683,22
JaMychal Green,PF,32,GSW,57,1,797,136,252,.540,42,111,.378,94,141,.667,.623,52,67,.776,72,133,205,51,25,23,52,105,366,22
Javonte Green,SG,29,CHI,32,1,480,61,108,.565,13,35,.371,48,73,.658,.625,30,45,.667,27,61,88,23,24,21,20,52,165,22
Jeff Green,PF,36,DEN,56,4,1091,160,328,.488,30,104,.288,130,224,.580,.534,87,117,.744,38,106,144,69,18,17,46,99,437,22
Josh Green,SG,22,DAL,60,21,1539,205,382,.537,68,169,.402,137,213,.643,.626,68,94,.723,55,127,182,103,42,5,72,156,546,22
AJ Griffin,SF,19,ATL,72,12,1401,248,533,.465,101,259,.390,147,274,.536,.560,42,47,.894,37,116,153,73,42,12,42,87,639,22
Blake Griffin,C,33,BOS,41,16,569,63,130,.485,23,66,.348,40,64,.625,.573,21,32,.656,47,108,155,61,14,9,22,75,170,22
Quentin Grimes,SG,22,NYK,71,66,2121,282,602,.468,157,407,.386,125,195,.641,.599,78,98,.796,49,180,229,150,47,26,69,177,799,22
Rui Hachimura,PF,24,TOT,63,9,1466,284,584,.486,51,160,.319,233,424,.550,.530,88,119,.739,53,230,283,58,19,26,53,72,707,22
Rui Hachimura,PF,24,WAS,30,0,728,158,324,.488,30,89,.337,128,235,.545,.534,44,58,.759,19,109,128,35,11,12,36,39,390,22
Rui Hachimura,PF,24,LAL,33,9,738,126,260,.485,21,71,.296,105,189,.556,.525,44,61,.721,34,121,155,23,8,14,17,33,317,22
Tyrese Haliburton,PG,22,IND,56,56,1883,412,841,.490,161,402,.400,251,439,.572,.586,175,201,.871,33,172,205,585,91,25,141,69,1160,22
Jordan Hall,SF,21,SAS,9,0,83,9,28,.321,3,15,.200,6,13,.462,.375,7,9,.778,3,9,12,11,1,0,7,6,28,22
R.J. Hampton,PG,21,TOT,47,3,750,102,237,.430,41,116,.353,61,121,.504,.517,57,76,.750,18,69,87,54,27,9,42,51,302,22
R.J. Hampton,PG,21,ORL,26,0,361,50,114,.439,18,53,.340,32,61,.525,.518,31,37,.838,9,30,39,34,16,4,21,22,149,22
R.J. Hampton,PG,21,DET,21,3,389,52,123,.423,23,63,.365,29,60,.483,.516,26,39,.667,9,39,48,20,11,5,21,29,153,22
Tim Hardaway Jr.,SG,30,DAL,71,45,2152,340,847,.401,212,550,.385,128,297,.431,.527,127,165,.770,21,230,251,129,49,12,60,120,1019,22
James Harden,PG,33,PHI,58,58,2135,371,842,.441,161,418,.385,210,424,.495,.536,313,361,.867,40,314,354,618,71,31,195,112,1216,22
Jaden Hardy,SG,20,DAL,48,5,708,146,333,.438,63,156,.404,83,177,.469,.533,65,79,.823,11,78,89,65,17,7,46,64,420,22
Ron Harper Jr.,SF,22,TOR,9,0,48,8,16,.500,3,9,.333,5,7,.714,.594,1,1,1.000,3,4,7,4,0,1,0,3,20,22
Montrezl Harrell,C,29,PHI,57,7,681,125,209,.598,0,6,0,125,203,.616,.598,70,101,.693,67,92,159,33,17,25,35,75,320,22
Gary Harris,SG,28,ORL,48,42,1184,138,307,.450,94,218,.431,44,89,.494,.603,27,30,.900,21,77,98,59,45,12,28,93,397,22
Joe Harris,SG,31,BRK,74,33,1527,201,440,.457,142,333,.426,59,107,.551,.618,18,28,.643,23,141,164,101,34,13,41,140,562,22
Kevon Harris,SG,25,ORL,34,0,457,47,107,.439,16,43,.372,31,64,.484,.514,31,41,.756,28,42,70,16,17,5,21,53,141,22
Tobias Harris,PF,30,PHI,74,74,2436,423,845,.501,126,324,.389,297,521,.570,.575,113,129,.876,67,357,424,186,68,40,89,149,1085,22
Shaquille Harrison,SG,29,POR,5,0,120,15,36,.417,3,10,.300,12,26,.462,.458,11,15,.733,1,21,22,30,11,2,6,12,44,22
Josh Hart,SF-SG,27,TOT,76,52,2454,275,520,.529,61,164,.372,214,356,.601,.588,132,176,.750,142,451,593,290,88,21,117,195,743,22
Josh Hart,SF,27,POR,51,51,1704,183,363,.504,34,112,.304,149,251,.594,.551,87,119,.731,95,322,417,200,54,9,79,133,487,22
Josh Hart,SG,27,NYK,25,1,750,92,157,.586,27,52,.519,65,105,.619,.672,45,57,.789,47,129,176,90,34,12,38,62,256,22
Isaiah Hartenstein,C,24,NYK,82,8,1626,175,327,.535,8,37,.216,167,290,.576,.547,48,71,.676,209,327,536,102,53,64,66,213,406,22
Udonis Haslem,C,42,MIA,7,1,71,10,29,.345,3,9,.333,7,20,.350,.397,4,5,.800,4,7,11,0,1,2,1,11,27,22
Sam Hauser,PF,25,BOS,80,8,1290,180,396,.455,140,335,.418,40,61,.656,.631,12,17,.706,35,169,204,71,29,21,30,99,512,22
Jaxson Hayes,C,22,NOP,47,2,610,86,156,.551,3,29,.103,83,127,.654,.561,58,83,.699,39,93,132,34,20,19,31,67,233,22
Killian Hayes,PG,21,DET,76,56,2154,307,815,.377,80,286,.280,227,529,.429,.426,92,112,.821,28,193,221,470,104,28,173,219,786,22
Gordon Hayward,SF,32,CHO,50,50,1577,276,581,.475,52,160,.325,224,421,.532,.520,129,159,.811,33,182,215,206,42,12,99,70,733,22
Juancho Hernangómez,PF,27,TOR,42,10,614,48,114,.421,17,67,.254,31,47,.660,.496,9,16,.563,27,96,123,25,16,6,15,43,122,22
Willy Hernangómez,C,28,NOP,38,2,458,89,169,.527,3,11,.273,86,158,.544,.536,81,104,.779,58,122,180,33,17,13,39,64,262,22
Tyler Herro,SG,23,MIA,67,67,2337,487,1109,.439,203,537,.378,284,572,.497,.531,170,182,.934,27,333,360,280,51,16,158,101,1347,22
Buddy Hield,SF,30,IND,80,73,2482,475,1038,.458,288,677,.425,187,361,.518,.596,106,129,.822,67,333,400,225,92,26,139,156,1344,22
Haywood Highsmith,SF,26,MIA,54,11,969,93,216,.431,37,109,.339,56,107,.523,.516,13,28,.464,57,131,188,43,36,17,45,82,236,22
George Hill,PG,36,TOT,46,1,834,78,166,.470,34,95,.358,44,71,.620,.572,42,55,.764,15,70,85,110,26,6,34,55,232,22
George Hill,PG,36,MIL,35,0,668,59,132,.447,23,74,.311,36,58,.621,.534,34,46,.739,13,54,67,89,19,3,27,41,175,22
George Hill,PG,36,IND,11,1,166,19,34,.559,11,21,.524,8,13,.615,.721,8,9,.889,2,16,18,21,7,3,7,14,57,22
Malcolm Hill,SF,27,CHI,5,0,9,2,4,.500,1,3,.333,1,1,1.000,.625,0,0,0,0,3,3,0,0,0,0,1,5,22
Aaron Holiday,PG,26,ATL,63,6,845,92,220,.418,36,88,.409,56,132,.424,.500,27,32,.844,25,49,74,89,37,12,36,79,247,22
Jrue Holiday,PG,32,MIL,67,65,2183,490,1023,.479,158,411,.384,332,612,.542,.556,152,177,.859,79,262,341,495,79,25,197,116,1290,22
Justin Holiday,SG,33,TOT,46,2,706,77,204,.377,46,143,.322,31,61,.508,.490,5,8,.625,5,50,55,41,19,19,22,68,205,22
Justin Holiday,SG,33,ATL,28,0,411,48,125,.384,30,87,.345,18,38,.474,.504,0,0,0,2,21,23,25,5,10,12,37,126,22
Justin Holiday,SG,33,DAL,18,2,295,29,79,.367,16,56,.286,13,23,.565,.468,5,8,.625,3,29,32,16,14,9,10,31,79,22
Richaun Holmes,C,29,SAC,42,1,348,55,89,.618,5,8,.625,50,81,.617,.646,15,19,.789,29,51,80,9,3,11,14,50,130,22
Al Horford,C,36,BOS,63,63,1922,228,479,.476,145,325,.446,83,154,.539,.627,15,21,.714,73,317,390,189,30,61,37,121,616,22
Talen Horton-Tucker,SG,22,UTA,65,20,1313,257,613,.419,58,203,.286,199,410,.485,.467,126,168,.750,41,169,210,246,41,29,126,108,698,22
Danuel House Jr.,SF,29,PHI,56,5,807,93,197,.472,37,110,.336,56,87,.644,.566,45,60,.750,9,85,94,44,14,9,26,69,268,22
Caleb Houstan,SF,20,ORL,51,4,812,66,182,.363,46,136,.338,20,46,.435,.489,15,18,.833,34,65,99,30,12,7,18,63,193,22
Trevor Hudgins,PG,23,HOU,5,0,28,2,9,.222,2,8,.250,0,1,0,.333,3,3,1.000,0,0,0,3,0,0,1,1,9,22
Kevin Huerter,SG,24,SAC,75,75,2203,420,866,.485,205,510,.402,215,356,.604,.603,95,131,.725,42,209,251,221,80,24,97,181,1140,22
Jay Huff,C,24,WAS,7,0,95,15,25,.600,6,12,.500,9,13,.692,.720,15,16,.938,6,15,21,10,3,4,5,15,51,22
De'Andre Hunter,SF,25,ATL,67,67,2126,379,822,.461,100,286,.350,279,536,.521,.522,171,207,.826,46,238,284,94,35,17,82,199,1029,22
Bones Hyland,PG,22,TOT,56,1,1085,228,571,.399,117,315,.371,111,256,.434,.502,86,102,.843,20,115,135,172,39,15,82,96,659,22
Bones Hyland,PG,22,DEN,42,1,820,173,434,.399,91,241,.378,82,193,.425,.503,71,82,.866,10,76,86,125,28,13,67,66,508,22
Bones Hyland,PG,22,LAC,14,0,265,55,137,.401,26,74,.351,29,63,.460,.496,15,20,.750,10,39,49,47,11,2,15,30,151,22
Serge Ibaka,C,33,MIL,16,0,185,26,54,.481,6,18,.333,20,36,.556,.537,8,13,.615,15,29,44,4,2,7,11,23,66,22
Andre Iguodala,SF,39,GSW,8,0,113,7,15,.467,1,9,.111,6,6,1.000,.500,2,3,.667,3,14,17,19,4,3,9,11,17,22
Joe Ingles,SF,35,MIL,46,0,1044,108,248,.435,83,203,.409,25,45,.556,.603,18,21,.857,13,115,128,150,33,6,55,74,317,22
Brandon Ingram,SF,25,NOP,45,45,1538,404,835,.484,64,164,.390,340,671,.507,.522,240,272,.882,23,223,246,262,32,19,148,116,1112,22
Kyrie Irving,PG,30,TOT,60,60,2241,594,1203,.494,188,496,.379,406,707,.574,.572,247,273,.905,59,245,304,331,66,45,128,165,1623,22
Kyrie Irving,PG,30,BRK,40,40,1478,398,819,.486,130,348,.374,268,471,.569,.565,158,179,.883,38,166,204,211,41,33,91,109,1084,22
Kyrie Irving,PG,30,DAL,20,20,763,196,384,.510,58,148,.392,138,236,.585,.586,89,94,.947,21,79,100,120,25,12,37,56,539,22
Jonathan Isaac,PF,25,ORL,11,0,124,22,53,.415,6,15,.400,16,38,.421,.472,5,9,.556,15,29,44,6,14,4,4,5,55,22
Jaden Ivey,SG,20,DET,74,73,2304,409,983,.416,120,350,.343,289,633,.457,.477,266,356,.747,73,215,288,387,61,17,237,242,1204,22
Frank Jackson,PG,24,UTA,1,0,5,0,3,0,0,1,0,0,2,0,0,0,0,0,1,1,2,1,0,0,0,0,0,22
Isaiah Jackson,C,21,IND,63,12,1042,179,318,.563,2,14,.143,177,304,.582,.566,95,146,.651,113,169,282,51,31,93,51,154,455,22
Jaren Jackson Jr.,C,23,MEM,63,63,1787,416,822,.506,100,282,.355,316,540,.585,.567,241,306,.788,108,318,426,60,65,189,107,227,1173,22
Justin Jackson,SF,27,BOS,23,0,107,7,27,.259,5,20,.250,2,7,.286,.352,1,2,.500,2,15,17,9,4,4,2,7,20,22
Quenton Jackson,PG,24,WAS,9,0,135,19,42,.452,1,12,.083,18,30,.600,.464,17,22,.773,2,6,8,15,4,1,4,10,56,22
Reggie Jackson,PG,32,TOT,68,40,1657,263,640,.411,96,288,.333,167,352,.474,.486,71,78,.910,25,119,144,233,47,6,115,114,693,22
Reggie Jackson,PG,32,LAC,52,38,1338,214,512,.418,77,220,.350,137,292,.469,.493,61,66,.924,22,94,116,183,38,5,96,92,566,22
Reggie Jackson,PG,32,DEN,16,2,319,49,128,.383,19,68,.279,30,60,.500,.457,10,12,.833,3,25,28,50,9,1,19,22,127,22
LeBron James,PF,38,LAL,55,54,1954,609,1219,.500,121,377,.321,488,842,.580,.549,251,327,.768,65,392,457,375,50,32,178,88,1590,22
Ty Jerome,SG,25,GSW,45,2,816,118,242,.488,35,90,.389,83,152,.546,.560,38,41,.927,7,71,78,135,23,5,30,64,309,22
Isaiah Joe,SG,23,OKC,73,10,1395,224,508,.441,161,394,.409,63,114,.553,.599,82,100,.820,27,148,175,88,48,8,39,105,691,22
Alize Johnson,PF,26,SAS,4,0,30,3,6,.500,0,2,0,3,4,.750,.500,1,2,.500,2,8,10,1,1,0,4,3,7,22
Cameron Johnson,PF,26,TOT,42,41,1199,223,474,.470,103,255,.404,120,219,.548,.579,101,120,.842,34,151,185,78,50,14,37,83,650,22
Cameron Johnson,PF,26,PHO,17,16,429,82,173,.474,45,99,.455,37,74,.500,.604,27,33,.818,14,51,65,26,15,6,10,29,236,22
Cameron Johnson,PF,26,BRK,25,25,770,141,301,.468,58,156,.372,83,145,.572,.565,74,87,.851,20,100,120,52,35,8,27,54,414,22
Jalen Johnson,SF,21,ATL,70,6,1042,158,322,.491,30,104,.288,128,218,.587,.537,49,78,.628,51,231,282,83,38,34,41,113,395,22
James Johnson,PF,35,IND,18,1,162,22,49,.449,3,15,.200,19,34,.559,.480,4,8,.500,4,26,30,15,7,6,8,32,51,22
Keldon Johnson,SF,23,SAS,63,63,2063,503,1113,.452,134,407,.329,369,706,.523,.512,245,327,.749,56,262,318,183,46,11,134,125,1385,22
Keon Johnson,SG,20,POR,40,0,416,67,178,.376,28,81,.346,39,97,.402,.455,27,41,.659,11,33,44,59,19,6,43,43,189,22
Stanley Johnson,SF,26,SAS,30,0,469,65,122,.533,18,40,.450,47,82,.573,.607,26,39,.667,22,73,95,67,16,6,33,48,174,22
Nikola Jokić,C,27,DEN,69,69,2323,646,1022,.632,57,149,.383,589,873,.675,.660,341,415,.822,167,650,817,678,87,47,247,174,1690,22
Carlik Jones,PG,25,CHI,7,0,56,6,15,.400,3,6,.500,3,9,.333,.500,5,8,.625,1,4,5,6,2,0,2,2,20,22
Damian Jones,C,27,TOT,41,1,477,55,86,.640,10,17,.588,45,69,.652,.698,22,29,.759,42,80,122,15,8,21,23,55,142,22
Damian Jones,C,27,LAL,22,1,176,20,37,.541,0,3,0,20,34,.588,.541,15,20,.750,18,37,55,4,3,12,9,17,55,22
Damian Jones,C,27,UTA,19,0,301,35,49,.714,10,14,.714,25,35,.714,.816,7,9,.778,24,43,67,11,5,9,14,38,87,22
Derrick Jones Jr.,SF,25,CHI,64,0,893,115,230,.500,27,80,.338,88,150,.587,.559,62,84,.738,60,93,153,34,29,37,25,86,319,22
Herbert Jones,SF,24,NOP,66,66,1951,235,501,.469,56,167,.335,179,334,.536,.525,123,161,.764,97,172,269,162,103,42,88,208,649,22
Kai Jones,C,22,CHO,46,0,550,67,120,.558,4,19,.211,63,101,.624,.575,19,26,.731,37,86,123,15,17,30,31,65,157,22
Tre Jones,PG,23,SAS,68,65,1984,341,743,.459,45,158,.285,296,585,.506,.489,148,172,.860,56,189,245,448,89,9,110,98,875,22
Tyus Jones,PG,26,MEM,80,22,1940,311,710,.438,121,326,.371,190,384,.495,.523,80,100,.800,28,172,200,417,83,6,74,32,823,22
DeAndre Jordan,C,34,DEN,39,8,586,88,115,.765,1,1,1.000,87,114,.763,.770,22,48,.458,52,150,202,34,12,23,48,71,199,22
Cory Joseph,PG,31,DET,62,2,1227,150,351,.427,70,180,.389,80,171,.468,.527,57,72,.792,21,85,106,217,34,9,56,88,427,22
Nikola Jović,PF,19,MIA,15,8,204,28,69,.406,8,35,.229,20,34,.588,.464,18,19,.947,9,22,31,10,7,2,10,19,82,22
Johnny Juzang,SF,21,UTA,18,0,232,35,104,.337,15,63,.238,20,41,.488,.409,2,4,.500,8,31,39,8,4,3,3,13,87,22
Mfiondu Kabengele,PF,25,BOS,4,0,36,2,7,.286,0,3,0,2,4,.500,.286,2,2,1.000,5,5,10,0,2,0,1,3,6,22
Frank Kaminsky,C,29,TOT,36,0,235,31,63,.492,13,33,.394,18,30,.600,.595,14,16,.875,7,45,52,32,6,4,9,22,89,22
Frank Kaminsky,C,29,ATL,26,0,176,25,44,.568,11,23,.478,14,21,.667,.693,10,12,.833,3,33,36,21,5,1,9,21,71,22
Frank Kaminsky,C,29,HOU,10,0,59,6,19,.316,2,10,.200,4,9,.444,.368,4,4,1.000,4,12,16,11,1,3,0,1,18,22
Trevor Keels,SG,19,NYK,3,0,8,1,4,.250,1,4,.250,0,0,0,.375,0,0,0,0,2,2,0,0,0,0,0,3,22
Luke Kennard,SG,26,TOT,59,14,1315,188,382,.492,133,269,.494,55,113,.487,.666,37,39,.949,15,143,158,91,32,5,46,82,546,22
Luke Kennard,SG,26,LAC,35,11,725,98,211,.464,59,132,.447,39,79,.494,.604,19,20,.950,6,77,83,37,19,4,30,47,274,22
Luke Kennard,SG,26,MEM,24,3,590,90,171,.526,74,137,.540,16,34,.471,.743,18,19,.947,9,66,75,54,13,1,16,35,272,22
Walker Kessler,C,21,UTA,74,40,1703,298,414,.720,1,3,.333,297,411,.723,.721,82,159,.516,231,389,620,69,26,173,58,169,679,22
Braxton Key,SF,25,DET,3,0,9,1,1,1.000,0,0,0,1,1,1.000,1.000,2,2,1.000,0,1,1,0,0,0,0,0,4,22
Louis King,SF,23,PHI,1,0,29,8,13,.615,4,8,.500,4,5,.800,.769,0,1,0,2,2,4,2,1,0,2,4,20,22
Corey Kispert,SF,23,WAS,74,45,2093,291,585,.497,163,384,.424,128,201,.637,.637,75,88,.852,33,174,207,87,32,9,55,97,820,22
Maxi Kleber,C,31,DAL,37,5,930,77,169,.456,39,112,.348,38,57,.667,.571,27,38,.711,30,105,135,52,12,30,27,85,220,22
Nathan Knight,PF,25,MIN,38,0,291,46,81,.568,8,22,.364,38,59,.644,.617,39,57,.684,22,34,56,13,10,6,21,41,139,22
Kevin Knox,PF-SF,23,TOT,63,5,952,152,332,.458,65,186,.349,87,146,.596,.556,46,60,.767,34,143,177,33,24,12,50,95,415,22
Kevin Knox,PF,23,DET,42,1,593,84,179,.469,43,116,.371,41,63,.651,.589,26,33,.788,20,88,108,15,14,12,32,74,237,22
Kevin Knox,SF,23,POR,21,4,359,68,153,.444,22,70,.314,46,83,.554,.516,20,27,.741,14,55,69,18,10,0,18,21,178,22
Christian Koloko,C,22,TOR,58,19,802,72,150,.480,1,12,.083,71,138,.514,.483,37,59,.627,84,87,171,31,21,57,20,128,182,22
John Konchar,SG,26,MEM,72,23,1494,138,320,.431,60,177,.339,78,143,.545,.525,28,36,.778,64,246,310,100,77,25,37,112,364,22
Furkan Korkmaz,SG,25,PHI,37,0,353,48,111,.432,18,46,.391,30,65,.462,.514,26,36,.722,6,36,42,22,10,3,24,18,140,22
Luke Kornet,C,27,BOS,69,0,804,113,170,.665,3,13,.231,110,157,.701,.674,32,39,.821,86,111,197,53,11,46,25,81,261,22
Vit Krejci,PG,22,ATL,29,0,165,15,37,.405,5,21,.238,10,16,.625,.473,1,2,.500,6,20,26,17,5,1,5,17,36,22
Jonathan Kuminga,PF,20,GSW,67,16,1394,261,497,.525,54,146,.370,207,351,.590,.579,90,138,.652,70,161,231,125,41,31,95,157,666,22
Kyle Kuzma,PF,27,WAS,64,64,2239,512,1142,.448,160,481,.333,352,661,.533,.518,173,237,.730,55,408,463,239,36,29,190,145,1357,22
Anthony Lamb,SF,25,GSW,62,4,1195,148,314,.471,73,199,.367,75,115,.652,.588,46,60,.767,56,159,215,96,28,20,54,134,415,22
Jock Landale,C,27,PHO,69,4,979,178,337,.528,21,84,.250,157,253,.621,.559,79,105,.752,119,161,280,68,16,30,59,126,456,22
Romeo Langford,SG,23,SAS,43,21,844,121,259,.467,16,61,.262,105,198,.530,.498,39,56,.696,57,57,114,50,24,13,30,67,297,22
Jake LaRavia,PF,21,MEM,35,0,414,37,95,.389,24,71,.338,13,24,.542,.516,7,9,.778,19,44,63,21,12,4,18,49,105,22
Zach LaVine,SG,27,CHI,77,77,2768,673,1388,.485,204,544,.375,469,844,.556,.558,363,428,.848,42,303,345,327,69,18,194,159,1913,22
A.J. Lawson,SG,22,TOT,15,0,108,22,44,.500,10,25,.400,12,19,.632,.614,2,8,.250,6,15,21,2,2,0,3,11,56,22
A.J. Lawson,SG,22,MIN,1,0,2,1,1,1.000,0,0,0,1,1,1.000,1.000,0,0,0,0,1,1,0,0,0,0,1,2,22
A.J. Lawson,SG,22,DAL,14,0,106,21,43,.488,10,25,.400,11,18,.611,.605,2,8,.250,6,14,20,2,2,0,3,10,54,22
Damion Lee,SG,30,PHO,74,5,1506,200,452,.442,110,247,.445,90,205,.439,.564,94,104,.904,39,186,225,99,30,7,78,118,604,22
Saben Lee,PG,23,TOT,25,1,373,49,121,.405,11,30,.367,38,91,.418,.450,42,57,.737,13,32,45,67,19,1,24,32,151,22
Saben Lee,PG,23,PHI,2,0,10,3,4,.750,0,1,0,3,3,1.000,.750,0,0,0,0,0,0,2,1,0,3,1,6,22
Saben Lee,PG,23,PHO,23,1,363,46,117,.393,11,29,.379,35,88,.398,.440,42,57,.737,13,32,45,65,18,1,21,31,145,22
Alex Len,C,29,SAC,26,2,161,16,30,.533,0,2,0,16,28,.571,.533,11,16,.688,24,36,60,12,4,11,16,28,43,22
Kawhi Leonard,SF,31,LAC,52,50,1748,446,871,.512,104,250,.416,342,621,.551,.572,243,279,.871,57,281,338,204,72,28,88,84,1239,22
Meyers Leonard,C,30,MIL,9,2,114,14,29,.483,7,18,.389,7,11,.636,.603,8,9,.889,12,22,34,1,2,0,6,16,43,22
Caris LeVert,SG,28,CLE,74,30,2237,320,742,.431,127,324,.392,193,418,.462,.517,130,180,.722,53,229,282,287,72,24,116,170,897,22
Kira Lewis Jr.,PG,21,NOP,25,0,235,40,88,.455,15,34,.441,25,54,.463,.540,19,22,.864,5,28,33,23,10,2,10,24,114,22
Damian Lillard,PG,32,POR,58,58,2107,556,1202,.463,244,658,.371,312,544,.574,.564,510,558,.914,44,233,277,425,50,18,191,109,1866,22
Nassir Little,SF,22,POR,54,4,976,134,303,.442,58,158,.367,76,145,.524,.538,33,46,.717,27,114,141,50,20,20,36,66,359,22
Isaiah Livers,PF,24,DET,52,22,1199,120,288,.417,74,203,.365,46,85,.541,.545,32,39,.821,28,115,143,41,28,28,30,103,346,22
Kenneth Lofton Jr.,PF,20,MEM,24,1,176,49,93,.527,6,17,.353,43,76,.566,.559,16,27,.593,19,32,51,20,5,2,12,28,120,22
Kevon Looney,C,26,GSW,82,70,1958,242,384,.630,0,1,0,242,383,.632,.630,94,155,.606,274,486,760,207,52,50,45,225,578,22
Brook Lopez,C,34,MIL,78,78,2373,477,899,.531,136,364,.374,341,535,.637,.606,149,190,.784,157,363,520,99,37,193,107,203,1239,22
Robin Lopez,C,34,CLE,37,2,299,48,75,.640,2,4,.500,46,71,.648,.653,14,18,.778,23,28,51,19,2,8,25,43,112,22
Kevin Love,PF,34,TOT,62,20,1240,165,424,.389,99,296,.334,66,128,.516,.506,80,91,.879,59,340,399,116,16,12,70,97,509,22
Kevin Love,PF,34,CLE,41,3,821,111,285,.389,69,195,.354,42,90,.467,.511,56,63,.889,42,238,280,76,7,7,47,65,347,22
Kevin Love,PF,34,MIA,21,17,419,54,139,.388,30,101,.297,24,38,.632,.496,24,28,.857,17,102,119,40,9,5,23,32,162,22
Kyle Lowry,PG,36,MIA,55,44,1718,196,485,.404,107,310,.345,89,175,.509,.514,116,135,.859,43,182,225,281,57,21,103,143,615,22
Trey Lyles,PF,27,SAC,74,0,1247,187,408,.458,87,240,.363,100,168,.595,.565,101,124,.815,68,232,300,66,27,31,64,97,562,22
Théo Maledon,PG,21,CHO,44,7,854,102,254,.402,28,95,.295,74,159,.465,.457,63,74,.851,14,109,123,152,37,12,59,61,295,22
Sandro Mamukelashvili,C,23,TOT,43,7,660,97,230,.422,30,99,.303,67,131,.511,.487,39,57,.684,70,115,185,62,14,12,35,52,263,22
Sandro Mamukelashvili,C,23,MIL,24,0,217,19,58,.328,7,32,.219,12,26,.462,.388,12,18,.667,18,38,56,16,4,5,9,19,57,22
Sandro Mamukelashvili,C,23,SAS,19,7,443,78,172,.453,23,67,.343,55,105,.524,.520,27,39,.692,52,77,129,46,10,7,26,33,206,22
Terance Mann,SG,26,LAC,81,36,1872,272,524,.519,77,198,.389,195,326,.598,.593,92,118,.780,77,199,276,184,42,22,80,149,713,22
Tre Mann,PG,21,OKC,67,5,1183,197,501,.393,81,257,.315,116,244,.475,.474,42,55,.764,27,128,155,120,40,11,62,99,517,22
Boban Marjanović,C,34,HOU,31,0,171,41,60,.683,0,1,0,41,59,.695,.683,20,27,.741,20,40,60,9,5,2,14,10,102,22
Lauri Markkanen,SF,25,UTA,66,66,2273,571,1145,.499,200,511,.391,371,634,.585,.586,349,399,.875,130,440,570,123,42,38,127,137,1691,22
Naji Marshall,SF,25,NOP,77,21,1792,247,571,.433,66,218,.303,181,353,.513,.490,138,175,.789,48,231,279,189,54,14,97,113,698,22
Caleb Martin,PF,27,MIA,71,49,2077,254,548,.464,84,236,.356,170,312,.545,.540,91,113,.805,88,256,344,117,71,31,78,145,683,22
Cody Martin,SF,27,CHO,7,0,134,14,36,.389,3,14,.214,11,22,.500,.431,4,7,.571,8,16,24,11,4,1,2,13,35,22
Kenyon Martin Jr.,SF,22,HOU,82,49,2292,410,720,.569,68,216,.315,342,504,.679,.617,151,222,.680,126,326,452,123,41,30,91,147,1039,22
Tyrese Martin,SG,23,ATL,16,0,66,9,23,.391,1,7,.143,8,16,.500,.413,2,2,1.000,5,7,12,2,1,0,2,2,21,22
Garrison Mathews,SG,26,TOT,54,0,686,73,201,.363,63,180,.350,10,21,.476,.520,48,53,.906,11,62,73,26,24,5,19,62,257,22
Garrison Mathews,SG,26,HOU,45,0,602,60,170,.353,53,155,.342,7,15,.467,.509,41,45,.911,10,52,62,23,23,4,18,56,214,22
Garrison Mathews,SG,26,ATL,9,0,84,13,31,.419,10,25,.400,3,6,.500,.581,7,8,.875,1,10,11,3,1,1,1,6,43,22
Bennedict Mathurin,SF,20,IND,78,17,2222,413,951,.434,100,310,.323,313,641,.488,.487,376,454,.828,87,231,318,116,48,13,152,162,1302,22
Wesley Matthews,SG,36,MIL,52,0,820,58,160,.363,39,124,.315,19,36,.528,.484,24,28,.857,34,79,113,34,20,13,18,71,179,22
Tyrese Maxey,SG,22,PHI,60,41,2016,439,913,.481,160,369,.434,279,544,.513,.568,180,213,.845,23,153,176,212,49,8,80,132,1218,22
Skylar Mays,SG,25,POR,6,6,189,34,68,.500,12,26,.462,22,42,.524,.588,12,13,.923,2,17,19,50,6,1,10,11,92,22
Miles McBride,PG,22,NYK,64,2,760,77,215,.358,40,134,.299,37,81,.457,.451,28,42,.667,13,37,50,72,37,8,25,60,222,22
Mac McClung,SG,24,PHI,2,0,41,9,20,.450,4,11,.364,5,9,.556,.550,3,5,.600,3,7,10,9,0,0,3,3,25,22
CJ McCollum,SG,31,NOP,75,75,2649,587,1344,.437,211,543,.389,376,801,.469,.515,183,238,.769,55,273,328,429,70,38,183,153,1568,22
T.J. McConnell,PG,30,IND,75,6,1526,283,521,.543,26,59,.441,257,462,.556,.568,58,68,.853,45,189,234,397,81,10,143,105,650,22
Jaden McDaniels,SF,22,MIN,79,79,2416,370,716,.517,107,269,.398,263,447,.588,.591,106,144,.736,92,215,307,148,74,76,112,272,953,22
Jalen McDaniels,SF,25,TOT,80,24,1913,281,617,.455,77,232,.332,204,385,.530,.518,116,138,.841,63,283,346,130,83,34,93,209,755,22
Jalen McDaniels,SF,25,CHO,56,21,1494,221,494,.447,65,202,.322,156,292,.534,.513,88,104,.846,44,226,270,111,66,29,80,158,595,22
Jalen McDaniels,SF,25,PHI,24,3,419,60,123,.488,12,30,.400,48,93,.516,.537,28,34,.824,19,57,76,19,17,5,13,51,160,22
Doug McDermott,SF,31,SAS,64,0,1314,239,523,.457,123,298,.413,116,225,.516,.575,53,70,.757,24,115,139,91,13,6,58,118,654,22
JaVale McGee,C,35,DAL,42,7,355,80,125,.640,2,5,.400,78,120,.650,.648,24,41,.585,30,77,107,11,4,26,36,54,186,22
Bryce McGowens,SG,20,CHO,46,7,787,80,202,.396,26,80,.325,54,122,.443,.460,60,80,.750,20,73,93,54,15,6,43,48,246,22
Rodney McGruder,SG,31,DET,32,12,524,62,152,.408,41,97,.423,21,55,.382,.543,18,22,.818,20,54,74,28,16,1,11,39,183,22
Jordan McLaughlin,PG,26,MIN,43,0,678,61,145,.421,24,78,.308,37,67,.552,.503,15,18,.833,15,47,62,148,32,4,33,28,161,22
De'Anthony Melton,PG,24,PHI,77,58,2150,277,651,.425,157,403,.390,120,248,.484,.546,69,87,.793,69,243,312,197,126,41,102,191,780,22
Sam Merrill,SG,26,CLE,5,0,59,9,22,.409,5,18,.278,4,4,1.000,.523,2,2,1.000,0,9,9,5,4,0,0,3,25,22
Chimezie Metu,C,25,SAC,66,0,689,129,219,.589,9,38,.237,120,181,.663,.610,54,73,.740,47,151,198,40,22,21,32,81,321,22
Khris Middleton,SF,31,MIL,33,19,801,177,406,.436,51,162,.315,126,244,.516,.499,92,102,.902,28,112,140,163,23,5,71,68,497,22
Patty Mills,PG,34,BRK,40,2,567,86,209,.411,49,134,.366,37,75,.493,.529,25,30,.833,8,36,44,56,15,3,30,32,246,22
Shake Milton,SG,26,PHI,76,11,1567,241,503,.479,56,148,.378,185,355,.521,.535,99,116,.853,39,152,191,240,25,13,94,123,637,22
Justin Minaya,SF,23,POR,4,0,89,7,23,.304,3,12,.250,4,11,.364,.370,0,1,0,3,12,15,4,2,5,4,9,17,22
Josh Minott,SF,20,MIN,15,0,96,18,36,.500,2,6,.333,16,30,.533,.528,8,8,1.000,5,20,25,5,4,6,3,10,46,22
Davion Mitchell,PG,24,SAC,80,9,1447,181,399,.454,63,197,.320,118,202,.584,.533,25,31,.806,16,89,105,185,44,15,62,112,450,22
Donovan Mitchell,SG,26,CLE,68,68,2432,679,1402,.484,245,635,.386,434,767,.566,.572,319,368,.867,63,226,289,301,99,27,180,168,1922,22
Evan Mobley,PF,21,CLE,79,79,2715,525,947,.554,22,102,.216,503,845,.595,.566,205,304,.674,187,524,711,224,60,119,146,218,1277,22
Isaiah Mobley,PF,23,CLE,13,0,84,12,28,.429,3,8,.375,9,20,.450,.482,4,4,1.000,4,16,20,3,4,3,1,8,31,22
Chima Moneke,SF,27,SAC,2,0,8,1,2,.500,0,0,0,1,2,.500,.500,0,2,0,2,0,2,1,0,0,2,2,2,22
Malik Monk,SG,24,SAC,77,0,1719,357,796,.448,143,398,.359,214,398,.538,.538,184,207,.889,32,171,203,298,49,20,146,125,1041,22
Moses Moody,SG,20,GSW,63,3,817,108,227,.476,49,135,.363,59,92,.641,.584,37,53,.698,28,77,105,51,18,7,34,54,302,22
Xavier Moon,SG,28,LAC,4,0,20,3,9,.333,1,3,.333,2,6,.333,.389,0,0,0,0,3,3,5,0,0,1,2,7,22
Wendell Moore Jr.,SG,21,MIN,29,2,153,18,43,.419,2,17,.118,16,26,.615,.442,4,5,.800,4,14,18,18,8,5,8,13,42,22
Ja Morant,PG,23,MEM,61,59,1948,566,1214,.466,92,300,.307,474,914,.519,.504,372,497,.748,61,296,357,493,66,16,206,100,1596,22
Marcus Morris,PF,33,LAC,65,65,1825,274,643,.426,112,308,.364,162,335,.484,.513,68,87,.782,29,229,258,114,42,21,56,136,728,22
Markieff Morris,PF,33,TOT,35,2,355,47,115,.409,28,71,.394,19,44,.432,.530,10,10,1.000,13,58,71,31,9,5,18,48,132,22
Markieff Morris,PF,33,BRK,27,1,285,33,82,.402,20,49,.408,13,33,.394,.524,10,10,1.000,13,46,59,25,8,5,14,33,96,22
Markieff Morris,PF,33,DAL,8,1,70,14,33,.424,8,22,.364,6,11,.545,.545,0,0,0,0,12,12,6,1,0,4,15,36,22
Monte Morris,PG,27,WAS,62,61,1695,247,515,.480,78,204,.382,169,311,.543,.555,64,77,.831,26,184,210,326,43,13,60,75,636,22
Trey Murphy III,SF,22,NOP,79,65,2448,387,800,.484,202,497,.406,185,303,.611,.610,172,190,.905,59,222,281,112,89,43,61,155,1148,22
Dejounte Murray,SG,26,ATL,74,74,2693,612,1319,.464,133,387,.344,479,932,.514,.514,158,190,.832,53,336,389,448,112,19,160,106,1515,22
Jamal Murray,PG,25,DEN,65,65,2133,473,1041,.454,172,432,.398,301,609,.494,.537,180,216,.833,48,209,257,400,66,16,145,103,1298,22
Keegan Murray,SF,22,SAC,80,78,2382,354,782,.453,206,501,.411,148,281,.527,.584,62,81,.765,89,282,371,98,61,42,60,162,976,22
Mike Muscala,C,31,TOT,63,9,945,131,292,.449,81,207,.391,50,85,.588,.587,40,52,.769,37,166,203,50,15,24,23,98,383,22
Mike Muscala,C,31,OKC,43,5,622,89,203,.438,56,142,.394,33,61,.541,.576,31,39,.795,23,112,135,38,11,19,14,70,265,22
Mike Muscala,C,31,BOS,20,4,323,42,89,.472,25,65,.385,17,24,.708,.612,9,13,.692,14,54,68,12,4,5,9,28,118,22
Svi Mykhailiuk,SF,25,TOT,32,8,468,77,173,.445,42,99,.424,35,74,.473,.566,26,39,.667,15,38,53,53,15,4,24,23,222,22
Svi Mykhailiuk,SF,25,NYK,13,0,40,6,12,.500,6,10,.600,0,2,0,.750,3,5,.600,0,7,7,1,1,0,2,1,21,22
Svi Mykhailiuk,SF,25,CHO,19,8,428,71,161,.441,36,89,.404,35,72,.486,.553,23,34,.676,15,31,46,52,14,4,22,22,201,22
Larry Nance Jr.,PF,30,NOP,65,1,1381,186,305,.610,14,42,.333,172,263,.654,.633,55,79,.696,106,248,354,119,56,37,42,133,441,22
Andrew Nembhard,SG,23,IND,75,63,2073,284,644,.441,92,263,.350,192,381,.504,.512,49,62,.790,35,164,199,341,70,13,126,179,709,22
Aaron Nesmith,SF,23,IND,73,60,1816,252,590,.427,115,314,.366,137,276,.496,.525,119,142,.838,62,215,277,98,55,34,75,235,738,22
Raul Neto,PG,30,CLE,48,1,505,57,110,.518,12,42,.286,45,68,.662,.573,31,34,.912,10,36,46,79,17,4,24,49,157,22
Georges Niang,PF,29,PHI,78,1,1512,222,502,.442,154,384,.401,68,118,.576,.596,39,45,.867,19,166,185,77,30,14,54,145,637,22
Daishen Nix,PG,20,HOU,57,7,914,81,237,.342,40,140,.286,41,97,.423,.426,24,36,.667,18,80,98,132,31,7,86,59,226,22
Zeke Nnaji,PF,22,DEN,53,5,728,110,196,.561,17,65,.262,93,131,.710,.605,40,62,.645,65,73,138,18,17,23,31,105,277,22
Nerlens Noel,C,28,TOT,17,4,195,13,36,.361,1,2,.500,12,34,.353,.375,8,12,.667,10,36,46,10,16,10,13,32,35,22
Nerlens Noel,C,28,DET,14,3,152,12,30,.400,1,2,.500,11,28,.393,.417,7,10,.700,7,30,37,7,13,9,8,25,32,22
Nerlens Noel,C,28,BRK,3,1,43,1,6,.167,0,0,0,1,6,.167,.167,1,2,.500,3,6,9,3,3,1,5,7,3,22
Jaylen Nowell,SG,23,MIN,65,2,1252,280,625,.448,67,232,.289,213,393,.542,.502,77,99,.778,36,134,170,132,42,5,65,101,704,22
Frank Ntilikina,PG,24,DAL,47,5,607,48,132,.364,17,67,.254,31,65,.477,.428,22,33,.667,7,55,62,58,16,7,29,65,135,22
Kendrick Nunn,SG-PG,27,TOT,70,2,964,191,450,.424,79,223,.354,112,227,.493,.512,35,41,.854,15,94,109,90,28,7,66,66,496,22
Kendrick Nunn,SG,27,LAL,39,2,528,102,251,.406,41,126,.325,61,125,.488,.488,17,21,.810,5,50,55,34,11,3,31,35,262,22
Kendrick Nunn,PG,27,WAS,31,0,436,89,199,.447,38,97,.392,51,102,.500,.543,18,20,.900,10,44,54,56,17,4,35,31,234,22
Jusuf Nurkić,C,28,POR,52,52,1391,262,505,.519,43,119,.361,219,386,.567,.561,127,192,.661,114,357,471,149,43,44,119,185,694,22
Jordan Nwora,SF,24,TOT,62,14,1188,194,445,.436,86,211,.408,108,234,.462,.533,68,86,.791,51,178,229,88,24,14,66,74,542,22
Jordan Nwora,SF,24,MIL,38,3,597,76,197,.386,40,102,.392,36,95,.379,.487,37,43,.860,29,88,117,38,12,7,34,34,229,22
Jordan Nwora,SF,24,IND,24,11,591,118,248,.476,46,109,.422,72,139,.518,.569,31,43,.721,22,90,112,50,12,7,32,40,313,22
Royce O'Neale,SF,29,BRK,76,53,2409,229,593,.386,163,419,.389,66,174,.379,.524,50,69,.725,55,329,384,283,65,49,114,239,671,22
Chuma Okeke,SF,24,ORL,27,8,518,43,122,.352,26,86,.302,17,36,.472,.459,16,21,.762,26,70,96,37,19,11,17,40,128,22
Josh Okogie,SG,24,PHO,72,26,1350,162,414,.391,66,197,.335,96,217,.442,.471,139,192,.724,109,142,251,105,56,34,63,114,529,22
Onyeka Okongwu,C,22,ATL,80,18,1849,317,497,.638,4,13,.308,313,484,.647,.642,153,196,.781,217,359,576,81,56,107,81,251,791,22
Isaac Okoro,SF,22,CLE,76,46,1652,175,354,.494,62,171,.363,113,183,.617,.582,78,103,.757,52,135,187,87,56,30,42,158,490,22
KZ Okpala,PF,23,SAC,35,3,248,16,38,.421,7,21,.333,9,17,.529,.513,7,8,.875,7,27,34,13,7,7,7,39,46,22
Victor Oladipo,SG,30,MIA,42,2,1106,160,403,.397,70,212,.330,90,191,.471,.484,59,79,.747,16,112,128,146,57,12,87,99,449,22
Kelly Olynyk,C,31,UTA,68,68,1942,278,557,.499,93,236,.394,185,321,.576,.583,198,232,.853,82,338,420,252,60,37,168,232,847,22
Eugene Omoruyi,SF,25,TOT,40,6,645,101,228,.443,25,89,.281,76,139,.547,.498,51,75,.680,43,68,111,28,28,3,34,91,278,22
Eugene Omoruyi,SF,25,OKC,23,2,272,44,94,.468,8,31,.258,36,63,.571,.511,17,28,.607,22,30,52,11,14,0,16,46,113,22
Eugene Omoruyi,SF,25,DET,17,4,373,57,134,.425,17,58,.293,40,76,.526,.489,34,47,.723,21,38,59,17,14,3,18,45,165,22
Cedi Osman,SF,27,CLE,77,2,1548,239,530,.451,116,312,.372,123,218,.564,.560,75,108,.694,25,151,176,115,35,11,52,122,669,22
Kelly Oubre Jr.,SF,27,CHO,48,40,1548,353,819,.431,108,339,.319,245,480,.510,.497,158,208,.760,65,184,249,54,68,18,64,141,972,22
Chris Paul,PG,37,PHO,59,59,1889,294,668,.440,98,261,.375,196,407,.482,.513,133,160,.831,27,224,251,524,91,22,114,126,819,22
Cameron Payne,PG,28,PHO,48,15,968,188,453,.415,68,185,.368,120,268,.448,.490,49,64,.766,12,94,106,214,33,8,81,88,493,22
Gary Payton II,PG,30,TOT,22,1,367,41,69,.594,13,26,.500,28,43,.651,.688,6,7,.857,24,45,69,30,22,5,16,43,101,22
Gary Payton II,PG,30,POR,15,1,255,24,41,.585,9,17,.529,15,24,.625,.695,4,4,1.000,10,29,39,22,16,1,12,29,61,22
Gary Payton II,PG,30,GSW,7,0,112,17,28,.607,4,9,.444,13,19,.684,.679,2,3,.667,14,16,30,8,6,4,4,14,40,22
Theo Pinson,SG,27,DAL,40,1,323,31,87,.356,22,62,.355,9,25,.360,.483,11,13,.846,10,53,63,46,6,1,12,34,95,22
Scotty Pippen Jr.,PG,22,LAL,6,0,32,4,12,.333,1,3,.333,3,9,.333,.375,5,9,.556,2,2,4,2,2,1,2,3,14,22
Mason Plumlee,C,32,TOT,79,60,2054,329,484,.680,0,0,0,329,484,.680,.680,199,313,.636,229,471,700,245,46,47,117,217,857,22
Mason Plumlee,C,32,CHO,56,56,1597,265,396,.669,0,0,0,265,396,.669,.669,155,256,.605,187,354,541,205,35,35,87,161,685,22
Mason Plumlee,C,32,LAC,23,4,457,64,88,.727,0,0,0,64,88,.727,.727,44,57,.772,42,117,159,40,11,12,30,56,172,22
Jakob Poeltl,C,27,TOT,72,71,1906,389,618,.629,0,1,0,389,617,.630,.629,119,201,.592,236,417,653,197,66,86,125,195,897,22
Jakob Poeltl,C,27,SAS,46,46,1199,239,388,.616,0,1,0,239,387,.618,.616,78,129,.605,152,264,416,141,36,52,96,118,556,22
Jakob Poeltl,C,27,TOR,26,25,707,150,230,.652,0,0,0,150,230,.652,.652,41,72,.569,84,153,237,56,30,34,29,77,341,22
Aleksej Pokusevski,PF,21,OKC,34,25,701,108,249,.434,38,104,.365,70,145,.483,.510,22,35,.629,45,114,159,64,20,43,43,58,276,22
Jordan Poole,PG,23,GSW,82,43,2458,550,1278,.430,214,637,.336,336,641,.524,.514,361,415,.870,32,193,225,369,63,21,252,214,1675,22
Kevin Porter Jr.,PG,22,HOU,59,59,2024,391,884,.442,141,385,.366,250,499,.501,.522,207,264,.784,76,238,314,338,82,17,188,156,1130,22
Michael Porter Jr.,SF,24,DEN,62,62,1798,398,817,.487,188,454,.414,210,363,.579,.602,96,120,.800,64,277,341,65,37,29,68,119,1080,22
Otto Porter Jr.,SF,29,TOR,8,2,146,15,30,.500,6,17,.353,9,13,.692,.600,8,8,1.000,6,13,19,8,11,0,4,7,44,22
Bobby Portis,PF,27,MIL,70,22,1818,398,803,.496,95,257,.370,303,546,.555,.555,96,125,.768,154,518,672,105,29,16,81,115,987,22
Kristaps Porziņģis,C,27,WAS,65,65,2120,507,1018,.498,137,356,.385,370,662,.559,.565,354,416,.851,114,432,546,174,58,100,137,196,1505,22
Micah Potter,PF,24,UTA,7,0,52,10,15,.667,4,7,.571,6,8,.750,.800,0,0,0,3,13,16,4,1,0,2,5,24,22
Dwight Powell,C,31,DAL,76,64,1458,197,269,.732,0,5,0,197,264,.746,.732,112,168,.667,149,165,314,69,48,26,65,209,506,22
Norman Powell,SG,29,LAC,60,8,1567,340,710,.479,114,287,.397,226,423,.534,.559,225,277,.812,24,151,175,109,50,18,101,125,1019,22
Jason Preston,PG,23,LAC,14,0,124,18,41,.439,5,18,.278,13,23,.565,.500,0,2,0,2,20,22,27,2,0,10,7,41,22
Joshua Primo,SG,20,SAS,4,0,93,9,26,.346,3,12,.250,6,14,.429,.404,7,9,.778,2,11,13,18,1,2,11,8,28,22
Taurean Prince,SF,28,MIN,54,4,1192,177,379,.467,74,194,.381,103,185,.557,.565,65,77,.844,15,117,132,84,28,15,69,123,493,22
Payton Pritchard,PG,25,BOS,48,3,643,101,245,.412,56,154,.364,45,91,.495,.527,12,16,.750,25,63,88,64,14,1,40,37,270,22
Trevelin Queen,SG,25,IND,7,0,70,7,29,.241,2,15,.133,5,14,.357,.276,5,5,1.000,8,9,17,6,2,5,7,4,21,22
Neemias Queta,C,23,SAC,5,0,29,6,9,.667,0,0,0,6,9,.667,.667,0,2,0,5,6,11,1,0,2,1,7,12,22
Immanuel Quickley,PG,23,NYK,81,21,2344,419,936,.448,168,454,.370,251,482,.521,.537,203,248,.819,58,279,337,279,80,14,100,166,1209,22
Lester Quinones,SG,22,GSW,4,0,18,2,5,.400,2,4,.500,0,1,0,.600,4,6,.667,1,2,3,2,1,0,5,0,10,22
Julius Randle,PF,28,NYK,77,77,2737,658,1432,.459,218,636,.343,440,796,.553,.536,402,531,.757,141,626,767,316,49,21,216,233,1936,22
Austin Reaves,SG,24,LAL,64,22,1843,259,490,.529,86,216,.398,173,274,.631,.616,229,265,.864,33,160,193,215,33,19,99,108,833,22
Cam Reddish,SF,23,TOT,40,20,990,139,312,.446,45,144,.313,94,168,.560,.518,64,75,.853,18,70,88,57,39,14,47,72,387,22
Cam Reddish,SF,23,NYK,20,8,438,61,136,.449,17,56,.304,44,80,.550,.511,29,33,.879,7,24,31,20,15,8,15,32,168,22
Cam Reddish,SF,23,POR,20,12,552,78,176,.443,28,88,.318,50,88,.568,.523,35,42,.833,11,46,57,37,24,6,32,40,219,22
Davon Reed,SG,27,TOT,43,1,342,28,84,.333,17,46,.370,11,38,.289,.435,16,24,.667,10,49,59,23,15,4,20,39,89,22
Davon Reed,SG,27,DEN,35,1,315,25,80,.313,16,44,.364,9,36,.250,.413,15,20,.750,9,46,55,19,13,4,20,36,81,22
Davon Reed,SG,27,LAL,8,0,27,3,4,.750,1,2,.500,2,2,1.000,.875,1,4,.250,1,3,4,4,2,0,0,3,8,22
Paul Reed,C,23,PHI,69,2,755,124,209,.593,1,6,.167,123,203,.606,.596,38,51,.745,112,150,262,27,46,51,45,123,287,22
Naz Reid,C,23,MIN,68,11,1251,310,577,.537,75,217,.346,235,360,.653,.602,86,127,.677,73,260,333,77,42,53,92,176,781,22
Jared Rhoden,SG,23,DET,14,0,198,17,44,.386,5,20,.250,12,24,.500,.443,6,6,1.000,11,26,37,4,4,1,3,23,45,22
Nick Richards,C,25,CHO,65,9,1217,197,313,.629,1,1,1.000,196,312,.628,.631,137,183,.749,147,269,416,38,11,71,59,154,532,22
Josh Richardson,SG,29,TOT,65,10,1530,239,554,.431,107,293,.365,132,261,.506,.528,69,81,.852,41,134,175,174,69,20,86,117,654,22
Josh Richardson,SG,29,SAS,42,6,997,177,406,.436,74,207,.357,103,199,.518,.527,53,60,.883,30,89,119,137,40,11,63,70,481,22
Josh Richardson,SG,29,NOP,23,4,533,62,148,.419,33,86,.384,29,62,.468,.530,16,21,.762,11,45,56,37,29,9,23,47,173,22
Austin Rivers,SG,30,MIN,52,10,1016,91,209,.435,43,123,.350,48,86,.558,.538,30,39,.769,5,78,83,75,28,4,23,80,255,22
Duncan Robinson,SF,28,MIA,42,1,691,88,237,.371,63,192,.328,25,45,.556,.504,29,32,.906,8,61,69,46,14,0,28,77,268,22
Mitchell Robinson,C,24,NYK,59,58,1591,188,280,.671,0,0,0,188,280,.671,.671,59,122,.484,267,288,555,53,56,109,41,160,435,22
Orlando Robinson,C,22,MIA,31,1,425,47,89,.528,0,6,0,47,83,.566,.528,22,31,.710,48,78,126,25,12,12,16,53,116,22
Jeremiah Robinson-Earl,PF,22,OKC,43,20,814,110,248,.444,37,111,.333,73,137,.533,.518,35,42,.833,71,109,180,43,24,11,19,71,292,22
Isaiah Roby,PF,24,SAS,42,2,474,67,155,.432,18,60,.300,49,95,.516,.490,20,41,.488,21,86,107,38,18,7,31,53,172,22
David Roddy,PF,21,MEM,70,4,1258,180,420,.429,65,212,.307,115,208,.553,.506,41,65,.631,50,143,193,59,29,19,57,107,466,22
Ryan Rollins,PG,20,GSW,12,0,62,7,20,.350,3,9,.333,4,11,.364,.425,6,6,1.000,3,9,12,6,1,1,16,10,23,22
Derrick Rose,PG,34,NYK,27,0,338,61,159,.384,19,63,.302,42,96,.438,.443,11,12,.917,8,32,40,46,7,5,22,18,152,22
Terrence Ross,SG,31,TOT,63,9,1330,200,465,.430,95,258,.368,105,207,.507,.532,27,34,.794,22,132,154,95,35,10,43,97,522,22
Terrence Ross,SG,31,ORL,42,9,944,129,299,.431,61,160,.381,68,139,.489,.533,15,20,.750,10,75,85,54,25,8,37,53,334,22
Terrence Ross,SG,31,PHO,21,0,386,71,166,.428,34,98,.347,37,68,.544,.530,12,14,.857,12,57,69,41,10,2,6,44,188,22
Terry Rozier,SG,28,CHO,63,63,2221,493,1188,.415,165,505,.327,328,683,.480,.484,178,220,.809,51,208,259,319,74,16,134,119,1329,22
Ricky Rubio,PG,32,CLE,33,2,566,61,178,.343,21,82,.256,40,96,.417,.402,28,35,.800,9,61,70,115,26,6,31,51,171,22
D'Angelo Russell,PG,26,TOT,71,71,2304,445,948,.469,194,490,.396,251,458,.548,.572,179,216,.829,35,180,215,437,70,29,186,140,1263,22
D'Angelo Russell,PG,26,MIN,54,54,1778,338,727,.465,148,379,.391,190,348,.546,.567,143,167,.856,28,137,165,334,60,21,147,117,967,22
D'Angelo Russell,PG,26,LAL,17,17,526,107,221,.484,46,111,.414,61,110,.555,.588,36,49,.735,7,43,50,103,10,8,39,23,296,22
Matt Ryan,SF,25,TOT,34,0,310,40,108,.370,32,84,.381,8,24,.333,.519,10,12,.833,4,22,26,16,5,1,7,27,122,22
Matt Ryan,SF,25,LAL,12,0,129,15,49,.306,13,35,.371,2,14,.143,.439,4,5,.800,2,12,14,4,2,0,3,14,47,22
Matt Ryan,SF,25,MIN,22,0,181,25,59,.424,19,49,.388,6,10,.600,.585,6,7,.857,2,10,12,12,3,1,4,13,75,22
Domantas Sabonis,C,26,SAC,79,79,2736,577,938,.615,31,83,.373,546,855,.639,.632,325,438,.742,251,722,973,573,65,39,230,279,1510,22
Luka Šamanić,PF,23,UTA,7,4,161,26,57,.456,8,31,.258,18,26,.692,.526,9,13,.692,0,30,30,15,6,2,10,17,69,22
Dario Šarić,PF,28,TOT,57,12,806,127,277,.458,45,115,.391,82,162,.506,.540,63,76,.829,53,154,207,74,20,7,55,99,362,22
Dario Šarić,PF,28,PHO,37,12,533,76,178,.427,27,69,.391,49,109,.450,.503,36,44,.818,39,103,142,57,13,5,36,69,215,22
Dario Šarić,PF,28,OKC,20,0,273,51,99,.515,18,46,.391,33,53,.623,.606,27,32,.844,14,51,65,17,7,2,19,30,147,22
Olivier Sarr,C,23,OKC,9,1,114,15,30,.500,1,8,.125,14,22,.636,.517,5,7,.714,12,19,31,4,1,5,4,17,36,22
Jordan Schakel,SF,24,WAS,2,0,6,1,2,.500,1,1,1.000,0,1,0,.750,0,0,0,0,0,0,1,1,0,0,1,3,22
Admiral Schofield,PF,25,ORL,37,0,451,55,122,.451,24,74,.324,31,48,.646,.549,21,23,.913,23,39,62,31,8,5,16,61,155,22
Dennis Schröder,PG,29,LAL,66,50,1986,270,650,.415,74,225,.329,196,425,.461,.472,216,252,.857,21,144,165,298,50,10,112,145,830,22
Jay Scrubb,SG,22,ORL,2,0,30,5,7,.714,2,2,1.000,3,5,.600,.857,1,2,.500,0,6,6,1,2,0,3,2,13,22
Dereon Seabron,SG,22,NOP,5,0,12,2,5,.400,0,0,0,2,5,.400,.400,0,0,0,1,0,1,0,0,0,0,1,4,22
Alperen Şengün,C,20,HOU,75,72,2171,442,799,.553,19,57,.333,423,742,.570,.565,206,288,.715,242,436,678,291,70,70,193,258,1109,22
Collin Sexton,SG,24,UTA,48,15,1145,237,468,.506,48,122,.393,189,346,.546,.558,163,199,.819,37,68,105,138,27,6,85,112,685,22
Landry Shamet,SG,25,PHO,40,9,807,113,300,.377,75,199,.377,38,101,.376,.502,45,51,.882,11,56,67,93,26,5,36,61,346,22
Day'Ron Sharpe,C,21,BRK,48,3,552,93,171,.544,6,11,.545,87,160,.544,.561,35,55,.636,99,101,200,37,15,32,42,89,227,22
Shaedon Sharpe,SG,19,POR,80,15,1779,306,648,.472,102,283,.360,204,365,.559,.551,75,105,.714,63,173,236,94,38,24,83,136,789,22
Pascal Siakam,C,28,TOR,71,71,2652,630,1313,.480,93,287,.324,537,1026,.523,.515,367,474,.774,131,425,556,415,65,36,169,228,1720,22
Chris Silva,PF,26,DAL,1,0,3,1,1,1.000,0,0,0,1,1,1.000,1.000,0,0,0,0,0,0,0,0,0,1,2,2,22
Ben Simmons,PG,26,BRK,42,33,1105,133,235,.566,0,2,0,133,233,.571,.566,25,57,.439,40,223,263,256,54,24,97,139,291,22
Kobi Simmons,PG,25,CHO,5,0,28,1,6,.167,1,5,.200,0,1,0,.250,2,2,1.000,1,3,4,5,0,2,1,0,5,22
Marko Simonovic,C,23,CHI,7,0,20,2,7,.286,1,4,.250,1,3,.333,.357,1,2,.500,1,1,2,0,0,0,0,5,6,22
Anfernee Simons,SG,23,POR,62,62,2171,467,1045,.447,212,562,.377,255,483,.528,.548,160,179,.894,18,143,161,253,42,14,128,142,1306,22
Jericho Sims,C,24,NYK,52,16,812,83,107,.776,0,1,0,83,106,.783,.776,12,16,.750,99,143,242,25,15,28,27,96,178,22
Marcus Smart,PG,28,BOS,61,61,1957,250,602,.415,115,342,.336,135,260,.519,.511,88,118,.746,46,145,191,382,93,23,143,172,703,22
Dennis Smith Jr.,PG,25,CHO,54,15,1390,186,452,.412,24,111,.216,162,341,.475,.438,78,106,.736,27,140,167,261,75,25,82,122,474,22
Dru Smith,SG,25,TOT,15,1,158,18,45,.400,5,19,.263,13,26,.500,.456,3,3,1.000,2,22,24,22,10,4,3,23,44,22
Dru Smith,SG,25,MIA,5,1,67,5,14,.357,1,6,.167,4,8,.500,.393,0,0,0,1,8,9,5,4,3,1,10,11,22
Dru Smith,SG,25,BRK,10,0,91,13,31,.419,4,13,.308,9,18,.500,.484,3,3,1.000,1,14,15,17,6,1,2,13,33,22
Ish Smith,PG,34,DEN,43,0,398,52,131,.397,2,12,.167,50,119,.420,.405,2,4,.500,5,49,54,100,8,7,44,33,108,22
Jabari Smith Jr.,PF,19,HOU,79,79,2451,364,892,.408,120,391,.307,244,501,.487,.475,162,206,.786,122,447,569,101,43,74,104,227,1010,22
Jalen Smith,PF,22,IND,68,31,1279,242,508,.476,54,191,.283,188,317,.593,.530,104,137,.759,129,265,394,66,21,60,72,153,642,22
Xavier Sneed,SF,25,CHO,4,0,48,5,10,.500,3,6,.500,2,4,.500,.650,4,4,1.000,0,5,5,5,0,1,3,7,17,22
Jeremy Sochan,PF,19,SAS,56,53,1458,250,552,.453,33,134,.246,217,418,.519,.483,81,116,.698,95,200,295,142,43,23,97,138,614,22
Jaden Springer,SG,20,PHI,16,2,89,17,35,.486,2,5,.400,15,30,.500,.514,6,8,.750,6,8,14,8,7,3,3,15,42,22
Lamar Stevens,PF,25,CLE,62,25,1120,129,288,.448,30,95,.316,99,193,.513,.500,40,57,.702,48,159,207,33,27,19,27,79,328,22
Isaiah Stewart,C,21,DET,50,47,1414,195,441,.442,67,205,.327,128,236,.542,.518,110,149,.738,115,288,403,70,20,34,68,133,567,22
Max Strus,SF,26,MIA,80,33,2272,324,790,.410,197,563,.350,127,227,.559,.535,78,89,.876,49,209,258,171,42,12,70,166,923,22
Jalen Suggs,PG,21,ORL,53,19,1246,186,444,.419,66,202,.327,120,242,.496,.493,86,119,.723,55,106,161,155,67,27,94,120,524,22
Edmond Sumner,SG,27,BRK,53,12,736,124,269,.461,31,87,.356,93,182,.511,.519,99,108,.917,13,66,79,68,31,10,50,83,378,22
Cole Swider,SF,23,LAL,7,0,41,3,9,.333,3,8,.375,0,1,0,.500,0,0,0,1,6,7,4,0,0,0,3,9,22
Jae'Sean Tate,SF,27,HOU,31,7,677,110,229,.480,13,46,.283,97,183,.530,.509,50,69,.725,41,77,118,84,21,7,47,106,283,22
Jayson Tatum,PF,24,BOS,74,74,2732,727,1559,.466,240,686,.350,487,873,.558,.543,531,622,.854,78,571,649,342,78,51,213,160,2225,22
Terry Taylor,PF,23,TOT,31,2,264,39,75,.520,5,19,.263,34,56,.607,.553,6,11,.545,27,20,47,10,3,6,9,26,89,22
Terry Taylor,PF,23,IND,26,2,228,30,65,.462,4,18,.222,26,47,.553,.492,5,7,.714,22,17,39,10,3,5,9,24,69,22
Terry Taylor,PF,23,CHI,5,0,36,9,10,.900,1,1,1.000,8,9,.889,.950,1,4,.250,5,3,8,0,0,1,0,2,20,22
Garrett Temple,SG,36,NOP,25,0,162,18,45,.400,11,26,.423,7,19,.368,.522,3,4,.750,5,12,17,13,9,2,4,15,50,22
Dalen Terry,SG,20,CHI,38,0,214,32,72,.444,7,27,.259,25,45,.556,.493,14,21,.667,12,25,37,22,11,5,8,24,85,22
Daniel Theis,C,30,IND,7,1,109,21,44,.477,2,11,.182,19,33,.576,.500,5,12,.417,7,15,22,9,2,6,3,7,49,22
Cam Thomas,SG,21,BRK,57,4,948,201,456,.441,51,133,.383,150,323,.464,.497,151,174,.868,8,87,95,78,20,7,63,55,604,22
Klay Thompson,SG,32,GSW,69,69,2279,546,1252,.436,301,731,.412,245,521,.470,.556,116,132,.879,39,247,286,163,49,29,123,130,1509,22
JT Thor,PF,20,CHO,69,8,969,95,238,.399,39,123,.317,56,115,.487,.481,33,47,.702,36,116,152,36,22,23,44,66,262,22
Matisse Thybulle,SG,25,TOT,71,28,1200,110,253,.435,54,148,.365,56,105,.533,.542,19,28,.679,40,100,140,53,83,32,24,113,293,22
Matisse Thybulle,SG,25,PHI,49,6,591,50,116,.431,21,63,.333,29,53,.547,.522,9,12,.750,20,43,63,23,45,14,8,65,130,22
Matisse Thybulle,SG,25,POR,22,22,609,60,137,.438,33,85,.388,27,52,.519,.558,10,16,.625,20,57,77,30,38,18,16,48,163,22
Xavier Tillman Sr.,PF,24,MEM,61,29,1180,188,306,.614,4,15,.267,184,291,.632,.621,49,89,.551,121,186,307,96,58,29,44,97,429,22
Isaiah Todd,PF,21,WAS,6,1,61,3,19,.158,1,10,.100,2,9,.222,.184,2,2,1.000,2,10,12,4,1,0,2,4,9,22
Obi Toppin,PF,24,NYK,67,5,1050,187,419,.446,85,247,.344,102,172,.593,.548,38,47,.809,29,158,187,66,23,12,38,68,497,22
Juan Toscano-Anderson,SF,29,TOT,52,9,700,64,143,.448,8,43,.186,56,100,.560,.476,19,24,.792,28,96,124,65,16,10,34,80,155,22
Juan Toscano-Anderson,SF,29,LAL,30,7,365,33,66,.500,4,20,.200,29,46,.630,.530,11,15,.733,14,47,61,25,10,7,17,46,81,22
Juan Toscano-Anderson,SF,29,UTA,22,2,335,31,77,.403,4,23,.174,27,54,.500,.429,8,9,.889,14,49,63,40,6,3,17,34,74,22
Karl-Anthony Towns,PF,27,MIN,29,29,957,212,428,.495,60,164,.366,152,264,.576,.565,118,135,.874,48,188,236,140,20,17,86,111,602,22
Gary Trent Jr.,SG,24,TOR,66,44,2118,405,935,.433,166,450,.369,239,485,.493,.522,172,205,.839,30,143,173,106,104,14,55,102,1148,22
P.J. Tucker,PF,37,PHI,75,75,1920,96,225,.427,55,140,.393,41,85,.482,.549,19,23,.826,95,200,295,60,39,15,44,180,266,22
Myles Turner,C,26,IND,62,62,1825,402,733,.548,93,249,.373,309,484,.638,.612,216,276,.783,88,378,466,89,36,140,103,215,1113,22
Stanley Umude,SG,23,DET,1,0,2,0,1,0,0,1,0,0,0,0,0,2,2,1.000,0,0,0,0,1,1,0,0,2,22
Jonas Valančiūnas,C,30,NOP,79,79,1968,446,816,.547,38,109,.349,408,707,.577,.570,185,224,.826,225,579,804,140,20,52,159,245,1115,22
Jarred Vanderbilt,PF,23,TOT,78,65,1879,247,451,.548,29,90,.322,218,361,.604,.580,96,139,.691,170,412,582,184,83,21,97,190,619,22
Jarred Vanderbilt,PF,23,UTA,52,41,1254,173,311,.556,19,57,.333,154,254,.606,.587,67,102,.657,121,288,409,142,53,15,68,133,432,22
Jarred Vanderbilt,PF,23,LAL,26,24,625,74,140,.529,10,33,.303,64,107,.598,.564,29,37,.784,49,124,173,42,30,6,29,57,187,22
Fred VanVleet,PG,28,TOR,69,69,2535,437,1112,.393,207,606,.342,230,506,.455,.486,254,283,.898,30,250,280,495,123,38,140,193,1335,22
Devin Vassell,SG,22,SAS,38,32,1178,261,595,.439,103,266,.387,158,329,.480,.525,78,100,.780,8,140,148,136,43,17,57,57,703,22
Gabe Vincent,PG,26,MIA,68,34,1759,228,567,.402,117,350,.334,111,217,.512,.505,68,78,.872,27,118,145,167,62,5,92,154,641,22
Noah Vonleh,C,27,BOS,23,1,171,11,24,.458,1,4,.250,10,20,.500,.479,2,2,1.000,18,30,48,7,2,8,11,35,25,22
Nikola Vučević,C,32,CHI,82,82,2746,597,1148,.520,121,347,.349,476,801,.594,.573,132,158,.835,159,744,903,265,60,57,139,179,1447,22
Dean Wade,PF,26,CLE,44,13,891,73,177,.412,45,127,.354,28,50,.560,.540,15,23,.652,20,130,150,37,28,21,17,89,206,22
Franz Wagner,SF,21,ORL,80,80,2609,542,1118,.485,130,360,.361,412,758,.544,.543,271,322,.842,70,259,329,283,77,17,167,183,1485,22
Moritz Wagner,C,25,ORL,57,18,1109,198,396,.500,51,163,.313,147,233,.631,.564,153,182,.841,69,190,259,84,37,13,68,136,600,22
Ish Wainright,SF,28,PHO,60,2,915,84,227,.370,57,173,.329,27,54,.500,.496,26,31,.839,45,94,139,53,38,22,22,117,251,22
Jabari Walker,SF,20,POR,56,0,619,83,198,.419,16,56,.286,67,142,.472,.460,34,45,.756,48,83,131,34,10,13,29,69,216,22
Kemba Walker,PG,32,DAL,9,1,144,24,57,.421,7,28,.250,17,29,.586,.482,17,21,.810,3,13,16,19,2,2,4,11,72,22
Lonnie Walker IV,SG,24,LAL,56,32,1297,236,527,.448,91,249,.365,145,278,.522,.534,91,106,.858,14,95,109,64,30,17,46,71,654,22
John Wall,PG,32,LAC,34,3,755,138,338,.408,33,109,.303,105,229,.459,.457,77,113,.681,14,78,92,178,27,12,80,59,386,22
T.J. Warren,PF-SF,29,TOT,42,0,687,132,270,.489,22,67,.328,110,203,.542,.530,28,35,.800,26,95,121,40,22,12,20,65,314,22
T.J. Warren,PF,29,BRK,26,0,490,102,200,.510,16,48,.333,86,152,.566,.550,27,33,.818,13,59,72,29,15,7,17,45,247,22
T.J. Warren,SF,29,PHO,16,0,197,30,70,.429,6,19,.316,24,51,.471,.471,1,2,.500,13,36,49,11,7,5,3,20,67,22
Duane Washington Jr.,SG,22,PHO,31,3,394,94,256,.367,40,111,.360,54,145,.372,.445,16,24,.667,2,34,36,63,6,4,34,23,244,22
P.J. Washington,PF,24,CHO,73,73,2380,434,978,.444,149,428,.348,285,550,.518,.520,127,174,.730,73,285,358,175,66,79,110,193,1144,22
TyTy Washington Jr.,PG,21,HOU,31,2,433,58,160,.363,19,80,.238,39,80,.488,.422,10,18,.556,2,43,45,47,15,2,14,29,145,22
Yuta Watanabe,SF,28,BRK,58,1,928,114,232,.491,60,135,.444,54,97,.557,.621,34,47,.723,30,111,141,48,25,17,22,80,322,22
Lindy Waters III,SG,25,OKC,41,0,531,70,178,.393,58,162,.358,12,16,.750,.556,16,20,.800,16,59,75,28,14,11,10,42,214,22
Trendon Watford,PF,22,POR,62,12,1182,181,323,.560,25,64,.391,156,259,.602,.599,72,100,.720,42,196,238,130,32,12,71,118,459,22
Peyton Watson,SG,20,DEN,23,2,186,29,59,.492,6,14,.429,23,45,.511,.542,11,20,.550,8,29,37,11,2,11,8,14,75,22
Blake Wesley,SG,19,SAS,37,1,669,69,215,.321,20,52,.385,49,163,.301,.367,26,44,.591,11,70,81,99,25,5,65,67,184,22
Russell Westbrook,PG,34,TOT,73,24,2126,432,991,.436,89,286,.311,343,705,.487,.481,206,314,.656,89,334,423,551,76,33,255,162,1159,22
Russell Westbrook,PG,34,LAL,52,3,1491,304,729,.417,63,213,.296,241,516,.467,.460,156,238,.655,59,262,321,391,53,23,184,121,827,22
Russell Westbrook,PG,34,LAC,21,21,635,128,262,.489,26,73,.356,102,189,.540,.538,50,76,.658,30,72,102,160,23,10,71,41,332,22
Coby White,SG,22,CHI,74,2,1730,263,594,.443,128,344,.372,135,250,.540,.551,61,70,.871,16,196,212,204,54,6,74,122,715,22
Derrick White,SG,28,BOS,82,70,2319,350,758,.462,149,391,.381,201,367,.548,.560,168,192,.875,52,241,293,321,54,76,95,177,1017,22
Jack White,SF,25,DEN,17,0,66,8,19,.421,3,9,.333,5,10,.500,.500,2,3,.667,6,11,17,4,3,2,2,9,21,22
Joe Wieskamp,SF,23,TOR,9,0,50,3,14,.214,3,12,.250,0,2,0,.321,0,0,0,0,4,4,3,0,0,1,3,9,22
Aaron Wiggins,SG,24,OKC,70,14,1297,186,363,.512,48,122,.393,138,241,.573,.579,59,71,.831,68,142,210,80,39,15,55,110,479,22
Andrew Wiggins,SF,27,GSW,37,37,1190,250,529,.473,89,225,.396,161,304,.530,.557,44,72,.611,61,125,186,85,45,28,48,107,633,22
Lindell Wigginton,PG,24,MIL,7,1,87,18,37,.486,6,18,.333,12,19,.632,.568,8,9,.889,0,7,7,14,0,2,12,7,50,22
Alondes Williams,SG,23,BRK,1,0,5,0,0,0,0,0,0,0,0,0,0,0,0,0,0,1,1,0,0,0,2,1,0,22
Donovan Williams,SG,21,ATL,2,0,4,2,5,.400,0,2,0,2,3,.667,.400,0,0,0,0,2,2,0,0,0,0,0,4,22
Grant Williams,PF,24,BOS,79,23,2045,216,476,.454,115,291,.395,101,185,.546,.575,94,122,.770,87,276,363,131,41,31,82,192,641,22
Jalen Williams,SG,21,OKC,75,62,2276,414,794,.521,73,205,.356,341,589,.579,.567,155,191,.812,84,253,337,248,103,35,123,191,1056,22
Jaylin Williams,PF,20,OKC,49,36,914,102,234,.436,46,113,.407,56,121,.463,.534,38,54,.704,44,197,241,76,28,12,37,111,288,22
Jeenathan Williams,SG,23,POR,5,4,127,24,39,.615,3,8,.375,21,31,.677,.654,2,3,.667,10,5,15,10,3,2,4,13,53,22
Kenrich Williams,PF,28,OKC,53,10,1206,179,346,.517,50,134,.373,129,212,.608,.590,17,39,.436,97,164,261,105,45,14,32,112,425,22
Mark Williams,C,21,CHO,43,17,828,160,251,.637,0,0,0,160,251,.637,.637,67,97,.691,93,211,304,18,28,45,40,94,387,22
Patrick Williams,PF,21,CHI,82,65,2323,314,677,.464,115,277,.415,199,400,.498,.549,90,105,.857,78,249,327,100,72,70,101,147,833,22
Robert Williams,C,25,BOS,35,20,824,127,170,.747,0,1,0,127,169,.751,.747,25,41,.610,104,188,292,50,22,48,34,68,279,22
Vince Williams Jr.,SG,22,MEM,15,1,105,12,40,.300,4,28,.143,8,12,.667,.350,2,2,1.000,4,11,15,4,6,2,5,12,30,22
Ziaire Williams,SF,21,MEM,37,4,561,84,196,.429,25,97,.258,59,99,.596,.492,17,22,.773,16,63,79,35,14,6,37,58,210,22
Zion Williamson,PF,22,NOP,29,29,956,285,469,.608,7,19,.368,278,450,.618,.615,177,248,.714,58,144,202,133,32,16,99,65,754,22
Dylan Windler,SF,26,CLE,3,0,10,2,3,.667,1,2,.500,1,1,1.000,.833,0,0,0,0,0,0,1,1,0,1,0,5,22
Justise Winslow,SF,26,POR,29,11,776,81,198,.409,14,45,.311,67,153,.438,.444,20,28,.714,49,96,145,98,30,11,43,89,196,22
James Wiseman,C,21,TOT,45,22,867,189,339,.558,4,20,.200,185,319,.580,.563,68,97,.701,73,194,267,30,7,27,51,108,450,22
James Wiseman,C,21,GSW,21,0,262,59,94,.628,1,2,.500,58,92,.630,.633,26,38,.684,18,55,73,14,3,7,14,39,145,22
James Wiseman,C,21,DET,24,22,605,130,245,.531,3,18,.167,127,227,.559,.537,42,59,.712,55,139,194,16,4,20,37,69,305,22
Christian Wood,C,27,DAL,67,17,1738,396,769,.515,105,279,.376,291,490,.594,.583,217,281,.772,87,404,491,121,30,72,121,169,1114,22
Delon Wright,PG,30,WAS,50,14,1221,138,291,.474,41,119,.345,97,172,.564,.545,52,60,.867,58,122,180,194,92,17,44,59,369,22
McKinley Wright IV,PG,24,DAL,27,1,335,46,98,.469,9,28,.321,37,70,.529,.515,13,19,.684,9,38,47,58,8,5,19,24,114,22
Gabe York,SG,29,IND,3,0,56,8,21,.381,6,18,.333,2,3,.667,.524,2,2,1.000,0,6,6,5,2,0,0,5,24,22
Thaddeus Young,PF,34,TOR,54,9,795,108,198,.545,6,34,.176,102,164,.622,.561,18,26,.692,71,95,166,75,54,5,42,88,240,22
Trae Young,PG,24,ATL,73,73,2541,597,1390,.429,154,460,.335,443,930,.476,.485,566,639,.886,56,161,217,741,80,9,300,104,1914,22
Omer Yurtseven,C,24,MIA,9,0,83,16,27,.593,3,7,.429,13,20,.650,.648,5,6,.833,8,15,23,2,2,2,4,16,40,22
Cody Zeller,C,30,MIA,15,2,217,37,59,.627,0,2,0,37,57,.649,.627,24,35,.686,25,39,64,10,3,4,14,33,98,22
Ivica Zubac,C,25,LAC,76,76,2170,326,514,.634,0,2,0,326,512,.637,.634,166,238,.697,236,520,756,77,29,98,117,219,818,22